forward_num,reverse_num,forward_rate,reverse_rate,organism_num,organism_rate
500,500,5.5,5.5,1000,5.5
494,496,5.50202429149798,5.49596774193548,990,5.4989898989899
492,495,5.5020325203252,5.49292929292929,987,5.49746707193516
536,463,5.2705223880597,5.48812095032397,999,5.37137137137137
574,424,4.73519163763066,5.53301886792453,998,5.07414829659319
606,393,4.92904290429043,5.57760814249364,999,5.18418418418418
625,373,5.1232,5.62734584450402,998,5.31162324649299
640,359,5.0078125,5.33426183844011,999,5.12512512512513
673,326,4.85735512630015,5.32208588957055,999,5.00900900900901
687,312,5.04657933042213,5.56410256410256,999,5.20820820820821
665,333,4.94135338345865,5.61861861861862,998,5.16733466933868
684,314,5.02485380116959,5.63057324840764,998,5.21543086172345
693,305,4.89466089466089,5.72459016393443,998,5.14829659318637
696,303,4.89367816091954,5.72607260726073,999,5.14614614614615
665,334,4.91729323308271,5.31736526946108,999,5.05105105105105
676,323,4.74260355029586,5.34984520123839,999,4.93893893893894
694,303,4.9193083573487,5.31353135313531,997,5.03911735205617
684,315,4.98391812865497,5.22539682539683,999,5.06006006006006
671,328,5.01043219076006,5.15853658536585,999,5.05905905905906
685,312,4.88321167883212,5.19871794871795,997,4.98194583751254
689,310,4.91727140783745,5.10322580645161,999,4.97497497497497
698,301,4.95272206303725,5.0797342192691,999,4.99099099099099
703,296,5.03129445234708,4.94932432432432,999,5.00700700700701
698,300,4.96131805157593,4.95666666666667,998,4.95991983967936
695,302,5.11223021582734,5.03311258278146,997,5.08826479438315
708,289,5.02824858757062,5.05536332179931,997,5.03610832497492
703,295,5.07254623044097,4.91864406779661,998,5.02705410821643
711,288,5.10970464135021,4.86458333333333,999,5.03903903903904
706,292,5.11331444759207,5.02054794520548,998,5.08617234468938
712,287,5.17275280898876,5.10104529616725,999,5.15215215215215
709,287,5.29055007052186,5.02787456445993,996,5.214859437751
709,289,5.43300423131171,5.04152249134948,998,5.31963927855711
729,269,5.3923182441701,4.88104089219331,998,5.25450901803607
733,266,5.45156889495225,4.94736842105263,999,5.31731731731732
742,257,5.52156334231806,4.98832684824903,999,5.38438438438438
736,262,5.60190217391304,5.1412213740458,998,5.48096192384769
739,259,5.53179972936401,5.24710424710425,998,5.45791583166333
739,260,5.57374830852503,5.30769230769231,999,5.5045045045045
744,255,5.63709677419355,5.28627450980392,999,5.54754754754755
748,250,5.62566844919786,5.296,998,5.54308617234469
749,249,5.58477970627503,5.38955823293173,998,5.53607214428858
753,246,5.60026560424967,5.52845528455285,999,5.58258258258258
754,245,5.70291777188329,5.59183673469388,999,5.67567567567568
759,240,5.64953886693017,5.74583333333333,999,5.67267267267267
762,236,5.6509186351706,5.77118644067797,998,5.67935871743487
774,224,5.63178294573643,5.80803571428571,998,5.67134268537074
776,222,5.59278350515464,5.88288288288288,998,5.65731462925852
776,223,5.61726804123711,5.88789237668161,999,5.67767767767768
774,221,5.62919896640827,5.92760180995475,995,5.69547738693467
778,220,5.55655526992288,5.95,998,5.64328657314629
774,223,5.61240310077519,6.00896860986547,997,5.70110330992979
780,219,5.67564102564103,6.03196347031963,999,5.75375375375375
781,218,5.67989756722151,5.92660550458716,999,5.73373373373373
791,207,5.66371681415929,5.94685990338164,998,5.72244488977956
788,211,5.63832487309645,5.9478672985782,999,5.7037037037037
794,205,5.69647355163728,6.00975609756098,999,5.76076076076076
787,211,5.715374841169,6.00473933649289,998,5.77655310621242
785,212,5.69936305732484,6.02358490566038,997,5.76830491474423
785,213,5.76433121019108,6.04225352112676,998,5.82364729458918
786,213,5.73664122137405,6.07042253521127,999,5.80780780780781
787,212,5.76111817026684,6.01415094339623,999,5.81481481481481
795,204,5.74339622641509,6.04411764705882,999,5.8048048048048
795,204,5.79119496855346,6.12254901960784,999,5.85885885885886
791,208,5.80151706700379,6.08653846153846,999,5.86086086086086
789,209,5.83903675538656,6.13397129186603,998,5.90080160320641
791,206,5.8558786346397,6.07281553398058,997,5.90070210631896
798,201,5.90977443609023,6.13432835820895,999,5.95495495495495
805,192,5.97888198757764,6.125,997,6.00702106318957
799,198,5.94743429286608,6.04545454545455,997,5.96690070210632
794,204,6.00125944584383,6.01960784313725,998,6.00501002004008
804,195,6.02114427860697,6.08205128205128,999,6.03303303303303
806,193,6.0272952853598,6.0,999,6.02202202202202
814,185,6.08230958230958,5.8972972972973,999,6.04804804804805
811,188,6.1233045622688,5.81382978723404,999,6.06506506506507
811,185,6.07274969173859,5.92432432432432,996,6.04518072289157
820,179,6.12560975609756,5.93854748603352,999,6.09209209209209
815,183,6.18895705521472,5.91256830601093,998,6.13827655310621
825,174,6.18181818181818,5.95977011494253,999,6.14314314314314
822,175,6.22384428223844,5.97142857142857,997,6.17953861584754
820,179,6.24878048780488,5.95530726256983,999,6.1961961961962
830,168,6.26265060240964,6.27976190476191,998,6.26553106212425
830,169,6.3,6.0887573964497,999,6.26426426426426
830,168,6.31807228915663,6.09523809523809,998,6.28056112224449
836,162,6.36722488038277,6.12962962962963,998,6.32865731462926
843,156,6.29893238434164,5.94871794871795,999,6.24424424424424
839,158,6.29082240762813,6.14556962025316,997,6.26780341023069
835,161,6.29101796407186,6.17391304347826,996,6.27208835341365
836,163,6.28827751196172,6.2760736196319,999,6.28628628628629
836,162,6.27511961722488,6.12962962962963,998,6.25150300601202
843,156,6.26571767497034,6.12179487179487,999,6.24324324324324
847,151,6.31523022432113,6.2317880794702,998,6.30260521042084
848,150,6.38207547169811,6.30666666666667,998,6.37074148296593
854,145,6.31615925058548,6.31724137931035,999,6.31631631631632
853,146,6.30597889800703,6.44520547945205,999,6.32632632632633
856,142,6.3107476635514,6.33098591549296,998,6.31362725450902
860,139,6.27209302325581,6.39568345323741,999,6.28928928928929
862,136,6.26218097447796,6.36764705882353,998,6.27655310621242
860,138,6.27441860465116,6.40579710144928,998,6.29258517034068
855,144,6.23859649122807,6.43055555555556,999,6.26626626626627
856,143,6.18457943925234,6.3986013986014,999,6.21521521521522
847,150,6.16410861865407,6.32666666666667,997,6.18856569709127
856,142,6.20093457943925,6.52816901408451,998,6.24749498997996
858,140,6.27039627039627,6.62142857142857,998,6.31963927855711
859,139,6.23748544819558,6.56834532374101,998,6.28356713426854
857,142,6.23103850641774,6.61267605633803,999,6.28528528528529
865,134,6.28670520231214,6.40298507462687,999,6.3023023023023
861,137,6.37514518002323,6.40875912408759,998,6.37975951903808
866,133,6.37990762124711,6.40601503759398,999,6.38338338338338
876,123,6.40525114155251,6.39837398373984,999,6.4044044044044
876,121,6.40639269406393,6.50413223140496,997,6.41825476429288
883,115,6.43827859569649,6.57391304347826,998,6.45390781563126
884,115,6.46493212669683,6.58260869565217,999,6.47847847847848
888,111,6.48873873873874,6.4954954954955,999,6.48948948948949
889,110,6.4533183352081,6.49090909090909,999,6.45745745745746
891,108,6.48933782267116,6.55555555555556,999,6.4964964964965
890,108,6.50337078651685,6.5462962962963,998,6.50801603206413
888,111,6.4786036036036,6.6036036036036,999,6.49249249249249
888,111,6.5472972972973,6.55855855855856,999,6.54854854854855
887,111,6.59526493799324,6.61261261261261,998,6.59719438877756
887,110,6.50507328072153,6.56363636363636,997,6.51153460381143
895,102,6.54301675977654,6.32352941176471,997,6.52056168505517
896,101,6.55580357142857,6.37623762376238,997,6.53761283851555
892,105,6.60986547085202,6.43809523809524,997,6.59177532597793
895,101,6.63687150837989,6.54455445544554,996,6.62751004016064
906,92,6.62030905077263,6.6195652173913,998,6.62024048096192
907,91,6.62403528114664,6.63736263736264,998,6.625250501002
902,96,6.60975609756098,6.53125,998,6.60220440881764
898,101,6.61024498886414,6.57425742574257,999,6.60660660660661
904,93,6.59181415929203,6.62365591397849,997,6.59478435305918
904,94,6.5608407079646,6.79787234042553,998,6.58316633266533
911,88,6.52689352360044,6.625,999,6.53553553553554
914,84,6.50875273522976,6.72619047619048,998,6.52705410821643
912,86,6.47478070175439,6.76744186046512,998,6.5
914,84,6.4781181619256,6.70238095238095,998,6.49699398797595
916,83,6.42903930131004,6.73493975903614,999,6.45445445445445
918,80,6.48366013071895,6.8,998,6.50901803607214
925,73,6.47027027027027,6.83561643835616,998,6.49699398797595
927,71,6.47788565264293,6.95774647887324,998,6.51202404809619
928,69,6.45043103448276,6.88405797101449,997,6.48044132397192
927,71,6.46494066882416,7.02816901408451,998,6.50501002004008
932,66,6.48390557939914,7.39393939393939,998,6.54408817635271
937,62,6.52081109925293,7.25806451612903,999,6.56656656656657
935,64,6.48663101604278,7.1875,999,6.53153153153153
936,63,6.52350427350427,7.07936507936508,999,6.55855855855856
937,62,6.51867662753468,6.95161290322581,999,6.54554554554555
940,59,6.52234042553192,6.79661016949153,999,6.53853853853854
938,60,6.55223880597015,6.68333333333333,998,6.56012024048096
938,61,6.61727078891258,6.73770491803279,999,6.62462462462462
935,61,6.64491978609626,6.63934426229508,996,6.64457831325301
944,55,6.64724576271186,6.47272727272727,999,6.63763763763764
943,55,6.61293743372216,6.56363636363636,998,6.61022044088176
942,56,6.59023354564756,6.60714285714286,998,6.59118236472946
946,53,6.61099365750529,6.69811320754717,999,6.61561561561562
947,52,6.59556494192186,6.84615384615385,999,6.60860860860861
947,52,6.54699049630412,6.92307692307692,999,6.56656656656657
952,46,6.57247899159664,6.8695652173913,998,6.58617234468938
957,40,6.59352142110763,7.05,997,6.61183550651956
959,40,6.65797705943691,7.025,999,6.67267267267267
959,40,6.6548488008342,6.775,999,6.65965965965966
961,38,6.67950052029136,6.76315789473684,999,6.68268268268268
961,38,6.69302809573361,6.73684210526316,999,6.69469469469469
963,36,6.64589823468328,7.11111111111111,999,6.66266266266266
962,37,6.66008316008316,7.18918918918919,999,6.67967967967968
965,34,6.65492227979275,7.08823529411765,999,6.66966966966967
966,32,6.62836438923395,7.0625,998,6.64228456913828
969,30,6.59649122807018,7.03333333333333,999,6.60960960960961
971,27,6.62203913491246,7.07407407407407,998,6.63426853707415
973,26,6.61664953751285,6.73076923076923,999,6.61961961961962
968,31,6.56404958677686,6.90322580645161,999,6.57457457457457
964,34,6.56120331950207,7.02941176470588,998,6.57715430861723
966,33,6.54761904761905,6.90909090909091,999,6.55955955955956
969,30,6.47368421052632,7.13333333333333,999,6.49349349349349
969,29,6.48710010319917,7.03448275862069,998,6.50300601202405
969,29,6.45614035087719,7.03448275862069,998,6.47294589178357
971,27,6.48094747682801,6.81481481481481,998,6.48997995991984
972,26,6.47736625514403,6.65384615384615,998,6.48196392785571
970,29,6.48659793814433,6.62068965517241,999,6.49049049049049
973,26,6.50668036998972,6.61538461538461,999,6.50950950950951
973,25,6.5087358684481,6.68,998,6.51302605210421
971,28,6.4778578784758,6.67857142857143,999,6.48348348348348
972,27,6.48251028806584,6.7037037037037,999,6.48848848848849
970,29,6.5020618556701,6.55172413793103,999,6.5035035035035
968,31,6.54648760330578,6.41935483870968,999,6.54254254254254
967,30,6.54395036194416,6.6,997,6.5456369107322
965,33,6.60829015544041,6.60606060606061,998,6.60821643286573
967,31,6.57497414684592,6.25806451612903,998,6.56513026052104
966,31,6.64699792960663,6.48387096774194,997,6.641925777332
970,29,6.69175257731959,6.41379310344828,999,6.68368368368368
971,28,6.63645726055613,6.17857142857143,999,6.62362362362362
972,26,6.65123456790123,6.07692307692308,998,6.63627254509018
974,25,6.63244353182752,5.96,999,6.61561561561562
974,25,6.64168377823409,5.96,999,6.62462462462462
971,27,6.66529351184346,6.40740740740741,998,6.65831663326653
972,27,6.67798353909465,6.44444444444444,999,6.67167167167167
971,28,6.73635427394439,6.53571428571429,999,6.73073073073073
970,28,6.7,6.53571428571429,998,6.69539078156313
971,28,6.74150360453141,6.67857142857143,999,6.73973973973974
974,25,6.72689938398357,6.72,999,6.72672672672673
971,27,6.70854788877446,6.74074074074074,998,6.70941883767535
970,26,6.69072164948454,6.61538461538461,996,6.68875502008032
972,27,6.71913580246914,6.77777777777778,999,6.72072072072072
967,29,6.72078593588418,6.79310344827586,996,6.72289156626506
965,31,6.70051813471503,7.19354838709677,996,6.71586345381526
967,31,6.74043433298862,7.35483870967742,998,6.75951903807615
965,31,6.74611398963731,7.19354838709677,996,6.76004016064257
969,29,6.73787409700722,7.48275862068965,998,6.75951903807615
968,30,6.73037190082645,7.26666666666667,998,6.74649298597194
964,33,6.77489626556017,7.18181818181818,997,6.78836509528586
966,33,6.74534161490683,7.36363636363636,999,6.76576576576577
963,35,6.79023883696781,7.08571428571429,998,6.80060120240481
965,34,6.80829015544041,6.94117647058824,999,6.81281281281281
961,37,6.78772112382934,6.78378378378378,998,6.7875751503006
967,32,6.79834539813857,6.8125,999,6.7987987987988
967,32,6.87280248190279,6.4375,999,6.85885885885886
967,32,6.87073422957601,6.0,999,6.84284284284284
967,32,6.90899689762151,6.3125,999,6.88988988988989
966,32,6.93374741200828,5.96875,998,6.90280561122244
967,31,6.8210961737332,6.0,998,6.79559118236473
970,29,6.85154639175258,5.89655172413793,999,6.82382382382382
971,28,6.80741503604531,5.78571428571429,999,6.77877877877878
969,28,6.80288957688339,5.71428571428571,997,6.77231695085256
971,28,6.75901132852729,5.92857142857143,999,6.73573573573574
970,27,6.78969072164948,6.18518518518519,997,6.77331995987964
970,28,6.78556701030928,5.89285714285714,998,6.76052104208417
972,25,6.76234567901235,6.08,997,6.74523570712136
971,26,6.73532440782698,6.07692307692308,997,6.71815446339017
974,25,6.71457905544148,5.92,999,6.69469469469469
975,22,6.68820512820513,5.90909090909091,997,6.67101303911735
971,26,6.68486096807415,6.34615384615385,997,6.67602808425276
969,29,6.68524251805986,6.51724137931035,998,6.68036072144289
970,29,6.74845360824742,6.55172413793103,999,6.74274274274274
968,30,6.77066115702479,6.66666666666667,998,6.76753507014028
970,29,6.80309278350515,6.68965517241379,999,6.7997997997998
970,29,6.80103092783505,6.6551724137931,999,6.7967967967968
972,26,6.81893004115226,6.53846153846154,998,6.81162324649299
971,27,6.83213182286303,6.66666666666667,998,6.82765531062124
971,28,6.87847579814624,6.60714285714286,999,6.87087087087087
971,28,6.86096807415036,6.60714285714286,999,6.85385385385385
971,28,6.87126673532441,6.64285714285714,999,6.86486486486486
969,30,6.8968008255934,7.03333333333333,999,6.9009009009009
970,29,6.87422680412371,7.10344827586207,999,6.88088088088088
972,27,6.85390946502058,7.25925925925926,999,6.86486486486486
971,28,6.8486096807415,7.32142857142857,999,6.86186186186186
969,30,6.83488132094943,7.33333333333333,999,6.84984984984985
971,28,6.84243048403708,7.35714285714286,999,6.85685685685686
970,29,6.84226804123711,7.10344827586207,999,6.84984984984985
974,25,6.86755646817248,7.44,999,6.88188188188188
973,25,6.86125385405961,7.64,998,6.88076152304609
974,25,6.86036960985626,7.04,999,6.86486486486486
976,23,6.80840163934426,6.78260869565217,999,6.80780780780781
972,27,6.80041152263374,6.85185185185185,999,6.8018018018018
974,25,6.80595482546201,7.04,999,6.81181181181181
975,24,6.76205128205128,7.125,999,6.77077077077077
976,22,6.78176229508197,6.95454545454545,998,6.78557114228457
977,21,6.78812691914023,7.04761904761905,998,6.7935871743487
977,22,6.80245649948823,6.72727272727273,999,6.8008008008008
976,23,6.80020491803279,6.82608695652174,999,6.8008008008008
975,24,6.82461538461538,6.75,999,6.82282282282282
973,25,6.85817060637205,6.68,998,6.85370741482966
974,24,6.87577002053388,6.54166666666667,998,6.86773547094188
972,27,6.87242798353909,6.7037037037037,999,6.86786786786787
970,27,6.87422680412371,6.92592592592593,997,6.87562688064193
971,27,6.88259526261586,6.74074074074074,998,6.87875751503006
971,28,6.85993820803296,6.67857142857143,999,6.85485485485485
971,27,6.85478887744593,6.55555555555556,998,6.84669338677355
973,26,6.87667009249743,6.80769230769231,999,6.87487487487487
974,24,6.91067761806982,6.75,998,6.90681362725451
971,28,6.94953656024717,6.82142857142857,999,6.94594594594595
971,27,6.90937178166838,6.74074074074074,998,6.90480961923848
971,27,6.93202883625129,6.74074074074074,998,6.92685370741483
973,24,6.9054470709147,6.75,997,6.90170511534604
973,24,6.95580678314491,7.16666666666667,997,6.96088264794383
975,23,6.90666666666667,7.0,998,6.90881763527054
977,22,6.97543500511771,7.09090909090909,999,6.97797797797798
978,20,6.99795501022495,7.05,998,6.99899799599198
977,21,6.99488229273286,7.19047619047619,998,6.99899799599198
973,23,7.05035971223022,7.1304347826087,996,7.05220883534137
973,24,7.04933196300103,7.04166666666667,997,7.04914744232698
975,22,7.04512820512821,7.04545454545455,997,7.04513540621866
977,22,7.01023541453429,7.31818181818182,999,7.01701701701702
975,24,7.00307692307692,7.125,999,7.00600600600601
974,23,7.00616016427105,7.21739130434783,997,7.01103309929789
971,25,6.98970133882595,7.04,996,6.99096385542169
973,25,6.99075025693731,7.0,998,6.99098196392786
970,26,6.98556701030928,6.92307692307692,996,6.98393574297189
970,27,6.92783505154639,7.07407407407407,997,6.93179538615848
972,26,6.92901234567901,6.92307692307692,998,6.92885771543086
972,25,6.88991769547325,7.0,997,6.89267803410231
968,28,6.87913223140496,6.78571428571429,996,6.87650602409639
972,27,6.88786008230453,6.88888888888889,999,6.88788788788789
973,26,6.87667009249743,6.61538461538461,999,6.86986986986987
976,22,6.86885245901639,6.5,998,6.86072144288577
978,21,6.77914110429448,6.61904761904762,999,6.77577577577578
976,22,6.74897540983607,6.54545454545455,998,6.74448897795591
979,20,6.77936670071502,6.95,999,6.78278278278278
974,23,6.78439425051335,6.91304347826087,997,6.78736208625878
974,25,6.80903490759754,6.96,999,6.81281281281281
974,24,6.84804928131417,6.83333333333333,998,6.84769539078156
975,22,6.87589743589744,6.77272727272727,997,6.87362086258776
977,21,6.9007164790174,7.14285714285714,998,6.90581162324649
974,24,6.92197125256673,7.29166666666667,998,6.93086172344689
974,23,6.91273100616016,7.60869565217391,997,6.92878635907723
973,24,6.91161356628983,7.5,997,6.92577733199599
977,21,6.90890481064483,7.61904761904762,998,6.92384769539078
980,19,6.91122448979592,7.36842105263158,999,6.91991991991992
978,20,6.87321063394683,7.25,998,6.88076152304609
980,19,6.8765306122449,7.36842105263158,999,6.88588588588589
976,21,6.8094262295082,7.14285714285714,997,6.81644934804413
978,20,6.79856850715746,7.0,998,6.80260521042084
980,19,6.81224489795918,7.10526315789474,999,6.81781781781782
979,20,6.75178753830439,7.0,999,6.75675675675676
979,18,6.80490296220633,6.66666666666667,997,6.802407221665
980,18,6.78571428571429,6.38888888888889,998,6.77855711422846
977,20,6.79222108495394,6.25,997,6.78134403209629
978,21,6.80981595092025,6.42857142857143,999,6.8018018018018
975,23,6.81025641025641,6.52173913043478,998,6.80360721442886
976,23,6.84631147540984,6.52173913043478,999,6.83883883883884
973,25,6.87255909558068,6.4,998,6.86072144288577
977,22,6.89866939611054,5.90909090909091,999,6.87687687687688
979,20,6.85597548518897,5.75,999,6.83383383383383
978,21,6.87321063394683,5.95238095238095,999,6.85385385385385
977,20,6.87615148413511,6.25,997,6.86359077231695
978,21,6.88445807770961,6.19047619047619,999,6.86986986986987
978,21,6.90184049079755,5.95238095238095,999,6.88188188188188
979,20,6.89581205311542,5.75,999,6.87287287287287
979,20,6.9632277834525,6.0,999,6.94394394394394
980,19,7.00102040816327,6.05263157894737,999,6.98298298298298
982,16,7.04073319755601,5.9375,998,7.02304609218437
980,18,7.03367346938775,6.11111111111111,998,7.01703406813627
981,18,6.99796126401631,6.94444444444444,999,6.996996996997
980,19,6.96836734693878,6.84210526315789,999,6.96596596596597
981,17,7.02140672782875,7.05882352941176,998,7.02204408817635
981,18,7.04383282364934,6.94444444444444,999,7.04204204204204
981,17,7.02344546381244,7.05882352941176,998,7.02404809619238
982,16,7.0030549898167,7.1875,998,7.0060120240481
982,16,7.02749490835031,7.1875,998,7.03006012024048
982,17,7.05193482688391,7.64705882352941,999,7.06206206206206
982,16,7.05702647657841,7.5,998,7.06412825651303
986,13,7.05578093306288,7.30769230769231,999,7.05905905905906
986,13,7.05070993914807,7.30769230769231,999,7.05405405405405
987,11,7.08206686930091,7.72727272727273,998,7.08917835671343
986,12,7.10141987829615,7.91666666666667,998,7.11122244488978
985,14,7.1238578680203,7.85714285714286,999,7.13413413413413
983,14,7.12105798575788,7.85714285714286,997,7.13139418254764
984,14,7.10264227642276,7.85714285714286,998,7.11322645290581
985,14,7.10355329949239,7.5,999,7.10910910910911
985,14,7.04670050761421,7.5,999,7.05305305305305
984,14,6.9989837398374,7.85714285714286,998,7.01102204408818
985,14,6.96142131979695,7.85714285714286,999,6.97397397397397
983,14,6.96439471007121,8.21428571428571,997,6.98194583751254
981,15,6.91539245667686,8.0,996,6.93172690763052
983,15,6.85859613428281,8.0,998,6.87575150300601
985,14,6.82233502538071,7.85714285714286,999,6.83683683683684
985,13,6.79086294416244,7.69230769230769,998,6.80260521042084
984,14,6.79979674796748,7.5,998,6.80961923847695
987,12,6.78216818642351,7.5,999,6.79079079079079
986,13,6.75050709939148,7.30769230769231,999,6.75775775775776
986,11,6.69776876267748,7.27272727272727,997,6.70411233701103
987,12,6.66970618034448,7.08333333333333,999,6.67467467467467
983,16,6.70498474059003,6.875,999,6.70770770770771
985,14,6.70862944162437,6.78571428571429,999,6.70970970970971
985,14,6.71065989847716,6.42857142857143,999,6.70670670670671
984,14,6.76321138211382,6.78571428571429,998,6.76352705410822
985,13,6.79492385786802,6.53846153846154,998,6.79158316633267
982,16,6.78309572301426,6.25,998,6.77454909819639
983,16,6.78942014242116,6.25,999,6.78078078078078
980,17,6.80816326530612,5.88235294117647,997,6.79237713139418
977,21,6.8157625383828,6.42857142857143,998,6.80761523046092
982,16,6.85336048879837,6.25,998,6.8436873747495
981,17,6.81651376146789,6.17647058823529,998,6.80561122244489
980,17,6.89489795918367,6.47058823529412,997,6.8876629889669
979,19,6.89479060265577,6.31578947368421,998,6.88376753507014
981,18,6.94495412844037,6.38888888888889,999,6.93493493493493
980,18,6.9969387755102,6.38888888888889,998,6.98597194388778
981,18,6.98369011213048,6.66666666666667,999,6.97797797797798
981,17,6.94393476044852,6.76470588235294,998,6.94088176352705
979,19,6.91930541368744,6.84210526315789,998,6.91783567134269
979,19,6.93564862104188,6.84210526315789,998,6.93386773547094
977,21,6.88126919140225,6.90476190476191,998,6.88176352705411
976,21,6.88627049180328,6.90476190476191,997,6.88665997993982
978,21,6.94376278118609,6.90476190476191,999,6.94294294294294
979,19,6.9805924412666,6.84210526315789,998,6.97795591182365
980,19,6.98061224489796,6.84210526315789,999,6.97797797797798
981,17,7.00713557594292,6.76470588235294,998,7.00300601202405
982,17,7.03360488798371,6.47058823529412,999,7.02402402402402
982,17,7.07128309572301,6.76470588235294,999,7.06606606606607
980,19,7.08673469387755,6.57894736842105,999,7.07707707707708
979,18,7.06026557711951,6.38888888888889,997,7.0481444332999
980,18,7.08367346938776,6.66666666666667,998,7.07615230460922
979,20,7.03575076608784,6.75,999,7.03003003003003
982,17,7.02749490835031,6.47058823529412,999,7.01801801801802
983,16,6.98880976602238,6.5625,999,6.98198198198198
983,15,7.00203458799593,6.66666666666667,998,6.99699398797595
983,16,6.99389623601221,6.5625,999,6.98698698698699
982,17,6.95417515274949,6.76470588235294,999,6.95095095095095
984,15,6.96646341463415,7.33333333333333,999,6.97197197197197
988,11,6.91902834008097,7.27272727272727,999,6.92292292292292
985,12,6.90355329949239,7.5,997,6.91073219658977
986,12,6.88640973630832,7.08333333333333,998,6.88877755511022
987,12,6.89868287740628,7.08333333333333,999,6.9009009009009
990,9,6.85454545454545,7.22222222222222,999,6.85785785785786
989,10,6.80485338725986,7.0,999,6.80680680680681
989,10,6.85945399393327,7.0,999,6.86086086086086
987,11,6.87639311043566,7.27272727272727,998,6.88076152304609
985,12,6.81116751269036,7.08333333333333,997,6.81444332998997
985,13,6.81624365482234,7.30769230769231,998,6.82264529058116
986,13,6.81338742393509,6.92307692307692,999,6.81481481481481
985,14,6.8507614213198,7.14285714285714,999,6.85485485485485
985,13,6.84467005076142,6.92307692307692,998,6.84569138276553
987,12,6.83789260385005,6.66666666666667,999,6.83583583583584
987,12,6.86018237082067,6.66666666666667,999,6.85785785785786
984,14,6.83943089430894,6.42857142857143,998,6.83366733466934
983,15,6.82604272634791,6.66666666666667,998,6.82364729458918
983,15,6.84740590030519,6.66666666666667,998,6.84468937875751
984,14,6.88109756097561,6.78571428571429,998,6.87975951903808
985,13,6.88121827411168,6.92307692307692,998,6.88176352705411
985,13,6.8994923857868,6.53846153846154,998,6.89478957915832
986,13,6.91784989858012,6.53846153846154,999,6.91291291291291
987,12,6.91489361702128,6.25,999,6.90690690690691
985,13,6.91675126903553,6.53846153846154,998,6.91182364729459
987,12,6.88855116514691,6.66666666666667,999,6.88588588588589
986,13,6.90669371196755,6.53846153846154,999,6.9019019019019
986,13,6.88742393509128,6.53846153846154,999,6.88288288288288
986,12,6.94320486815416,6.66666666666667,998,6.93987975951904
987,12,6.94630192502533,6.66666666666667,999,6.94294294294294
986,13,6.973630831643,6.92307692307692,999,6.97297297297297
985,13,6.96040609137056,6.92307692307692,998,6.95991983967936
982,15,6.95926680244399,7.33333333333333,997,6.96489468405216
985,12,6.96954314720812,7.08333333333333,997,6.97091273821464
989,10,6.9747219413549,6.5,999,6.96996996996997
988,11,6.90688259109312,6.36363636363636,999,6.9009009009009
987,10,6.93617021276596,6.5,997,6.93179538615848
988,10,6.92206477732794,6.5,998,6.91783567134269
988,10,6.91093117408907,6.5,998,6.90681362725451
990,9,6.88989898989899,6.66666666666667,999,6.88788788788789
989,9,6.90293225480283,7.22222222222222,998,6.90581162324649
990,7,6.92424242424242,7.85714285714286,997,6.93079237713139
992,7,6.92943548387097,7.85714285714286,999,6.93593593593594
992,7,6.93951612903226,7.85714285714286,999,6.94594594594595
989,7,6.93933265925177,7.85714285714286,996,6.94578313253012
992,7,6.94657258064516,7.85714285714286,999,6.95295295295295
989,7,6.96461071789687,7.14285714285714,996,6.96586345381526
992,6,6.95665322580645,8.33333333333333,998,6.96492985971944
994,5,6.98893360160966,9.0,999,6.998998998999
992,6,7.05342741935484,8.33333333333333,998,7.06112224448898
993,6,7.05941591137966,8.33333333333333,999,7.06706706706707
992,7,7.08064516129032,7.85714285714286,999,7.08608608608609
990,8,7.09292929292929,7.5,998,7.09619238476954
992,6,7.12903225806452,7.5,998,7.1312625250501
990,6,7.14444444444444,6.66666666666667,996,7.14156626506024
993,5,7.12890231621349,7.0,998,7.12825651302605
994,5,7.18108651911469,7.0,999,7.18018018018018
993,6,7.15407854984894,6.66666666666667,999,7.15115115115115
992,6,7.12903225806452,6.66666666666667,998,7.12625250501002
995,4,7.18291457286432,7.5,999,7.18418418418418
994,5,7.17002012072435,7.0,999,7.16916916916917
993,5,7.1238670694864,7.0,998,7.12324649298597
994,5,7.08551307847083,7.0,999,7.08508508508509
992,6,7.09576612903226,6.66666666666667,998,7.09318637274549
992,7,7.09173387096774,6.42857142857143,999,7.08708708708709
991,7,7.06659939455096,6.42857142857143,998,7.06212424849699
991,8,7.09586276488396,6.25,999,7.08908908908909
992,6,7.06854838709677,6.66666666666667,998,7.06613226452906
992,7,7.04838709677419,6.42857142857143,999,7.04404404404404
992,7,7.03427419354839,6.42857142857143,999,7.03003003003003
991,8,6.99899091826438,6.25,999,6.99299299299299
990,9,7.0030303030303,6.11111111111111,999,6.99499499499499
991,8,7.02623612512614,5.625,999,7.01501501501502
990,8,7.00707070707071,5.625,998,6.99599198396794
991,8,7.00908173562059,5.625,999,6.997997997998
990,8,6.97474747474747,5.625,998,6.96392785571142
989,9,6.93427704752275,5.55555555555556,998,6.92184368737475
991,8,6.90514631685167,5.0,999,6.88988988988989
991,7,7.01513622603431,5.0,998,7.00100200400802
989,8,7.01213346814965,5.625,997,7.00100300902708
989,9,6.95449949443883,6.11111111111111,998,6.94689378757515
990,9,6.93737373737374,6.11111111111111,999,6.92992992992993
989,10,6.98887765419616,6.5,999,6.98398398398398
987,10,6.9726443768997,6.5,997,6.9679037111334
987,9,7.00202634245187,6.66666666666667,996,6.99899598393574
990,9,7.03232323232323,6.66666666666667,999,7.02902902902903
990,9,7.04141414141414,6.66666666666667,999,7.03803803803804
988,10,6.99696356275304,7.0,998,6.99699398797595
988,10,6.98785425101215,7.5,998,6.99298597194389
988,8,7.04959514170041,8.125,996,7.05823293172691
992,7,7.04133064516129,7.85714285714286,999,7.04704704704705
993,6,7.06344410876133,7.5,999,7.06606606606607
993,6,7.00503524672709,7.5,999,7.00800800800801
989,7,7.04853387259858,7.85714285714286,996,7.05421686746988
992,6,7.00302419354839,7.5,998,7.0060120240481
995,4,7.0251256281407,7.5,999,7.02702702702703
993,4,7.05337361530715,7.5,997,7.05516549648947
995,4,7.04522613065327,7.5,999,7.04704704704705
994,4,7.12072434607646,7.5,998,7.12224448897796
993,5,7.10271903323263,8.0,998,7.10721442885772
994,5,7.10362173038229,8.0,999,7.10810810810811
993,6,7.10070493454179,8.33333333333333,999,7.10810810810811
992,6,7.10685483870968,8.33333333333333,998,7.11422845691383
993,6,7.11178247734139,7.5,999,7.11411411411411
993,6,7.12789526686808,7.5,999,7.13013013013013
993,6,7.0956696878147,7.5,999,7.0980980980981
993,6,7.12185297079557,6.66666666666667,999,7.11911911911912
992,7,7.15625,7.14285714285714,999,7.15615615615616
991,6,7.15338042381433,6.66666666666667,997,7.15045135406219
994,5,7.13983903420523,7.0,999,7.13913913913914
994,5,7.14989939637827,7.0,999,7.14914914914915
996,3,7.17670682730924,8.33333333333333,999,7.18018018018018
996,3,7.17871485943775,8.33333333333333,999,7.18218218218218
996,3,7.14859437751004,8.33333333333333,999,7.15215215215215
995,2,7.10954773869347,7.5,997,7.11033099297894
995,2,7.16884422110553,7.5,997,7.16950852557673
995,2,7.12562814070352,7.5,997,7.12637913741224
996,3,7.05823293172691,8.33333333333333,999,7.06206206206206
995,3,7.03115577889447,8.33333333333333,998,7.03507014028056
994,3,7.04828973843058,8.33333333333333,997,7.05215646940822
995,3,7.04522613065327,8.33333333333333,998,7.04909819639279
995,2,7.01407035175879,7.5,997,7.01504513540622
996,2,6.93975903614458,7.5,998,6.94088176352705
996,2,6.94076305220884,7.5,998,6.94188376753507
995,2,6.8964824120603,7.5,997,6.89769307923771
997,2,6.89468405215647,10.0,999,6.9009009009009
996,2,6.8995983935743,7.5,998,6.90080160320641
997,2,6.89167502507523,7.5,999,6.89289289289289
997,2,6.89969909729188,7.5,999,6.9009009009009
995,2,6.89045226130653,5.0,997,6.88665997993982
995,1,6.89145728643216,5.0,996,6.88955823293173
998,1,6.91683366733467,5.0,999,6.91491491491491
998,1,6.89278557114228,5.0,999,6.89089089089089
999,0,6.91391391391391,NaN,999,6.91391391391391
999,0,6.97597597597598,NaN,999,6.97597597597598
999,0,7.001001001001,NaN,999,7.001001001001
998,0,7.00100200400802,NaN,998,7.00100200400802
999,0,7.02702702702703,NaN,999,7.02702702702703
998,0,7.02304609218437,NaN,998,7.02304609218437
998,0,7.01202404809619,NaN,998,7.01202404809619
999,0,7.01001001001001,NaN,999,7.01001001001001
997,0,6.99799398194584,NaN,997,6.99799398194584
998,0,7.05410821643287,NaN,998,7.05410821643287
997,0,7.01504513540622,NaN,997,7.01504513540622
998,0,7.03507014028056,NaN,998,7.03507014028056
999,0,7.04704704704705,NaN,999,7.04704704704705
995,0,7.07537688442211,NaN,995,7.07537688442211
999,0,7.10610610610611,NaN,999,7.10610610610611
999,0,7.11011011011011,NaN,999,7.11011011011011
997,0,7.12637913741224,NaN,997,7.12637913741224
998,0,7.12925851703407,NaN,998,7.12925851703407
999,0,7.13713713713714,NaN,999,7.13713713713714
999,0,7.14314314314314,NaN,999,7.14314314314314
999,0,7.12712712712713,NaN,999,7.12712712712713
999,0,7.0950950950951,NaN,999,7.0950950950951
999,0,7.06606606606607,NaN,999,7.06606606606607
999,0,7.05605605605606,NaN,999,7.05605605605606
996,0,7.0793172690763,NaN,996,7.0793172690763
998,0,7.09318637274549,NaN,998,7.09318637274549
999,0,7.09209209209209,NaN,999,7.09209209209209
998,0,7.11823647294589,NaN,998,7.11823647294589
999,0,7.1041041041041,NaN,999,7.1041041041041
999,0,7.10910910910911,NaN,999,7.10910910910911
999,0,7.06206206206206,NaN,999,7.06206206206206
997,0,7.0962888665998,NaN,997,7.0962888665998
997,0,7.06018054162487,NaN,997,7.06018054162487
996,0,7.08132530120482,NaN,996,7.08132530120482
999,0,7.04104104104104,NaN,999,7.04104104104104
999,0,7.04504504504505,NaN,999,7.04504504504505
999,0,6.96696696696697,NaN,999,6.96696696696697
999,0,6.97197197197197,NaN,999,6.97197197197197
999,0,6.95595595595596,NaN,999,6.95595595595596
999,0,6.99399399399399,NaN,999,6.99399399399399
999,0,7.003003003003,NaN,999,7.003003003003
998,0,6.97294589178357,NaN,998,6.97294589178357
999,0,7.01601601601602,NaN,999,7.01601601601602
999,0,7.001001001001,NaN,999,7.001001001001
998,0,7.0310621242485,NaN,998,7.0310621242485
998,0,7.04408817635271,NaN,998,7.04408817635271
997,0,7.11434302908726,NaN,997,7.11434302908726
999,0,7.12512512512513,NaN,999,7.12512512512513
999,0,7.14814814814815,NaN,999,7.14814814814815
996,0,7.17168674698795,NaN,996,7.17168674698795
996,0,7.1636546184739,NaN,996,7.1636546184739
999,0,7.15815815815816,NaN,999,7.15815815815816
999,0,7.18518518518519,NaN,999,7.18518518518519
996,0,7.19879518072289,NaN,996,7.19879518072289
998,0,7.24148296593186,NaN,998,7.24148296593186
998,0,7.22144288577154,NaN,998,7.22144288577154
998,0,7.23847695390782,NaN,998,7.23847695390782
998,0,7.23947895791583,NaN,998,7.23947895791583
999,0,7.28728728728729,NaN,999,7.28728728728729
999,0,7.31331331331331,NaN,999,7.31331331331331
998,0,7.26553106212425,NaN,998,7.26553106212425
998,0,7.27454909819639,NaN,998,7.27454909819639
998,0,7.27054108216433,NaN,998,7.27054108216433
998,0,7.27354709418838,NaN,998,7.27354709418838
999,0,7.32732732732733,NaN,999,7.32732732732733
998,0,7.2935871743487,NaN,998,7.2935871743487
998,0,7.30460921843687,NaN,998,7.30460921843687
998,0,7.25450901803607,NaN,998,7.25450901803607
998,0,7.21543086172345,NaN,998,7.21543086172345
997,0,7.22066198595787,NaN,997,7.22066198595787
998,0,7.1563126252505,NaN,998,7.1563126252505
997,0,7.14042126379137,NaN,997,7.14042126379137
999,0,7.14514514514515,NaN,999,7.14514514514515
999,0,7.14014014014014,NaN,999,7.14014014014014
998,0,7.125250501002,NaN,998,7.125250501002
998,0,7.15531062124249,NaN,998,7.15531062124249
999,0,7.08308308308308,NaN,999,7.08308308308308
999,0,7.08508508508509,NaN,999,7.08508508508509
999,0,7.03503503503504,NaN,999,7.03503503503504
997,0,7.04413239719158,NaN,997,7.04413239719158
997,0,7.00902708124373,NaN,997,7.00902708124373
997,0,7.00300902708124,NaN,997,7.00300902708124
998,0,6.97094188376754,NaN,998,6.97094188376754
999,0,6.96596596596597,NaN,999,6.96596596596597
999,0,6.94794794794795,NaN,999,6.94794794794795
999,0,6.95195195195195,NaN,999,6.95195195195195
999,0,6.98998998998999,NaN,999,6.98998998998999
999,0,6.99199199199199,NaN,999,6.99199199199199
998,0,6.97895791583166,NaN,998,6.97895791583166
999,0,7.01201201201201,NaN,999,7.01201201201201
999,0,6.98498498498498,NaN,999,6.98498498498498
998,0,6.96793587174349,NaN,998,6.96793587174349
999,0,6.97997997997998,NaN,999,6.97997997997998
999,0,7.03903903903904,NaN,999,7.03903903903904
996,0,7.01606425702811,NaN,996,7.01606425702811
999,0,7.02002002002002,NaN,999,7.02002002002002
999,0,7.02602602602603,NaN,999,7.02602602602603
999,0,7.03603603603604,NaN,999,7.03603603603604
999,0,7.03203203203203,NaN,999,7.03203203203203
999,0,7.08308308308308,NaN,999,7.08308308308308
997,0,7.14643931795386,NaN,997,7.14643931795386
999,0,7.11611611611612,NaN,999,7.11611611611612
998,0,7.1122244488978,NaN,998,7.1122244488978
999,0,7.0990990990991,NaN,999,7.0990990990991
998,0,7.1312625250501,NaN,998,7.1312625250501
996,0,7.15160642570281,NaN,996,7.15160642570281
999,0,7.04104104104104,NaN,999,7.04104104104104
998,0,7.00901803607214,NaN,998,7.00901803607214
999,0,7.01901901901902,NaN,999,7.01901901901902
999,0,7.02502502502503,NaN,999,7.02502502502503
999,0,7.02702702702703,NaN,999,7.02702702702703
999,0,7.04204204204204,NaN,999,7.04204204204204
999,0,7.03803803803804,NaN,999,7.03803803803804
995,0,7.0713567839196,NaN,995,7.0713567839196
997,0,7.04613841524574,NaN,997,7.04613841524574
999,0,7.07307307307307,NaN,999,7.07307307307307
999,0,7.06206206206206,NaN,999,7.06206206206206
997,0,7.08124373119358,NaN,997,7.08124373119358
997,0,7.13139418254764,NaN,997,7.13139418254764
999,0,7.14614614614615,NaN,999,7.14614614614615
998,0,7.14028056112224,NaN,998,7.14028056112224
999,0,7.14114114114114,NaN,999,7.14114114114114
998,0,7.12424849699399,NaN,998,7.12424849699399
999,0,7.12912912912913,NaN,999,7.12912912912913
998,0,7.19539078156313,NaN,998,7.19539078156313
999,0,7.21121121121121,NaN,999,7.21121121121121
999,0,7.26526526526527,NaN,999,7.26526526526527
999,0,7.25025025025025,NaN,999,7.25025025025025
996,0,7.25903614457831,NaN,996,7.25903614457831
999,0,7.26426426426426,NaN,999,7.26426426426426
999,0,7.27927927927928,NaN,999,7.27927927927928
999,0,7.24824824824825,NaN,999,7.24824824824825
998,0,7.27955911823647,NaN,998,7.27955911823647
998,0,7.2434869739479,NaN,998,7.2434869739479
999,0,7.25925925925926,NaN,999,7.25925925925926
998,0,7.23246492985972,NaN,998,7.23246492985972
999,0,7.21221221221221,NaN,999,7.21221221221221
999,0,7.24324324324324,NaN,999,7.24324324324324
998,0,7.19539078156313,NaN,998,7.19539078156313
998,0,7.125250501002,NaN,998,7.125250501002
999,0,7.13413413413413,NaN,999,7.13413413413413
999,0,7.14414414414414,NaN,999,7.14414414414414
999,0,7.13413413413413,NaN,999,7.13413413413413
999,0,7.12612612612613,NaN,999,7.12612612612613
999,0,7.0960960960961,NaN,999,7.0960960960961
999,0,7.1041041041041,NaN,999,7.1041041041041
999,0,7.05905905905906,NaN,999,7.05905905905906
999,0,7.04704704704705,NaN,999,7.04704704704705
999,0,7.003003003003,NaN,999,7.003003003003
997,0,6.97993981945837,NaN,997,6.97993981945837
997,0,6.97492477432297,NaN,997,6.97492477432297
997,0,6.92978936810431,NaN,997,6.92978936810431
999,0,6.97597597597598,NaN,999,6.97597597597598
998,0,6.94288577154309,NaN,998,6.94288577154309
997,0,7.00802407221665,NaN,997,7.00802407221665
999,0,6.97997997997998,NaN,999,6.97997997997998
997,0,6.9518555667001,NaN,997,6.9518555667001
999,0,6.94494494494494,NaN,999,6.94494494494494
999,0,6.96696696696697,NaN,999,6.96696696696697
998,0,6.90180360721443,NaN,998,6.90180360721443
997,0,6.93279839518556,NaN,997,6.93279839518556
999,0,7.002002002002,NaN,999,7.002002002002
999,0,6.96096096096096,NaN,999,6.96096096096096
997,0,7.00501504513541,NaN,997,7.00501504513541
997,0,7.01805416248746,NaN,997,7.01805416248746
998,0,7.03707414829659,NaN,998,7.03707414829659
998,0,7.07414829659319,NaN,998,7.07414829659319
999,0,7.04704704704705,NaN,999,7.04704704704705
998,0,7.05110220440882,NaN,998,7.05110220440882
999,0,7.0990990990991,NaN,999,7.0990990990991
999,0,7.11211211211211,NaN,999,7.11211211211211
999,0,7.10710710710711,NaN,999,7.10710710710711
999,0,7.07507507507508,NaN,999,7.07507507507508
999,0,7.02502502502503,NaN,999,7.02502502502503
998,0,7.02204408817635,NaN,998,7.02204408817635
999,0,7.04604604604605,NaN,999,7.04604604604605
996,0,7.10843373493976,NaN,996,7.10843373493976
998,0,7.07014028056112,NaN,998,7.07014028056112
999,0,7.06006006006006,NaN,999,7.06006006006006
998,0,7.08016032064128,NaN,998,7.08016032064128
997,0,7.08625877632899,NaN,997,7.08625877632899
999,0,7.09209209209209,NaN,999,7.09209209209209
998,0,7.06913827655311,NaN,998,7.06913827655311
999,0,7.14414414414414,NaN,999,7.14414414414414
999,0,7.1991991991992,NaN,999,7.1991991991992
998,0,7.18537074148297,NaN,998,7.18537074148297
999,0,7.22722722722723,NaN,999,7.22722722722723
999,0,7.23223223223223,NaN,999,7.23223223223223
999,0,7.28428428428428,NaN,999,7.28428428428428
999,0,7.27727727727728,NaN,999,7.27727727727728
999,0,7.24124124124124,NaN,999,7.24124124124124
999,0,7.23523523523524,NaN,999,7.23523523523524
999,0,7.25925925925926,NaN,999,7.25925925925926
997,0,7.20260782347041,NaN,997,7.20260782347041
999,0,7.23723723723724,NaN,999,7.23723723723724
999,0,7.22322322322322,NaN,999,7.22322322322322
999,0,7.22722722722723,NaN,999,7.22722722722723
998,0,7.17434869739479,NaN,998,7.17434869739479
998,0,7.18036072144289,NaN,998,7.18036072144289
998,0,7.19038076152305,NaN,998,7.19038076152305
999,0,7.17917917917918,NaN,999,7.17917917917918
998,0,7.16032064128257,NaN,998,7.16032064128257
999,0,7.14114114114114,NaN,999,7.14114114114114
999,0,7.12812812812813,NaN,999,7.12812812812813
998,0,7.15230460921844,NaN,998,7.15230460921844
999,0,7.13813813813814,NaN,999,7.13813813813814
999,0,7.13613613613614,NaN,999,7.13613613613614
999,0,7.1021021021021,NaN,999,7.1021021021021
998,0,7.14929859719439,NaN,998,7.14929859719439
998,0,7.14529058116232,NaN,998,7.14529058116232
997,0,7.13139418254764,NaN,997,7.13139418254764
999,0,7.12612612612613,NaN,999,7.12612612612613
997,0,7.11534603811434,NaN,997,7.11534603811434
997,0,7.08525576730191,NaN,997,7.08525576730191
999,0,7.04204204204204,NaN,999,7.04204204204204
998,0,7.0060120240481,NaN,998,7.0060120240481
998,0,6.97394789579158,NaN,998,6.97394789579158
998,0,7.00200400801603,NaN,998,7.00200400801603
998,0,6.97895791583166,NaN,998,6.97895791583166
998,0,6.96392785571142,NaN,998,6.96392785571142
997,0,7.04513540621866,NaN,997,7.04513540621866
999,0,7.01701701701702,NaN,999,7.01701701701702
997,0,7.03911735205617,NaN,997,7.03911735205617
998,0,7.03006012024048,NaN,998,7.03006012024048
999,0,6.99099099099099,NaN,999,6.99099099099099
999,0,6.98898898898899,NaN,999,6.98898898898899
998,0,6.98296593186373,NaN,998,6.98296593186373
998,0,6.99098196392786,NaN,998,6.99098196392786
999,0,7.04004004004004,NaN,999,7.04004004004004
998,0,7.03707414829659,NaN,998,7.03707414829659
998,0,7.03306613226453,NaN,998,7.03306613226453
997,0,7.06920762286861,NaN,997,7.06920762286861
999,0,7.07507507507508,NaN,999,7.07507507507508
999,0,7.06906906906907,NaN,999,7.06906906906907
998,0,7.08416833667335,NaN,998,7.08416833667335
998,0,7.12925851703407,NaN,998,7.12925851703407
998,0,7.09118236472946,NaN,998,7.09118236472946
998,0,7.12124248496994,NaN,998,7.12124248496994
999,0,7.14114114114114,NaN,999,7.14114114114114
996,0,7.21586345381526,NaN,996,7.21586345381526
999,0,7.2042042042042,NaN,999,7.2042042042042
998,0,7.20541082164329,NaN,998,7.20541082164329
998,0,7.16933867735471,NaN,998,7.16933867735471
997,0,7.18455366098295,NaN,997,7.18455366098295
999,0,7.23623623623624,NaN,999,7.23623623623624
999,0,7.24724724724725,NaN,999,7.24724724724725
999,0,7.25125125125125,NaN,999,7.25125125125125
998,0,7.27454909819639,NaN,998,7.27454909819639
999,0,7.24924924924925,NaN,999,7.24924924924925
999,0,7.28928928928929,NaN,999,7.28928928928929
997,0,7.25275827482447,NaN,997,7.25275827482447
998,0,7.2434869739479,NaN,998,7.2434869739479
997,0,7.20060180541625,NaN,997,7.20060180541625
999,0,7.17517517517518,NaN,999,7.17517517517518
998,0,7.16432865731463,NaN,998,7.16432865731463
999,0,7.18918918918919,NaN,999,7.18918918918919
999,0,7.20820820820821,NaN,999,7.20820820820821
999,0,7.18318318318318,NaN,999,7.18318318318318
998,0,7.16132264529058,NaN,998,7.16132264529058
999,0,7.14914914914915,NaN,999,7.14914914914915
999,0,7.11211211211211,NaN,999,7.11211211211211
998,0,7.08917835671343,NaN,998,7.08917835671343
998,0,7.04809619238477,NaN,998,7.04809619238477
998,0,7.00300601202405,NaN,998,7.00300601202405
998,0,7.0,NaN,998,7.0
999,0,7.03803803803804,NaN,999,7.03803803803804
996,0,7.00803212851406,NaN,996,7.00803212851406
997,0,7.04112337011033,NaN,997,7.04112337011033
997,0,7.05015045135406,NaN,997,7.05015045135406
998,0,7.06212424849699,NaN,998,7.06212424849699
998,0,7.06613226452906,NaN,998,7.06613226452906
998,0,7.10120240480962,NaN,998,7.10120240480962
998,0,7.05711422845691,NaN,998,7.05711422845691
999,0,7.05505505505506,NaN,999,7.05505505505506
998,0,7.04709418837675,NaN,998,7.04709418837675
999,0,7.07307307307307,NaN,999,7.07307307307307
999,0,7.07107107107107,NaN,999,7.07107107107107
998,0,7.08717434869739,NaN,998,7.08717434869739
998,0,7.09318637274549,NaN,998,7.09318637274549
997,0,7.05215646940822,NaN,997,7.05215646940822
998,0,7.03406813627254,NaN,998,7.03406813627254
999,0,7.07407407407407,NaN,999,7.07407407407407
997,0,7.1283851554664,NaN,997,7.1283851554664
997,0,7.12236710130391,NaN,997,7.12236710130391
999,0,7.18018018018018,NaN,999,7.18018018018018
998,0,7.16132264529058,NaN,998,7.16132264529058
999,0,7.20720720720721,NaN,999,7.20720720720721
998,0,7.18937875751503,NaN,998,7.18937875751503
999,0,7.24224224224224,NaN,999,7.24224224224224
998,0,7.25050100200401,NaN,998,7.25050100200401
999,0,7.25225225225225,NaN,999,7.25225225225225
999,0,7.19219219219219,NaN,999,7.19219219219219
999,0,7.17017017017017,NaN,999,7.17017017017017
998,0,7.16733466933868,NaN,998,7.16733466933868
999,0,7.11411411411411,NaN,999,7.11411411411411
998,0,7.12725450901804,NaN,998,7.12725450901804
998,0,7.11723446893788,NaN,998,7.11723446893788
997,0,7.18555667001003,NaN,997,7.18555667001003
998,0,7.17835671342685,NaN,998,7.17835671342685
998,0,7.16933867735471,NaN,998,7.16933867735471
998,0,7.19338677354709,NaN,998,7.19338677354709
995,0,7.17085427135678,NaN,995,7.17085427135678
999,0,7.21521521521522,NaN,999,7.21521521521522
997,0,7.20060180541625,NaN,997,7.20060180541625
999,0,7.17917917917918,NaN,999,7.17917917917918
998,0,7.17234468937876,NaN,998,7.17234468937876
999,0,7.18718718718719,NaN,999,7.18718718718719
999,0,7.21521521521522,NaN,999,7.21521521521522
999,0,7.16516516516517,NaN,999,7.16516516516517
998,0,7.14729458917836,NaN,998,7.14729458917836
998,0,7.14228456913828,NaN,998,7.14228456913828
999,0,7.13313313313313,NaN,999,7.13313313313313
997,0,7.09127382146439,NaN,997,7.09127382146439
997,0,7.05717151454363,NaN,997,7.05717151454363
999,0,7.06006006006006,NaN,999,7.06006006006006
998,0,6.96693386773547,NaN,998,6.96693386773547
999,0,6.97497497497497,NaN,999,6.97497497497497
999,0,6.91091091091091,NaN,999,6.91091091091091
999,0,6.9039039039039,NaN,999,6.9039039039039
999,0,6.86886886886887,NaN,999,6.86886886886887
999,0,6.89089089089089,NaN,999,6.89089089089089
999,0,6.87187187187187,NaN,999,6.87187187187187
999,0,6.89289289289289,NaN,999,6.89289289289289
997,0,6.88665997993982,NaN,997,6.88665997993982
998,0,6.8937875751503,NaN,998,6.8937875751503
995,0,6.90050251256281,NaN,995,6.90050251256281
998,0,6.9188376753507,NaN,998,6.9188376753507
999,0,6.92892892892893,NaN,999,6.92892892892893
998,0,6.89779559118236,NaN,998,6.89779559118236
998,0,6.92084168336673,NaN,998,6.92084168336673
996,0,6.90863453815261,NaN,996,6.90863453815261
998,0,6.95190380761523,NaN,998,6.95190380761523
999,0,6.95195195195195,NaN,999,6.95195195195195
999,0,6.97297297297297,NaN,999,6.97297297297297
999,0,6.93993993993994,NaN,999,6.93993993993994
998,0,6.96693386773547,NaN,998,6.96693386773547
999,0,6.98198198198198,NaN,999,6.98198198198198
999,0,6.97897897897898,NaN,999,6.97897897897898
998,0,6.96693386773547,NaN,998,6.96693386773547
999,0,7.03603603603604,NaN,999,7.03603603603604
999,0,7.06706706706707,NaN,999,7.06706706706707
997,0,7.15145436308927,NaN,997,7.15145436308927
999,0,7.21221221221221,NaN,999,7.21221221221221
996,0,7.2429718875502,NaN,996,7.2429718875502
997,0,7.2407221664995,NaN,997,7.2407221664995
999,0,7.32532532532533,NaN,999,7.32532532532533
999,0,7.31531531531532,NaN,999,7.31531531531532
999,0,7.31931931931932,NaN,999,7.31931931931932
999,0,7.28728728728729,NaN,999,7.28728728728729
998,0,7.30961923847695,NaN,998,7.30961923847695
999,0,7.2992992992993,NaN,999,7.2992992992993
999,0,7.31431431431431,NaN,999,7.31431431431431
998,0,7.32464929859719,NaN,998,7.32464929859719
996,0,7.32329317269076,NaN,996,7.32329317269076
999,0,7.32632632632633,NaN,999,7.32632632632633
999,0,7.32932932932933,NaN,999,7.32932932932933
996,0,7.32329317269076,NaN,996,7.32329317269076
999,0,7.3033033033033,NaN,999,7.3033033033033
999,0,7.35235235235235,NaN,999,7.35235235235235
999,0,7.26826826826827,NaN,999,7.26826826826827
996,0,7.27911646586345,NaN,996,7.27911646586345
998,0,7.23647294589178,NaN,998,7.23647294589178
998,0,7.24248496993988,NaN,998,7.24248496993988
999,0,7.22322322322322,NaN,999,7.22322322322322
998,0,7.21142284569138,NaN,998,7.21142284569138
998,0,7.1623246492986,NaN,998,7.1623246492986
999,0,7.13413413413413,NaN,999,7.13413413413413
997,0,7.11735205616851,NaN,997,7.11735205616851
999,0,7.0960960960961,NaN,999,7.0960960960961
998,0,7.11122244488978,NaN,998,7.11122244488978
997,0,7.07823470411234,NaN,997,7.07823470411234
998,0,7.07214428857715,NaN,998,7.07214428857715
999,0,7.12412412412412,NaN,999,7.12412412412412
999,0,7.11911911911912,NaN,999,7.11911911911912
996,0,7.06726907630522,NaN,996,7.06726907630522
998,0,7.08216432865731,NaN,998,7.08216432865731
999,0,7.04004004004004,NaN,999,7.04004004004004
997,0,7.01805416248746,NaN,997,7.01805416248746
998,0,6.99198396793587,NaN,998,6.99198396793587
998,0,6.9749498997996,NaN,998,6.9749498997996
999,0,6.96996996996997,NaN,999,6.96996996996997
998,0,6.93587174348697,NaN,998,6.93587174348697
999,0,6.94894894894895,NaN,999,6.94894894894895
999,0,6.94594594594595,NaN,999,6.94594594594595
999,0,7.00500500500501,NaN,999,7.00500500500501
999,0,6.98898898898899,NaN,999,6.98898898898899
999,0,7.03803803803804,NaN,999,7.03803803803804
999,0,7.08808808808809,NaN,999,7.08808808808809
997,0,7.0802407221665,NaN,997,7.0802407221665
997,0,7.07622868605817,NaN,997,7.07622868605817
998,0,7.11322645290581,NaN,998,7.11322645290581
997,0,7.10631895687061,NaN,997,7.10631895687061
999,0,7.06206206206206,NaN,999,7.06206206206206
999,0,7.10710710710711,NaN,999,7.10710710710711
999,0,7.11711711711712,NaN,999,7.11711711711712
999,0,7.19019019019019,NaN,999,7.19019019019019
999,0,7.14214214214214,NaN,999,7.14214214214214
998,0,7.16332665330661,NaN,998,7.16332665330661
999,0,7.14214214214214,NaN,999,7.14214214214214
999,0,7.21321321321321,NaN,999,7.21321321321321
999,0,7.23723723723724,NaN,999,7.23723723723724
999,0,7.28328328328328,NaN,999,7.28328328328328
999,0,7.25225225225225,NaN,999,7.25225225225225
999,0,7.27627627627628,NaN,999,7.27627627627628
998,0,7.26052104208417,NaN,998,7.26052104208417
998,0,7.26553106212425,NaN,998,7.26553106212425
999,0,7.25325325325325,NaN,999,7.25325325325325
999,0,7.22822822822823,NaN,999,7.22822822822823
998,0,7.22244488977956,NaN,998,7.22244488977956
999,0,7.20920920920921,NaN,999,7.20920920920921
999,0,7.19119119119119,NaN,999,7.19119119119119
997,0,7.1444332998997,NaN,997,7.1444332998997
997,0,7.14643931795386,NaN,997,7.14643931795386
999,0,7.1041041041041,NaN,999,7.1041041041041
995,0,7.08341708542714,NaN,995,7.08341708542714
998,0,7.07314629258517,NaN,998,7.07314629258517
998,0,7.05210420841683,NaN,998,7.05210420841683
999,0,6.98998998998999,NaN,999,6.98998998998999
998,0,6.98196392785571,NaN,998,6.98196392785571
999,0,6.97497497497497,NaN,999,6.97497497497497
998,0,6.98296593186373,NaN,998,6.98296593186373
998,0,6.97895791583166,NaN,998,6.97895791583166
999,0,6.97097097097097,NaN,999,6.97097097097097
998,0,6.96793587174349,NaN,998,6.96793587174349
998,0,6.9939879759519,NaN,998,6.9939879759519
999,0,6.97597597597598,NaN,999,6.97597597597598
999,0,6.95795795795796,NaN,999,6.95795795795796
998,0,7.01002004008016,NaN,998,7.01002004008016
999,0,7.003003003003,NaN,999,7.003003003003
999,0,7.06406406406406,NaN,999,7.06406406406406
999,0,7.01201201201201,NaN,999,7.01201201201201
999,0,7.07607607607608,NaN,999,7.07607607607608
994,0,7.04024144869215,NaN,994,7.04024144869215
995,0,7.11356783919598,NaN,995,7.11356783919598
999,0,7.12312312312312,NaN,999,7.12312312312312
997,0,7.14242728184554,NaN,997,7.14242728184554
998,0,7.19138276553106,NaN,998,7.19138276553106
999,0,7.19419419419419,NaN,999,7.19419419419419
999,0,7.18818818818819,NaN,999,7.18818818818819
999,0,7.17817817817818,NaN,999,7.17817817817818
998,0,7.19539078156313,NaN,998,7.19539078156313
999,0,7.18318318318318,NaN,999,7.18318318318318
999,0,7.18418418418418,NaN,999,7.18418418418418
999,0,7.23023023023023,NaN,999,7.23023023023023
995,0,7.29949748743719,NaN,995,7.29949748743719
996,0,7.32730923694779,NaN,996,7.32730923694779
998,0,7.33667334669339,NaN,998,7.33667334669339
999,0,7.33633633633634,NaN,999,7.33633633633634
998,0,7.32965931863727,NaN,998,7.32965931863727
999,0,7.34234234234234,NaN,999,7.34234234234234
998,0,7.2625250501002,NaN,998,7.2625250501002
999,0,7.26826826826827,NaN,999,7.26826826826827
998,0,7.2124248496994,NaN,998,7.2124248496994
997,0,7.18956870611836,NaN,997,7.18956870611836
999,0,7.17817817817818,NaN,999,7.17817817817818
999,0,7.17817817817818,NaN,999,7.17817817817818
998,0,7.16432865731463,NaN,998,7.16432865731463
998,0,7.14929859719439,NaN,998,7.14929859719439
999,0,7.14814814814815,NaN,999,7.14814814814815
997,0,7.14343029087262,NaN,997,7.14343029087262
998,0,7.17835671342685,NaN,998,7.17835671342685
995,0,7.13065326633166,NaN,995,7.13065326633166
996,0,7.10341365461847,NaN,996,7.10341365461847
999,0,7.06606606606607,NaN,999,7.06606606606607
999,0,7.04304304304304,NaN,999,7.04304304304304
999,0,7.02302302302302,NaN,999,7.02302302302302
999,0,7.00900900900901,NaN,999,7.00900900900901
998,0,7.01102204408818,NaN,998,7.01102204408818
998,0,7.03507014028056,NaN,998,7.03507014028056
998,0,7.07014028056112,NaN,998,7.07014028056112
999,0,7.01001001001001,NaN,999,7.01001001001001
996,0,7.0070281124498,NaN,996,7.0070281124498
999,0,7.05005005005005,NaN,999,7.05005005005005
