forward_num,reverse_num,forward_rate,reverse_rate,organism_num,organism_rate
500,500,5.5,5.5,1000,5.5
496,496,5.51209677419355,5.49193548387097,992,5.50201612903226
493,493,5.50912778904665,5.49695740365112,986,5.50304259634888
539,459,6.07050092764378,5.48366013071895,998,5.80060120240481
574,424,6.09233449477352,5.40566037735849,998,5.80060120240481
611,385,6.19476268412439,5.3974025974026,996,5.88654618473896
642,355,6.24299065420561,5.4112676056338,997,5.94684052156469
665,333,6.41804511278195,5.50750750750751,998,6.11422845691383
692,306,6.38150289017341,5.56209150326797,998,6.13026052104208
699,299,6.39914163090129,5.52842809364549,998,6.13827655310621
690,309,6.47971014492754,5.38187702265372,999,6.14014014014014
712,287,6.30056179775281,5.4808362369338,999,6.06506506506507
702,294,6.46581196581197,5.58843537414966,996,6.20682730923695
708,290,6.53672316384181,5.56551724137931,998,6.25450901803607
686,310,6.61224489795918,5.96774193548387,996,6.41164658634538
716,282,6.69692737430168,5.9645390070922,998,6.48997995991984
733,265,6.76671214188267,5.84150943396226,998,6.52104208416834
707,291,6.74964639321075,6.07216494845361,998,6.55210420841683
692,307,6.86271676300578,5.99022801302932,999,6.59459459459459
708,290,6.94774011299435,6.02068965517241,998,6.67835671342685
712,286,7.05196629213483,5.96153846153846,998,6.73947895791583
721,277,6.92787794729542,6.03971119133574,998,6.6813627254509
725,273,6.89931034482759,6.12820512820513,998,6.68837675350701
740,258,7.04459459459459,6.11240310077519,998,6.80360721442886
736,261,6.96739130434783,6.13026819923372,997,6.74824473420261
742,256,7.09164420485175,6.2109375,998,6.86573146292585
749,250,7.11882510013351,6.2,999,6.88888888888889
753,245,7.16069057104914,6.2734693877551,998,6.94288577154309
759,237,7.133069828722,6.23628691983122,996,6.91967871485944
766,232,7.14882506527415,6.46551724137931,998,6.98997995991984
782,214,7.17774936061381,6.42523364485981,996,7.01606425702811
758,241,7.20580474934037,6.5850622406639,999,7.05605605605606
763,234,7.2346002621232,6.58547008547009,997,7.08224674022066
762,236,7.32020997375328,6.6864406779661,998,7.17034068136273
768,230,7.35286458333333,6.80869565217391,998,7.22745490981964
775,224,7.30064516129032,6.85267857142857,999,7.2002002002002
768,230,7.30859375,6.79130434782609,998,7.18937875751503
772,226,7.26943005181347,6.80530973451327,998,7.16432865731463
783,216,7.33077905491699,6.78240740740741,999,7.21221221221221
784,214,7.39540816326531,6.81775700934579,998,7.27154308617235
791,208,7.40455120101138,6.71153846153846,999,7.26026026026026
794,203,7.43198992443325,6.66995073891626,997,7.27683049147442
805,192,7.40993788819876,6.609375,997,7.25576730190572
806,192,7.424317617866,6.63541666666667,998,7.27254509018036
808,191,7.46039603960396,6.73298429319372,999,7.32132132132132
812,186,7.4692118226601,6.84408602150538,998,7.35270541082164
816,182,7.5281862745098,6.86263736263736,998,7.40681362725451
824,173,7.57402912621359,6.92485549132948,997,7.46138415245737
816,183,7.56495098039216,7.0655737704918,999,7.47347347347347
819,178,7.58852258852259,7.14606741573034,997,7.50952858575727
824,174,7.62742718446602,7.22413793103448,998,7.55711422845691
827,170,7.62031438935913,7.39411764705882,997,7.58174523570712
827,170,7.64328899637243,7.52941176470588,997,7.62387161484453
830,168,7.6421686746988,7.47619047619048,998,7.61422845691383
827,172,7.69528415961306,7.51744186046512,999,7.66466466466466
824,174,7.73179611650485,7.5632183908046,998,7.70240480961924
831,168,7.78339350180505,7.53571428571429,999,7.74174174174174
828,170,7.80555555555556,7.58823529411765,998,7.7685370741483
823,176,7.78736330498177,7.59659090909091,999,7.75375375375375
822,177,7.80048661800487,7.67231638418079,999,7.77777777777778
820,178,7.75243902439024,7.79775280898876,998,7.76052104208417
827,170,7.78113663845224,7.82941176470588,997,7.78936810431294
823,176,7.78493317132442,7.86931818181818,999,7.7997997997998
827,172,7.80894800483676,7.95348837209302,999,7.83383383383383
826,173,7.8365617433414,7.92485549132948,999,7.85185185185185
820,179,7.85121951219512,8.06145251396648,999,7.88888888888889
826,173,7.86198547215496,8.04624277456647,999,7.89389389389389
825,174,7.90060606060606,8.02873563218391,999,7.92292292292292
826,169,7.94915254237288,8.0414201183432,995,7.96482412060301
831,167,7.98796630565584,8.13173652694611,998,8.01202404809619
832,166,8.01081730769231,8.04216867469879,998,8.01603206412826
836,163,7.97846889952153,8.08588957055215,999,7.995995995996
838,161,8.00477326968974,8.1304347826087,999,8.02502502502503
840,157,8.00238095238095,8.15286624203822,997,8.02607823470411
838,161,8.02267303102625,8.25465838509317,999,8.06006006006006
833,165,8.05042016806723,8.32121212121212,998,8.09519038076152
833,162,8.00960384153661,8.48765432098766,995,8.08743718592965
841,158,8.00356718192628,8.54430379746835,999,8.08908908908909
851,148,8.04582843713279,8.53378378378378,999,8.11811811811812
843,156,8.04033214709371,8.5448717948718,999,8.11911911911912
847,152,8.06139315230224,8.57236842105263,999,8.13913913913914
850,148,8.06,8.5472972972973,998,8.13226452905812
834,164,8.08273381294964,8.58536585365854,998,8.16533066132265
836,162,8.11004784688995,8.7037037037037,998,8.2064128256513
836,163,8.08612440191388,8.7239263803681,999,8.19019019019019
836,162,8.14234449760766,8.81481481481481,998,8.25150300601202
842,157,8.11163895486936,8.78343949044586,999,8.21721721721722
844,155,8.18601895734597,8.80645161290323,999,8.28228228228228
838,160,8.19331742243437,8.7875,998,8.28857715430862
844,152,8.23815165876777,8.75657894736842,996,8.31726907630522
849,148,8.24028268551237,8.81081081081081,997,8.32497492477432
854,145,8.28220140515223,8.91724137931035,999,8.37437437437437
853,146,8.27667057444314,8.91095890410959,999,8.36936936936937
847,151,8.30224321133412,9.00662251655629,998,8.40881763527054
843,155,8.31316725978648,9.0,998,8.41983967935872
849,146,8.33451118963487,9.05479452054795,995,8.44020100502513
855,143,8.34853801169591,9.09090909090909,998,8.45490981963928
864,135,8.33449074074074,9.07407407407407,999,8.43443443443443
859,139,8.34691501746217,9.12230215827338,998,8.45490981963928
865,134,8.35491329479769,9.06716417910448,999,8.45045045045045
861,137,8.39256678281069,9.02189781021898,998,8.47895791583166
864,134,8.37268518518519,9.09701492537313,998,8.46993987975952
870,129,8.38965517241379,9.06976744186047,999,8.47747747747748
867,131,8.42214532871972,9.12213740458015,998,8.51402805611222
867,129,8.43713956170704,9.17054263565892,996,8.53212851405623
866,132,8.46189376443418,9.17424242424242,998,8.5561122244489
864,135,8.43055555555556,9.14814814814815,999,8.52752752752753
859,138,8.45052386495925,9.14492753623188,997,8.54663991975928
855,143,8.43976608187135,9.23776223776224,998,8.55410821643287
860,139,8.47558139534884,9.24460431654676,999,8.58258258258258
854,145,8.4847775175644,9.24827586206897,999,8.5955955955956
853,146,8.49941383352872,9.22602739726027,999,8.60560560560561
855,143,8.49590643274854,9.14685314685315,998,8.58917835671343
857,142,8.4830805134189,9.23239436619718,999,8.58958958958959
856,143,8.46845794392523,9.29370629370629,999,8.58658658658659
851,148,8.50058754406581,9.41216216216216,999,8.63563563563564
847,152,8.49350649350649,9.35526315789474,999,8.62462462462462
849,150,8.49941107184923,9.33333333333333,999,8.62462462462462
845,154,8.49467455621302,9.37012987012987,999,8.62962962962963
846,151,8.50354609929078,9.35761589403974,997,8.63289869608827
847,152,8.50885478158205,9.38157894736842,999,8.64164164164164
848,151,8.5436320754717,9.37748344370861,999,8.66966966966967
841,155,8.56361474435196,9.34838709677419,996,8.68574297188755
840,157,8.53809523809524,9.36305732484076,997,8.66800401203611
848,151,8.56367924528302,9.31788079470199,999,8.67767767767768
848,149,8.59316037735849,9.33557046979866,997,8.70411233701103
853,145,8.60140679953107,9.3448275862069,998,8.70941883767535
854,144,8.59367681498829,9.30555555555556,998,8.69639278557114
854,145,8.596018735363,9.31724137931034,999,8.7007007007007
855,143,8.6093567251462,9.28671328671329,998,8.7064128256513
854,145,8.61826697892272,9.30344827586207,999,8.71771771771772
851,148,8.64864864864865,9.32432432432432,999,8.74874874874875
850,148,8.63882352941176,9.28378378378378,998,8.73446893787575
852,146,8.67840375586854,9.30821917808219,998,8.77054108216433
853,145,8.69519343493552,9.28275862068966,998,8.78056112224449
848,149,8.71933962264151,9.31543624161074,997,8.80842527582748
848,151,8.71933962264151,9.29139072847682,999,8.80580580580581
853,146,8.72919109026964,9.34931506849315,999,8.81981981981982
841,158,8.705112960761,9.34177215189873,999,8.80580580580581
839,159,8.71632896305125,9.35220125786164,998,8.81763527054108
839,157,8.73659117997616,9.36305732484076,996,8.83534136546185
843,156,8.73902728351127,9.3525641025641,999,8.83483483483483
842,155,8.75890736342043,9.36129032258065,997,8.85255767301906
844,154,8.73578199052133,9.36363636363636,998,8.83266533066132
846,151,8.74113475177305,9.39735099337748,997,8.84052156469408
845,151,8.78579881656805,9.39072847682119,996,8.87751004016064
851,148,8.78378378378378,9.44594594594595,999,8.88188188188188
849,149,8.81861012956419,9.48322147651007,998,8.91783567134268
849,150,8.81861012956419,9.46666666666667,999,8.91591591591592
853,146,8.8147713950762,9.48630136986301,999,8.91291291291291
851,147,8.82256169212691,9.48979591836735,998,8.92084168336673
853,146,8.83118405627198,9.5,999,8.92892892892893
856,142,8.8446261682243,9.53521126760563,998,8.94288577154309
855,143,8.85029239766082,9.46153846153846,998,8.93787575150301
854,145,8.85831381733021,9.50344827586207,999,8.95195195195195
855,144,8.85730994152047,9.52083333333333,999,8.95295295295295
855,142,8.87485380116959,9.54929577464789,997,8.97091273821464
846,151,8.85933806146572,9.57615894039735,997,8.9679037111334
855,144,8.87602339181286,9.58333333333333,999,8.97797797797798
848,149,8.86556603773585,9.57046979865772,997,8.97091273821464
850,149,8.90235294117647,9.55704697986577,999,9.0
852,146,8.90023474178404,9.63013698630137,998,9.00701402805611
850,149,8.90588235294118,9.63087248322148,999,9.01401401401401
860,137,8.90232558139535,9.62043795620438,997,9.00100300902708
860,137,8.88837209302326,9.66423357664234,997,8.99498495486459
862,136,8.88399071925754,9.66176470588235,998,8.98997995991984
864,135,8.90393518518519,9.66666666666667,999,9.00700700700701
861,136,8.9082462253194,9.66176470588235,997,9.01103309929789
863,136,8.9513325608343,9.72058823529412,999,9.05605605605606
860,138,8.97209302325581,9.73188405797101,998,9.07715430861724
857,141,8.98016336056009,9.74468085106383,998,9.08817635270541
858,140,8.98834498834499,9.77142857142857,998,9.09819639278557
858,141,8.99300699300699,9.80851063829787,999,9.10810810810811
859,139,8.9837019790454,9.82014388489209,998,9.1002004008016
860,139,8.97093023255814,9.82014388489209,999,9.08908908908909
863,136,9.01506373117034,9.81617647058824,999,9.12412412412412
867,132,9.03921568627451,9.8030303030303,999,9.14014014014014
868,129,9.04838709677419,9.81395348837209,997,9.14744232698094
863,135,9.07415990730012,9.82962962962963,998,9.17635270541082
860,139,9.07790697674419,9.81294964028777,999,9.18018018018018
866,133,9.07736720554272,9.82706766917293,999,9.17717717717718
862,137,9.11948955916473,9.7956204379562,999,9.21221221221221
862,137,9.12412993039443,9.8029197080292,999,9.21721721721722
862,136,9.14037122969838,9.79411764705882,998,9.22945891783567
857,141,9.1365227537923,9.81560283687943,998,9.23246492985972
863,135,9.1657010428737,9.82962962962963,998,9.25551102204409
866,133,9.14087759815243,9.82706766917293,999,9.23223223223223
864,134,9.15393518518519,9.82089552238806,998,9.2434869739479
869,129,9.15189873417722,9.8062015503876,998,9.23647294589178
868,131,9.17857142857143,9.80152671755725,999,9.26026026026026
871,128,9.17451205510907,9.8046875,999,9.25525525525526
868,131,9.16589861751152,9.81679389312977,999,9.25125125125125
871,127,9.18599311136625,9.81889763779528,998,9.26653306613226
870,129,9.18965517241379,9.82945736434108,999,9.27227227227227
870,129,9.17011494252874,9.84496124031008,999,9.25725725725726
868,131,9.16013824884793,9.83206106870229,999,9.24824824824825
870,129,9.1816091954023,9.86046511627907,999,9.26926926926927
874,124,9.19221967963387,9.85483870967742,998,9.27454909819639
873,126,9.20962199312715,9.84126984126984,999,9.28928928928929
871,128,9.21814006888634,9.828125,999,9.2962962962963
876,122,9.18835616438356,9.83606557377049,998,9.26753507014028
877,121,9.22805017103763,9.85123966942149,998,9.30360721442886
881,118,9.24631101021566,9.82203389830508,999,9.31431431431431
880,118,9.26931818181818,9.8135593220339,998,9.33366733466934
879,120,9.29465301478953,9.81666666666667,999,9.35735735735736
879,118,9.30147895335609,9.78813559322034,997,9.35907723169509
876,123,9.3162100456621,9.8130081300813,999,9.37737737737738
877,120,9.32041049030787,9.79166666666667,997,9.37713139418255
880,118,9.32727272727273,9.77118644067797,998,9.37975951903808
881,117,9.33938706015891,9.76068376068376,998,9.38877755511022
885,112,9.35932203389831,9.77678571428571,997,9.4062186559679
880,119,9.36022727272727,9.79831932773109,999,9.41241241241241
880,118,9.35681818181818,9.80508474576271,998,9.40981963927856
881,118,9.34960272417707,9.82203389830508,999,9.40540540540541
879,119,9.36291240045506,9.82352941176471,998,9.41783567134268
879,118,9.37201365187713,9.83050847457627,997,9.42627883650953
883,115,9.38165345413364,9.85217391304348,998,9.43587174348697
884,114,9.39366515837104,9.86842105263158,998,9.44789579158317
884,115,9.3868778280543,9.84347826086957,999,9.43943943943944
881,118,9.39954597048808,9.83898305084746,999,9.45145145145145
883,116,9.39864099660249,9.83620689655172,999,9.44944944944945
882,117,9.38548752834467,9.82905982905983,999,9.43743743743744
882,116,9.41496598639456,9.81896551724138,998,9.46192384769539
882,116,9.39909297052154,9.83620689655172,998,9.4498997995992
887,112,9.41939120631342,9.84821428571429,999,9.46746746746747
884,115,9.41968325791855,9.83478260869565,999,9.46746746746747
880,116,9.4125,9.82758620689655,996,9.46084337349398
886,112,9.4176072234763,9.83035714285714,998,9.46392785571142
885,113,9.42372881355932,9.87610619469027,998,9.4749498997996
887,111,9.41600901916573,9.86486486486486,998,9.46593186372746
890,108,9.43258426966292,9.87037037037037,998,9.47995991983968
887,111,9.42051860202931,9.88288288288288,998,9.47194388777555
889,110,9.42744656917885,9.88181818181818,999,9.47747747747748
888,110,9.42905405405405,9.88181818181818,998,9.47895791583166
888,111,9.4222972972973,9.89189189189189,999,9.47447447447447
886,111,9.43905191873589,9.86486486486486,997,9.4864593781344
888,110,9.46509009009009,9.85454545454546,998,9.50801603206413
891,107,9.45679012345679,9.85981308411215,998,9.5
887,111,9.46335963923337,9.85585585585586,998,9.50701402805611
887,111,9.47350620067644,9.82882882882883,998,9.51302605210421
889,110,9.46119235095613,9.83636363636364,999,9.5025025025025
890,109,9.45168539325843,9.81651376146789,999,9.49149149149149
893,105,9.45128779395297,9.80952380952381,998,9.48897795591182
894,105,9.44183445190157,9.81904761904762,999,9.48148148148148
897,101,9.43478260869565,9.8019801980198,998,9.47194388777555
896,102,9.44419642857143,9.77450980392157,998,9.47795591182365
901,97,9.46503884572697,9.79381443298969,998,9.49699398797595
904,95,9.46681415929203,9.78947368421053,999,9.4974974974975
902,96,9.47671840354767,9.8125,998,9.50901803607214
906,93,9.46799116997792,9.81720430107527,999,9.5005005005005
902,96,9.47339246119734,9.8125,998,9.5060120240481
905,94,9.49171270718232,9.80851063829787,999,9.52152152152152
905,94,9.5060773480663,9.80851063829787,999,9.53453453453453
903,96,9.51273532668882,9.84375,999,9.54454454454454
902,96,9.52660753880266,9.83333333333333,998,9.5561122244489
901,97,9.5338512763596,9.82474226804124,998,9.56212424849699
899,97,9.54838709677419,9.82474226804124,996,9.57530120481928
898,101,9.55902004454343,9.81188118811881,999,9.58458458458458
900,97,9.57111111111111,9.82474226804124,997,9.59578736208626
904,93,9.57522123893805,9.81720430107527,997,9.59779338014042
906,93,9.58057395143488,9.80645161290323,999,9.6016016016016
908,90,9.56938325991189,9.78888888888889,998,9.58917835671343
914,85,9.58533916849015,9.78823529411765,999,9.6026026026026
914,85,9.58971553610503,9.78823529411765,999,9.60660660660661
915,82,9.57704918032787,9.80487804878049,997,9.59578736208626
916,83,9.57532751091703,9.79518072289157,999,9.59359359359359
912,87,9.58662280701754,9.82758620689655,999,9.60760760760761
910,88,9.58351648351648,9.86363636363636,998,9.60821643286573
907,91,9.5832414553473,9.83516483516484,998,9.6062124248497
911,86,9.58287596048299,9.82558139534884,997,9.60381143430291
913,86,9.5750273822563,9.82558139534884,999,9.5965965965966
905,91,9.60220994475138,9.81318681318681,996,9.6214859437751
907,91,9.58434399117971,9.79120879120879,998,9.60320641282565
914,85,9.58315098468271,9.78823529411765,999,9.6006006006006
906,92,9.57836644591612,9.81521739130435,998,9.6002004008016
908,91,9.58700440528634,9.82417582417582,999,9.60860860860861
906,92,9.58278145695364,9.82608695652174,998,9.60521042084168
909,89,9.58855885588559,9.84269662921348,998,9.61122244488978
905,90,9.59337016574586,9.84444444444444,995,9.61608040201005
905,94,9.5878453038674,9.86170212765957,999,9.61361361361361
907,91,9.58875413450937,9.85714285714286,998,9.61322645290581
905,93,9.58674033149171,9.86021505376344,998,9.61222444889779
906,93,9.58719646799117,9.89247311827957,999,9.61561561561562
909,88,9.59295929592959,9.89772727272727,997,9.61985957873621
904,94,9.60287610619469,9.90425531914894,998,9.6312625250501
906,93,9.59823399558499,9.90322580645161,999,9.62662662662663
907,91,9.59757442116869,9.9010989010989,998,9.625250501002
905,93,9.60441988950276,9.88172043010753,998,9.63026052104208
903,96,9.60243632336656,9.88541666666667,999,9.62962962962963
903,94,9.61240310077519,9.8936170212766,997,9.63891675025075
906,92,9.60485651214128,9.8804347826087,998,9.63026052104208
904,94,9.60619469026549,9.86170212765957,998,9.63026052104208
901,96,9.61598224195338,9.86458333333333,997,9.63991975927783
906,93,9.61479028697572,9.86021505376344,999,9.63763763763764
898,101,9.61804008908686,9.83168316831683,999,9.63963963963964
900,99,9.62777777777778,9.82828282828283,999,9.64764764764765
903,96,9.6389811738649,9.84375,999,9.65865865865866
898,98,9.62917594654788,9.83673469387755,996,9.6495983935743
895,104,9.64022346368715,9.82692307692308,999,9.65965965965966
896,102,9.65290178571429,9.82352941176471,998,9.67034068136273
899,98,9.64738598442714,9.80612244897959,997,9.6629889669007
897,100,9.63210702341137,9.81,997,9.64994984954865
899,98,9.63403781979978,9.8265306122449,997,9.65295887662989
897,102,9.63210702341137,9.81372549019608,999,9.65065065065065
896,102,9.62611607142857,9.7843137254902,998,9.64228456913828
893,105,9.62709966405375,9.8,998,9.64529058116232
896,103,9.64508928571429,9.79611650485437,999,9.66066066066066
895,103,9.65474860335195,9.79611650485437,998,9.66933867735471
900,99,9.64444444444444,9.7979797979798,999,9.65965965965966
905,94,9.65635359116022,9.79787234042553,999,9.66966966966967
909,90,9.64246424642464,9.78888888888889,999,9.65565565565566
912,86,9.63486842105263,9.80232558139535,998,9.64929859719439
915,84,9.65136612021858,9.79761904761905,999,9.66366366366366
914,85,9.65426695842451,9.78823529411765,999,9.66566566566567
918,81,9.66557734204793,9.77777777777778,999,9.67467467467467
919,79,9.6550598476605,9.77215189873418,998,9.66432865731463
923,75,9.65980498374865,9.78666666666667,998,9.66933867735471
924,75,9.65909090909091,9.74666666666667,999,9.66566566566567
925,74,9.66378378378378,9.77027027027027,999,9.67167167167167
929,69,9.67168998923574,9.78260869565217,998,9.67935871743487
928,70,9.66487068965517,9.78571428571429,998,9.67334669338677
935,64,9.67379679144385,9.796875,999,9.68168168168168
937,62,9.67556029882604,9.79032258064516,999,9.68268268268268
936,61,9.6784188034188,9.75409836065574,997,9.68304914744233
933,65,9.68703108252947,9.76923076923077,998,9.69238476953908
933,66,9.68274383708467,9.77272727272727,999,9.68868868868869
929,70,9.67276641550054,9.74285714285714,999,9.67767767767768
925,71,9.67243243243243,9.73239436619718,996,9.67670682730924
927,70,9.68716289104639,9.77142857142857,997,9.69307923771314
925,72,9.68864864864865,9.77777777777778,997,9.6950852557673
928,71,9.70258620689655,9.76056338028169,999,9.70670670670671
928,71,9.70905172413793,9.76056338028169,999,9.71271271271271
929,69,9.71044133476857,9.76811594202899,998,9.71442885771543
928,71,9.7198275862069,9.70422535211268,999,9.71871871871872
926,73,9.71382289416847,9.72602739726027,999,9.71471471471471
926,72,9.7170626349892,9.73611111111111,998,9.71843687374749
921,78,9.71661237785016,9.71794871794872,999,9.71671671671672
923,75,9.71505958829903,9.70666666666667,998,9.71442885771543
921,75,9.71986970684039,9.73333333333333,996,9.72088353413655
923,76,9.7172264355363,9.73684210526316,999,9.71871871871872
926,73,9.72570194384449,9.68493150684932,999,9.72272272272272
923,76,9.71505958829903,9.68421052631579,999,9.71271271271271
925,74,9.71243243243243,9.68918918918919,999,9.71071071071071
925,74,9.70702702702703,9.64864864864865,999,9.7027027027027
922,77,9.70932754880694,9.64935064935065,999,9.7047047047047
925,73,9.72324324324324,9.67123287671233,998,9.71943887775551
922,77,9.72125813449024,9.66233766233766,999,9.71671671671672
918,81,9.72984749455338,9.65432098765432,999,9.72372372372372
919,79,9.74102285092492,9.65822784810127,998,9.73446893787575
921,78,9.74809989142237,9.67948717948718,999,9.74274274274274
917,80,9.74372955288986,9.6875,997,9.73921765295888
923,76,9.75406283856988,9.71052631578947,999,9.75075075075075
919,79,9.74319912948858,9.69620253164557,998,9.73947895791583
923,75,9.73781148429036,9.65333333333333,998,9.7314629258517
922,77,9.74186550976139,9.67532467532468,999,9.73673673673674
921,78,9.74049945711183,9.69230769230769,999,9.73673673673674
917,82,9.73936750272628,9.69512195121951,999,9.73573573573574
919,80,9.74102285092492,9.6875,999,9.73673673673674
922,77,9.74403470715835,9.7012987012987,999,9.74074074074074
917,82,9.75027262813522,9.69512195121951,999,9.74574574574575
919,80,9.75408052230686,9.675,999,9.74774774774775
919,78,9.759521218716,9.69230769230769,997,9.75426278836509
918,81,9.75816993464052,9.7037037037037,999,9.75375375375375
913,86,9.76560788608981,9.69767441860465,999,9.75975975975976
915,83,9.76393442622951,9.69879518072289,998,9.75851703406814
914,81,9.76258205689278,9.67901234567901,995,9.75577889447236
918,81,9.77124183006536,9.64197530864197,999,9.76076076076076
918,81,9.75708061002179,9.66666666666667,999,9.74974974974975
916,81,9.76419213973799,9.66666666666667,997,9.75626880641926
918,81,9.78104575163399,9.64197530864197,999,9.76976976976977
917,81,9.77644492911669,9.62962962962963,998,9.76452905811623
917,78,9.77535441657579,9.64102564102564,995,9.76482412060301
917,82,9.77644492911669,9.62195121951219,999,9.76376376376376
919,80,9.77366702937976,9.65,999,9.76376376376376
923,75,9.76923076923077,9.66666666666667,998,9.76152304609218
917,81,9.76881134133042,9.62962962962963,998,9.75751503006012
923,76,9.76489707475623,9.63157894736842,999,9.75475475475475
922,76,9.7765726681128,9.64473684210526,998,9.76653306613226
921,77,9.78067318132465,9.62337662337662,998,9.7685370741483
918,80,9.78758169934641,9.65,998,9.77655310621243
921,77,9.78935939196526,9.66233766233766,998,9.77955911823647
925,74,9.79459459459459,9.66216216216216,999,9.78478478478478
920,78,9.78478260869565,9.6025641025641,998,9.77054108216433
926,73,9.79805615550756,9.63013698630137,999,9.78578578578579
932,67,9.80472103004292,9.65671641791045,999,9.79479479479479
929,70,9.80301399354144,9.67142857142857,999,9.79379379379379
931,67,9.8109559613319,9.67164179104478,998,9.80160320641283
930,68,9.80645161290323,9.70588235294118,998,9.79959919839679
927,71,9.80366774541532,9.69014084507042,998,9.79559118236473
928,71,9.80711206896552,9.66197183098592,999,9.7967967967968
924,73,9.8030303030303,9.67123287671233,997,9.79338014042126
925,74,9.80324324324324,9.66216216216216,999,9.79279279279279
926,73,9.80885529157667,9.67123287671233,999,9.7987987987988
924,75,9.80627705627706,9.69333333333333,999,9.7977977977978
926,72,9.80561555075594,9.65277777777778,998,9.79458917835671
928,70,9.80926724137931,9.62857142857143,998,9.79659318637275
925,73,9.81081081081081,9.65753424657534,998,9.79959919839679
927,69,9.8133764832794,9.60869565217391,996,9.79919678714859
926,72,9.81209503239741,9.625,998,9.79859719438878
928,70,9.81034482758621,9.64285714285714,998,9.79859719438878
928,71,9.80926724137931,9.66197183098592,999,9.7987987987988
927,70,9.81229773462783,9.65714285714286,997,9.80140421263791
932,66,9.81008583690987,9.66666666666667,998,9.80060120240481
927,70,9.80474649406688,9.68571428571429,997,9.79638916750251
930,68,9.8,9.66176470588235,998,9.79058116232465
934,65,9.80192719486081,9.69230769230769,999,9.79479479479479
933,65,9.78885316184352,9.69230769230769,998,9.78256513026052
930,66,9.78924731182796,9.66666666666667,996,9.78112449799197
927,70,9.7982740021575,9.7,997,9.7913741223671
927,70,9.80582524271845,9.71428571428571,997,9.79939819458375
931,68,9.80236305048335,9.76470588235294,999,9.7997997997998
935,63,9.79679144385027,9.76190476190476,998,9.79458917835671
936,63,9.79380341880342,9.76190476190476,999,9.79179179179179
931,66,9.80343716433942,9.77272727272727,997,9.80140421263791
929,69,9.79978471474704,9.7536231884058,998,9.79659318637275
931,68,9.80451127819549,9.77941176470588,999,9.8028028028028
928,70,9.80603448275862,9.78571428571429,998,9.80460921843687
922,76,9.80802603036876,9.75,998,9.80360721442886
922,77,9.81344902386117,9.75324675324675,999,9.80880880880881
922,76,9.80911062906724,9.76315789473684,998,9.80561122244489
922,77,9.81453362255965,9.72727272727273,999,9.80780780780781
926,73,9.81533477321814,9.73972602739726,999,9.80980980980981
928,71,9.82004310344828,9.74647887323944,999,9.81481481481481
924,74,9.82467532467532,9.71621621621622,998,9.81663326653307
925,74,9.82054054054054,9.72972972972973,999,9.81381381381381
925,74,9.82486486486486,9.75675675675676,999,9.81981981981982
933,66,9.81564844587353,9.72727272727273,999,9.80980980980981
931,67,9.82062298603652,9.73134328358209,998,9.81462925851703
929,69,9.81593110871905,9.73913043478261,998,9.81062124248497
929,68,9.82131324004306,9.73529411764706,997,9.81544633901705
926,73,9.82181425485961,9.6986301369863,999,9.81281281281281
926,72,9.81749460043197,9.72222222222222,998,9.81062124248497
924,74,9.82575757575758,9.72972972972973,998,9.8186372745491
921,78,9.82627578718784,9.73076923076923,999,9.81881881881882
919,79,9.82372143634385,9.74683544303798,998,9.81763527054108
919,78,9.82263329706202,9.76923076923077,997,9.81845536609829
920,77,9.82934782608696,9.7012987012987,997,9.81945837512538
929,70,9.83638320775027,9.7,999,9.82682682682683
928,71,9.83728448275862,9.70422535211268,999,9.82782782782783
928,71,9.85237068965517,9.6056338028169,999,9.83483483483483
930,69,9.85591397849462,9.63768115942029,999,9.84084084084084
934,64,9.86402569593148,9.625,998,9.84869739478958
932,65,9.86587982832618,9.58461538461538,997,9.84754262788365
932,66,9.86480686695279,9.57575757575758,998,9.84569138276553
939,59,9.86581469648562,9.59322033898305,998,9.8496993987976
942,57,9.87048832271762,9.57894736842105,999,9.85385385385385
945,54,9.87513227513227,9.57407407407407,999,9.85885885885886
949,50,9.87460484720759,9.56,999,9.85885885885886
948,49,9.87658227848101,9.57142857142857,997,9.86158475426279
954,44,9.87526205450734,9.54545454545454,998,9.86072144288577
958,41,9.8768267223382,9.51219512195122,999,9.86186186186186
959,40,9.87278415015641,9.525,999,9.85885885885886
958,39,9.87891440501044,9.48717948717949,997,9.86359077231695
957,41,9.8871473354232,9.53658536585366,998,9.87274549098196
960,38,9.88333333333333,9.52631578947368,998,9.86973947895792
960,39,9.875,9.56410256410256,999,9.86286286286286
956,41,9.8755230125523,9.60975609756098,997,9.86459378134403
961,38,9.87617065556712,9.57894736842105,999,9.86486486486486
957,41,9.87669801462905,9.58536585365854,998,9.86472945891784
955,42,9.88062827225131,9.61904761904762,997,9.86960882647944
953,44,9.88142707240294,9.63636363636364,997,9.87061183550652
954,43,9.87945492662474,9.62790697674419,997,9.86860581745236
956,42,9.87970711297071,9.64285714285714,998,9.86973947895792
957,40,9.87565308254963,9.675,997,9.86760280842528
955,41,9.87643979057592,9.68292682926829,996,9.86847389558233
958,41,9.8768267223382,9.70731707317073,999,9.86986986986987
957,42,9.87774294670846,9.69047619047619,999,9.86986986986987
959,40,9.88112617309698,9.7,999,9.87387387387387
962,37,9.87837837837838,9.7027027027027,999,9.87187187187187
965,32,9.87668393782383,9.84375,997,9.87562688064193
969,30,9.87512899896801,9.86666666666667,999,9.87487487487487
970,28,9.87422680412371,9.85714285714286,998,9.87374749498998
972,27,9.8858024691358,9.85185185185185,999,9.88488488488488
973,26,9.88386433710175,9.88461538461539,999,9.88388388388388
974,25,9.8911704312115,9.92,999,9.89189189189189
973,25,9.89105858170606,9.92,998,9.89178356713427
974,25,9.89322381930185,9.92,999,9.89389389389389
973,25,9.89003083247688,9.92,998,9.89078156312625
977,22,9.8863868986694,9.95454545454546,999,9.88788788788789
975,24,9.88615384615385,9.95833333333333,999,9.88788788788789
975,21,9.88512820512821,9.90476190476191,996,9.8855421686747
976,23,9.88422131147541,9.91304347826087,999,9.88488488488488
975,23,9.88205128205128,9.91304347826087,998,9.88276553106212
975,23,9.88,9.8695652173913,998,9.87975951903808
976,23,9.8780737704918,9.91304347826087,999,9.87887887887888
979,20,9.88661899897855,9.9,999,9.88688688688689
979,20,9.88457609805924,9.9,999,9.88488488488488
976,20,9.88729508196721,9.9,996,9.88755020080321
981,18,9.88888888888889,9.88888888888889,999,9.88888888888889
979,19,9.88866189989785,9.89473684210526,998,9.88877755511022
979,20,9.89989785495403,9.9,999,9.8998998998999
981,18,9.89194699286442,9.88888888888889,999,9.89189189189189
981,18,9.89398572884812,9.88888888888889,999,9.89389389389389
981,18,9.89908256880734,9.88888888888889,999,9.8988988988989
981,16,9.8960244648318,9.875,997,9.89568706118355
984,15,9.90040650406504,9.86666666666667,999,9.8998998998999
981,17,9.89398572884812,9.88235294117647,998,9.8937875751503
979,16,9.89785495403473,9.875,995,9.89748743718593
985,14,9.89847715736041,9.85714285714286,999,9.8978978978979
985,14,9.89847715736041,9.85714285714286,999,9.8978978978979
983,14,9.89827060020346,9.92857142857143,997,9.89869608826479
984,15,9.89532520325203,9.93333333333333,999,9.8958958958959
983,14,9.90030518819939,9.92857142857143,997,9.90070210631896
984,15,9.90447154471545,9.93333333333333,999,9.9049049049049
981,17,9.90214067278287,9.88235294117647,998,9.90180360721443
981,18,9.90010193679919,9.94444444444444,999,9.9009009009009
981,18,9.89908256880734,9.94444444444444,999,9.8998998998999
980,19,9.90102040816327,9.94736842105263,999,9.9019019019019
977,20,9.89559877175026,9.95,997,9.89669007021063
980,19,9.90510204081633,9.94736842105263,999,9.90590590590591
981,17,9.90214067278287,9.94117647058824,998,9.90280561122244
982,16,9.90427698574338,9.9375,998,9.90480961923848
983,16,9.90640895218718,9.9375,999,9.90690690690691
984,15,9.90548780487805,9.93333333333333,999,9.90590590590591
984,15,9.90650406504065,9.93333333333333,999,9.90690690690691
982,17,9.90122199592668,9.94117647058824,999,9.9019019019019
982,16,9.90631364562118,9.9375,998,9.90681362725451
978,19,9.90593047034765,9.94736842105263,997,9.90672016048144
983,16,9.90844354018311,9.9375,999,9.90890890890891
981,17,9.90927624872579,9.94117647058824,998,9.90981963927856
980,18,9.91020408163265,9.94444444444444,998,9.91082164328657
979,19,9.90398365679265,9.94736842105263,998,9.90480961923848
981,18,9.9072375127421,9.94444444444444,999,9.90790790790791
978,18,9.90286298568507,9.94444444444444,996,9.90361445783133
979,19,9.90602655771195,9.94736842105263,998,9.90681362725451
977,21,9.9078812691914,9.90476190476191,998,9.90781563126252
978,20,9.9120654396728,9.9,998,9.91182364729459
979,20,9.91317671092952,9.9,999,9.91291291291291
978,19,9.91717791411043,9.8421052631579,997,9.91574724172518
981,17,9.9164118246687,9.82352941176471,998,9.91482965931864
982,16,9.91649694501018,9.875,998,9.91583166332665
982,17,9.92464358452139,9.88235294117647,999,9.92392392392392
982,15,9.92566191446029,9.86666666666667,997,9.92477432296891
983,16,9.92878942014242,9.875,999,9.92792792792793
984,15,9.93191056910569,9.86666666666667,999,9.93093093093093
985,14,9.93604060913706,9.92857142857143,999,9.93593593593594
986,13,9.93002028397566,10.0,999,9.93093093093093
985,14,9.93401015228426,10.0,999,9.93493493493493
985,14,9.93299492385787,10.0,999,9.93393393393393
986,13,9.9340770791075,10.0,999,9.93493493493493
985,14,9.92994923857868,10.0,999,9.93093093093093
983,16,9.92777212614446,10.0,999,9.92892892892893
980,17,9.92755102040816,10.0,997,9.92878635907723
982,17,9.92362525458248,10.0,999,9.92492492492492
984,15,9.92682926829268,10.0,999,9.92792792792793
984,15,9.92581300813008,10.0,999,9.92692692692693
983,16,9.92878942014242,10.0,999,9.92992992992993
982,16,9.93890020366599,10.0,998,9.93987975951904
979,19,9.93769152196118,10.0,998,9.93887775551102
980,19,9.94081632653061,10.0,999,9.94194194194194
979,20,9.94279877425945,10.0,999,9.94394394394394
976,23,9.94774590163934,10.0,999,9.94894894894895
974,20,9.94866529774127,10.0,994,9.94969818913481
978,20,9.95398773006135,10.0,998,9.95490981963928
978,21,9.95501022494888,10.0,999,9.95595595595596
977,20,9.95701125895599,10.0,997,9.95787362086259
978,20,9.95705521472393,10.0,998,9.95791583166333
979,20,9.95914198161389,10.0,999,9.95995995995996
980,17,9.95612244897959,10.0,997,9.95687061183551
981,18,9.95820591233435,10.0,999,9.95895895895896
980,18,9.95816326530612,10.0,998,9.95891783567134
981,18,9.95820591233435,10.0,999,9.95895895895896
978,21,9.95398773006135,10.0,999,9.95495495495495
979,20,9.95505617977528,10.0,999,9.95595595595596
975,23,9.95384615384615,10.0,998,9.95490981963928
979,19,9.95505617977528,10.0,998,9.95591182364729
978,21,9.9478527607362,10.0,999,9.94894894894895
975,20,9.95076923076923,10.0,995,9.95175879396985
979,20,9.94892747701737,10.0,999,9.94994994994995
976,22,9.95081967213115,10.0,998,9.95190380761523
978,20,9.95501022494888,10.0,998,9.95591182364729
978,19,9.95296523517382,10.0,997,9.95386158475426
979,19,9.95403472931563,10.0,998,9.95490981963928
978,21,9.9519427402863,10.0,999,9.95295295295295
982,17,9.95417515274949,10.0,999,9.95495495495495
982,16,9.95723014256619,10.0,998,9.95791583166333
978,18,9.9601226993865,10.0,996,9.96084337349398
982,16,9.96130346232179,10.0,998,9.96192384769539
981,18,9.96126401630989,10.0,999,9.96196196196196
977,19,9.96315250767656,10.0,996,9.96385542168675
977,21,9.96417604912999,10.0,998,9.96492985971944
978,21,9.96625766871166,10.0,999,9.96696696696697
979,20,9.96629213483146,10.0,999,9.96696696696697
977,22,9.96827021494371,10.0,999,9.96896896896897
978,21,9.96625766871166,10.0,999,9.96696696696697
976,20,9.96926229508197,10.0,996,9.96987951807229
979,20,9.96629213483146,10.0,999,9.96696696696697
980,18,9.96632653061224,10.0,998,9.96693386773547
979,18,9.96527068437181,10.0,997,9.96589769307924
979,19,9.96527068437181,10.0,998,9.96593186372746
979,19,9.96731358529111,10.0,998,9.96793587174349
980,19,9.96530612244898,10.0,999,9.96596596596597
976,20,9.96311475409836,10.0,996,9.96385542168675
980,18,9.95918367346939,10.0,998,9.95991983967936
979,19,9.95709908069459,10.0,998,9.95791583166333
980,17,9.96122448979592,10.0,997,9.96188565697091
981,17,9.96024464831804,10.0,998,9.96092184368737
979,19,9.96424923391216,10.0,998,9.96492985971944
978,19,9.95910020449898,10.0,997,9.95987963891675
978,20,9.95705521472393,10.0,998,9.95791583166333
977,22,9.9539406345957,10.0,999,9.95495495495495
978,18,9.9560327198364,10.0,996,9.95682730923695
976,21,9.95901639344262,10.0,997,9.95987963891675
979,19,9.95403472931563,10.0,998,9.95490981963928
979,19,9.95709908069459,10.0,998,9.95791583166333
981,18,9.95820591233435,10.0,999,9.95895895895896
981,18,9.95514780835882,10.0,999,9.95595595595596
977,19,9.9539406345957,10.0,996,9.95481927710843
982,17,9.95315682281059,10.0,999,9.95395395395395
981,18,9.95820591233435,10.0,999,9.95895895895896
980,19,9.95816326530612,10.0,999,9.95895895895896
977,19,9.96008188331627,10.0,996,9.96084337349398
978,20,9.9601226993865,10.0,998,9.96092184368737
980,18,9.96122448979592,10.0,998,9.96192384769539
982,17,9.95926680244399,10.0,999,9.95995995995996
983,16,9.95727365208545,10.0,999,9.95795795795796
985,14,9.95736040609137,10.0,999,9.95795795795796
982,16,9.95417515274949,10.0,998,9.95490981963928
982,16,9.95621181262729,10.0,998,9.95691382765531
985,14,9.95228426395939,10.0,999,9.95295295295295
982,16,9.95213849287169,10.0,998,9.95290581162325
983,16,9.94913530010173,10.0,999,9.94994994994995
980,18,9.94489795918367,10.0,998,9.94589178356713
978,20,9.9478527607362,10.0,998,9.94889779559118
980,19,9.94897959183673,10.0,999,9.94994994994995
979,20,9.95097037793667,10.0,999,9.95195195195195
979,20,9.95199182839632,10.0,999,9.95295295295295
977,21,9.95087001023541,10.0,998,9.95190380761523
975,23,9.95282051282051,10.0,998,9.95390781563126
974,25,9.95277207392197,10.0,999,9.95395395395395
975,24,9.95692307692308,10.0,999,9.95795795795796
972,27,9.95473251028807,10.0,999,9.95595595595596
971,28,9.9557157569516,10.0,999,9.95695695695696
971,27,9.95983522142122,10.0,998,9.96092184368737
973,26,9.9568345323741,10.0,999,9.95795795795796
973,25,9.95991778006167,10.0,998,9.96092184368737
974,25,9.95687885010267,10.0,999,9.95795795795796
973,26,9.96094552929085,10.0,999,9.96196196196196
977,21,9.9611054247697,10.0,998,9.96192384769539
975,23,9.96,10.0,998,9.96092184368737
976,22,9.95901639344262,10.0,998,9.95991983967936
976,23,9.96004098360656,10.0,999,9.96096096096096
975,24,9.96102564102564,10.0,999,9.96196196196196
975,24,9.95897435897436,10.0,999,9.95995995995996
979,20,9.96220633299285,10.0,999,9.96296296296296
978,19,9.96216768916155,10.0,997,9.96288866599799
977,20,9.9611054247697,10.0,997,9.96188565697091
977,22,9.96008188331627,10.0,999,9.96096096096096
976,22,9.96618852459016,10.0,998,9.96693386773547
975,24,9.96717948717949,10.0,999,9.96796796796797
974,25,9.96919917864476,10.0,999,9.96996996996997
975,23,9.96820512820513,10.0,998,9.9689378757515
975,23,9.97025641025641,10.0,998,9.97094188376754
973,26,9.96711202466598,10.0,999,9.96796796796797
971,27,9.96910401647786,10.0,998,9.96993987975952
971,26,9.96910401647786,10.0,997,9.96990972918756
970,29,9.9680412371134,10.0,999,9.96896896896897
968,29,9.96900826446281,10.0,997,9.96990972918756
969,29,9.96904024767802,10.0,998,9.96993987975952
967,32,9.96690796277146,10.0,999,9.96796796796797
970,29,9.9680412371134,10.0,999,9.96896896896897
968,31,9.96590909090909,10.0,999,9.96696696696697
967,32,9.96690796277146,10.0,999,9.96796796796797
970,29,9.97113402061856,10.0,999,9.97197197197197
971,27,9.97116374871267,10.0,998,9.97194388777555
973,26,9.97225077081192,10.0,999,9.97297297297297
974,25,9.97433264887064,10.0,999,9.97497497497497
974,25,9.97330595482546,10.0,999,9.97397397397397
974,24,9.97330595482546,10.0,998,9.97394789579158
974,23,9.97535934291581,10.0,997,9.97592778335005
977,22,9.97441146366428,10.0,999,9.97497497497497
975,22,9.97333333333333,10.0,997,9.97392176529589
979,20,9.97344228804903,10.0,999,9.97397397397397
974,21,9.97330595482546,10.0,995,9.97386934673367
976,23,9.97336065573771,10.0,999,9.97397397397397
970,27,9.97525773195876,10.0,997,9.97592778335005
973,26,9.97738951695786,10.0,999,9.97797797797798
976,23,9.97643442622951,10.0,999,9.97697697697698
975,23,9.97948717948718,10.0,998,9.97995991983968
974,23,9.97741273100616,10.0,997,9.97793380140421
976,23,9.97848360655738,10.0,999,9.97897897897898
974,25,9.97741273100616,10.0,999,9.97797797797798
975,23,9.97641025641026,10.0,998,9.97695390781563
974,23,9.97535934291581,10.0,997,9.97592778335005
974,25,9.97330595482546,10.0,999,9.97397397397397
973,26,9.97225077081192,10.0,999,9.97297297297297
970,27,9.97422680412371,10.0,997,9.97492477432297
974,25,9.97125256673511,10.0,999,9.97197197197197
975,24,9.97025641025641,10.0,999,9.97097097097097
976,22,9.97336065573771,10.0,998,9.97394789579158
974,23,9.96919917864476,10.0,997,9.96990972918756
975,24,9.97025641025641,10.0,999,9.97097097097097
978,20,9.96932515337423,10.0,998,9.96993987975952
975,23,9.96820512820513,10.0,998,9.9689378757515
982,17,9.96945010183299,10.0,999,9.96996996996997
979,20,9.96731358529111,10.0,999,9.96796796796797
976,22,9.9702868852459,10.0,998,9.97094188376754
976,22,9.96926229508197,10.0,998,9.96993987975952
974,25,9.97022587268994,10.0,999,9.97097097097097
975,24,9.97333333333333,10.0,999,9.97397397397397
974,25,9.97125256673511,10.0,999,9.97197197197197
972,26,9.96913580246914,10.0,998,9.96993987975952
970,26,9.97113402061856,10.0,996,9.9718875502008
973,25,9.97225077081192,10.0,998,9.97294589178357
973,26,9.97122302158273,10.0,999,9.97197197197197
973,25,9.97225077081192,10.0,998,9.97294589178357
977,22,9.97543500511771,10.0,999,9.97597597597598
975,23,9.97230769230769,10.0,998,9.97294589178357
974,25,9.97227926078029,10.0,999,9.97297297297297
970,28,9.97216494845361,10.0,998,9.97294589178357
971,28,9.97219361483007,10.0,999,9.97297297297297
969,29,9.97213622291022,10.0,998,9.97294589178357
972,27,9.9701646090535,10.0,999,9.97097097097097
973,26,9.97122302158273,10.0,999,9.97197197197197
970,29,9.97010309278351,10.0,999,9.97097097097097
967,31,9.97311271975181,10.0,998,9.97394789579158
965,33,9.9720207253886,10.0,998,9.97294589178357
965,32,9.97305699481865,10.0,997,9.97392176529589
965,33,9.97512953367876,10.0,998,9.97595190380762
962,36,9.97297297297297,10.0,998,9.97394789579158
963,36,9.9730010384216,10.0,999,9.97397397397397
965,34,9.97512953367876,10.0,999,9.97597597597598
964,33,9.97614107883817,10.0,997,9.97693079237713
968,31,9.97830578512397,10.0,999,9.97897897897898
967,31,9.97828335056877,10.0,998,9.97895791583166
965,34,9.97720207253886,10.0,999,9.97797797797798
967,32,9.97724922440538,10.0,999,9.97797797797798
963,36,9.97611630321911,10.0,999,9.97697697697698
962,35,9.97713097713098,10.0,997,9.97793380140421
965,34,9.97823834196891,10.0,999,9.97897897897898
964,35,9.97406639004149,10.0,999,9.97497497497497
962,36,9.97297297297297,10.0,998,9.97394789579158
967,32,9.97104446742503,10.0,999,9.97197197197197
966,31,9.97101449275362,10.0,997,9.97191574724173
967,30,9.97207859358842,10.0,997,9.97291875626881
968,31,9.97107438016529,10.0,999,9.97197197197197
966,32,9.97412008281574,10.0,998,9.9749498997996
965,34,9.97512953367876,10.0,999,9.97597597597598
966,33,9.97619047619048,10.0,999,9.97697697697698
962,36,9.97609147609148,10.0,998,9.97695390781563
962,36,9.97505197505198,10.0,998,9.97595190380762
964,34,9.97510373443983,10.0,998,9.97595190380762
963,36,9.97403946002077,10.0,999,9.97497497497497
966,32,9.97412008281574,10.0,998,9.9749498997996
966,32,9.97204968944099,10.0,998,9.97294589178357
971,28,9.97219361483007,10.0,999,9.97297297297297
968,30,9.97107438016529,10.0,998,9.97194388777555
966,31,9.97308488612836,10.0,997,9.97392176529589
968,30,9.97210743801653,10.0,998,9.97294589178357
969,30,9.97316821465428,10.0,999,9.97397397397397
971,28,9.97219361483007,10.0,999,9.97297297297297
970,28,9.96907216494845,10.0,998,9.96993987975952
972,26,9.97222222222222,10.0,998,9.97294589178357
972,27,9.97222222222222,10.0,999,9.97297297297297
973,26,9.97225077081192,10.0,999,9.97297297297297
973,26,9.97327852004111,10.0,999,9.97397397397397
977,22,9.97031729785056,10.0,999,9.97097097097097
973,25,9.97122302158273,10.0,998,9.97194388777555
971,26,9.97116374871267,10.0,997,9.97191574724173
975,24,9.97538461538462,10.0,999,9.97597597597598
974,25,9.97638603696099,10.0,999,9.97697697697698
976,23,9.97643442622951,10.0,999,9.97697697697698
975,24,9.97641025641026,10.0,999,9.97697697697698
976,23,9.97745901639344,10.0,999,9.97797797797798
974,25,9.97843942505133,10.0,999,9.97897897897898
973,26,9.97944501541624,10.0,999,9.97997997997998
973,25,9.98150051387461,10.0,998,9.98196392785571
972,26,9.9783950617284,10.0,998,9.97895791583166
973,26,9.97841726618705,10.0,999,9.97897897897898
973,26,9.97738951695786,10.0,999,9.97797797797798
972,27,9.9783950617284,10.0,999,9.97897897897898
973,25,9.97327852004111,10.0,998,9.97394789579158
973,22,9.97533401849949,10.0,995,9.97587939698492
977,20,9.97441146366428,10.0,997,9.97492477432297
979,20,9.97242083758938,10.0,999,9.97297297297297
977,19,9.97031729785056,10.0,996,9.97088353413655
979,20,9.96935648621042,10.0,999,9.96996996996997
976,23,9.9702868852459,10.0,999,9.97097097097097
979,19,9.96731358529111,10.0,998,9.96793587174349
976,18,9.96516393442623,10.0,994,9.96579476861167
982,17,9.96435845213849,10.0,999,9.96496496496496
981,18,9.96432212028542,10.0,999,9.96496496496496
979,20,9.96629213483146,10.0,999,9.96696696696697
979,19,9.96220633299285,10.0,998,9.96292585170341
977,21,9.96417604912999,10.0,998,9.96492985971944
975,22,9.96307692307692,10.0,997,9.96389167502508
977,21,9.96212896622313,10.0,998,9.96292585170341
977,21,9.96008188331627,10.0,998,9.96092184368737
978,21,9.9642126789366,10.0,999,9.96496496496496
975,22,9.96410256410256,10.0,997,9.96489468405216
978,20,9.96319018404908,10.0,998,9.96392785571142
979,19,9.9632277834525,10.0,998,9.96392785571142
977,22,9.96315250767656,10.0,999,9.96396396396396
978,21,9.96319018404908,10.0,999,9.96396396396396
976,22,9.96209016393443,10.0,998,9.96292585170341
975,20,9.96410256410256,10.0,995,9.96482412060302
980,19,9.96428571428571,10.0,999,9.96496496496496
979,20,9.96833503575077,10.0,999,9.96896896896897
983,16,9.96744659206511,10.0,999,9.96796796796797
982,16,9.96741344195519,10.0,998,9.96793587174349
985,13,9.96751269035533,10.0,998,9.96793587174349
986,13,9.96653144016227,10.0,999,9.96696696696697
986,13,9.96754563894523,10.0,999,9.96796796796797
987,12,9.97365754812563,10.0,999,9.97397397397397
984,12,9.97154471544715,10.0,996,9.9718875502008
986,12,9.97464503042596,10.0,998,9.9749498997996
986,13,9.97667342799189,10.0,999,9.97697697697698
986,13,9.97768762677485,10.0,999,9.97797797797798
986,13,9.97667342799189,10.0,999,9.97697697697698
983,14,9.97558494404883,10.0,997,9.97592778335005
982,15,9.97250509164969,10.0,997,9.97291875626881
984,15,9.97256097560976,10.0,999,9.97297297297297
984,14,9.97256097560976,10.0,998,9.97294589178357
984,14,9.96951219512195,10.0,998,9.96993987975952
981,15,9.96738022426096,10.0,996,9.96787148594377
985,14,9.96954314720812,10.0,999,9.96996996996997
983,15,9.97151576805697,10.0,998,9.97194388777555
985,13,9.97258883248731,10.0,998,9.97294589178357
987,11,9.9726443768997,10.0,998,9.97294589178357
990,9,9.97272727272727,10.0,999,9.97297297297297
989,9,9.9747219413549,10.0,998,9.9749498997996
992,7,9.97782258064516,10.0,999,9.97797797797798
993,6,9.97784491440081,10.0,999,9.97797797797798
992,5,9.97983870967742,10.0,997,9.97993981945837
993,5,9.98086606243706,10.0,998,9.9809619238477
994,5,9.98088531187123,10.0,999,9.98098098098098
994,5,9.98088531187123,10.0,999,9.98098098098098
994,5,9.98189134808853,10.0,999,9.98198198198198
993,6,9.98187311178248,10.0,999,9.98198198198198
990,5,9.98080808080808,10.0,995,9.98090452261306
992,6,9.98286290322581,10.0,998,9.98296593186373
992,6,9.98084677419355,10.0,998,9.9809619238477
994,5,9.98390342052314,10.0,999,9.98398398398398
992,7,9.98387096774194,10.0,999,9.98398398398398
994,5,9.98490945674044,10.0,999,9.98498498498498
993,5,9.98388721047331,10.0,998,9.98396793587174
991,4,9.98385469223007,10.0,995,9.98391959798995
994,4,9.98289738430583,10.0,998,9.98296593186373
994,5,9.98289738430583,10.0,999,9.98298298298298
989,6,9.98584428715875,10.0,995,9.98592964824121
990,7,9.98585858585859,10.0,997,9.98595787362086
990,7,9.98383838383838,10.0,997,9.9839518555667
992,6,9.98487903225806,10.0,998,9.98496993987976
993,6,9.98388721047331,10.0,999,9.98398398398398
992,6,9.98286290322581,10.0,998,9.98296593186373
994,5,9.97887323943662,10.0,999,9.97897897897898
994,4,9.97987927565392,10.0,998,9.97995991983968
993,5,9.98288016112789,10.0,998,9.98296593186373
995,4,9.97989949748744,10.0,999,9.97997997997998
995,4,9.97788944723618,10.0,999,9.97797797797798
995,4,9.97587939698492,10.0,999,9.97597597597598
994,4,9.97987927565392,10.0,998,9.97995991983968
994,4,9.97987927565392,10.0,998,9.97995991983968
995,3,9.98090452261306,10.0,998,9.9809619238477
995,4,9.97889447236181,10.0,999,9.97897897897898
993,4,9.97784491440081,10.0,997,9.97793380140421
995,4,9.97788944723618,10.0,999,9.97797797797798
994,5,9.97786720321932,10.0,999,9.97797797797798
993,5,9.97985901309164,10.0,998,9.97995991983968
996,3,9.97791164658635,10.0,999,9.97797797797798
997,2,9.98294884653962,10.0,999,9.98298298298298
997,2,9.98294884653962,10.0,999,9.98298298298298
996,3,9.98393574297189,10.0,999,9.98398398398398
996,2,9.98493975903614,10.0,998,9.98496993987976
995,3,9.98291457286432,10.0,998,9.98296593186373
996,2,9.98293172690763,10.0,998,9.98296593186373
995,2,9.98291457286432,10.0,997,9.98294884653962
996,3,9.98493975903614,10.0,999,9.98498498498498
998,1,9.98597194388778,10.0,999,9.98598598598599
997,1,9.98796389167503,10.0,998,9.98797595190381
998,1,9.98997995991984,10.0,999,9.98998998998999
997,0,9.98796389167503,NaN,997,9.98796389167503
999,0,9.98798798798799,NaN,999,9.98798798798799
998,0,9.98597194388778,NaN,998,9.98597194388778
997,0,9.9839518555667,NaN,997,9.9839518555667
999,0,9.98198198198198,NaN,999,9.98198198198198
999,0,9.98198198198198,NaN,999,9.98198198198198
996,0,9.98393574297189,NaN,996,9.98393574297189
998,0,9.98296593186373,NaN,998,9.98296593186373
998,0,9.98396793587174,NaN,998,9.98396793587174
999,0,9.98398398398398,NaN,999,9.98398398398398
998,0,9.98496993987976,NaN,998,9.98496993987976
999,0,9.98598598598599,NaN,999,9.98598598598599
998,0,9.98597194388778,NaN,998,9.98597194388778
999,0,9.98598598598599,NaN,999,9.98598598598599
998,0,9.98797595190381,NaN,998,9.98797595190381
999,0,9.98798798798799,NaN,999,9.98798798798799
999,0,9.99099099099099,NaN,999,9.99099099099099
999,0,9.98998998998999,NaN,999,9.98998998998999
999,0,9.98998998998999,NaN,999,9.98998998998999
999,0,9.98898898898899,NaN,999,9.98898898898899
998,0,9.98797595190381,NaN,998,9.98797595190381
999,0,9.98898898898899,NaN,999,9.98898898898899
997,0,9.98796389167503,NaN,997,9.98796389167503
999,0,9.98598598598599,NaN,999,9.98598598598599
999,0,9.98698698698699,NaN,999,9.98698698698699
999,0,9.98398398398398,NaN,999,9.98398398398398
998,0,9.98396793587174,NaN,998,9.98396793587174
999,0,9.98198198198198,NaN,999,9.98198198198198
997,0,9.98294884653962,NaN,997,9.98294884653962
998,0,9.98196392785571,NaN,998,9.98196392785571
999,0,9.98198198198198,NaN,999,9.98198198198198
996,0,9.98092369477912,NaN,996,9.98092369477912
998,0,9.97995991983968,NaN,998,9.97995991983968
999,0,9.97697697697698,NaN,999,9.97697697697698
999,0,9.97697697697698,NaN,999,9.97697697697698
999,0,9.98198198198198,NaN,999,9.98198198198198
999,0,9.98398398398398,NaN,999,9.98398398398398
999,0,9.98398398398398,NaN,999,9.98398398398398
996,0,9.98293172690763,NaN,996,9.98293172690763
999,0,9.98298298298298,NaN,999,9.98298298298298
999,0,9.98198198198198,NaN,999,9.98198198198198
998,0,9.98296593186373,NaN,998,9.98296593186373
998,0,9.98196392785571,NaN,998,9.98196392785571
999,0,9.98498498498498,NaN,999,9.98498498498498
999,0,9.98398398398398,NaN,999,9.98398398398398
996,0,9.98293172690763,NaN,996,9.98293172690763
998,0,9.98396793587174,NaN,998,9.98396793587174
999,0,9.98298298298298,NaN,999,9.98298298298298
999,0,9.98398398398398,NaN,999,9.98398398398398
998,0,9.98296593186373,NaN,998,9.98296593186373
999,0,9.98198198198198,NaN,999,9.98198198198198
998,0,9.98196392785571,NaN,998,9.98196392785571
999,0,9.98098098098098,NaN,999,9.98098098098098
999,0,9.98098098098098,NaN,999,9.98098098098098
999,0,9.97897897897898,NaN,999,9.97897897897898
998,0,9.97995991983968,NaN,998,9.97995991983968
999,0,9.98098098098098,NaN,999,9.98098098098098
999,0,9.98098098098098,NaN,999,9.98098098098098
996,0,9.98293172690763,NaN,996,9.98293172690763
999,0,9.98298298298298,NaN,999,9.98298298298298
999,0,9.98198198198198,NaN,999,9.98198198198198
999,0,9.98298298298298,NaN,999,9.98298298298298
999,0,9.98298298298298,NaN,999,9.98298298298298
998,0,9.98196392785571,NaN,998,9.98196392785571
999,0,9.97997997997998,NaN,999,9.97997997997998
999,0,9.97897897897898,NaN,999,9.97897897897898
999,0,9.97697697697698,NaN,999,9.97697697697698
999,0,9.97997997997998,NaN,999,9.97997997997998
999,0,9.97997997997998,NaN,999,9.97997997997998
999,0,9.97797797797798,NaN,999,9.97797797797798
998,0,9.97895791583166,NaN,998,9.97895791583166
998,0,9.97695390781563,NaN,998,9.97695390781563
998,0,9.97595190380762,NaN,998,9.97595190380762
998,0,9.97394789579158,NaN,998,9.97394789579158
999,0,9.97497497497497,NaN,999,9.97497497497497
997,0,9.97592778335005,NaN,997,9.97592778335005
998,0,9.9749498997996,NaN,998,9.9749498997996
999,0,9.97597597597598,NaN,999,9.97597597597598
996,0,9.97590361445783,NaN,996,9.97590361445783
998,0,9.97895791583166,NaN,998,9.97895791583166
998,0,9.97595190380762,NaN,998,9.97595190380762
998,0,9.9749498997996,NaN,998,9.9749498997996
999,0,9.97697697697698,NaN,999,9.97697697697698
996,0,9.97489959839357,NaN,996,9.97489959839357
999,0,9.97597597597598,NaN,999,9.97597597597598
998,0,9.97595190380762,NaN,998,9.97595190380762
997,0,9.97492477432297,NaN,997,9.97492477432297
999,0,9.97397397397397,NaN,999,9.97397397397397
998,0,9.9749498997996,NaN,998,9.9749498997996
999,0,9.97297297297297,NaN,999,9.97297297297297
997,0,9.97091273821464,NaN,997,9.97091273821464
997,0,9.97291875626881,NaN,997,9.97291875626881
997,0,9.97191574724173,NaN,997,9.97191574724173
999,0,9.97297297297297,NaN,999,9.97297297297297
998,0,9.9749498997996,NaN,998,9.9749498997996
998,0,9.97595190380762,NaN,998,9.97595190380762
998,0,9.9749498997996,NaN,998,9.9749498997996
999,0,9.97497497497497,NaN,999,9.97497497497497
999,0,9.97297297297297,NaN,999,9.97297297297297
997,0,9.97291875626881,NaN,997,9.97291875626881
997,0,9.97392176529589,NaN,997,9.97392176529589
999,0,9.97497497497497,NaN,999,9.97497497497497
999,0,9.97397397397397,NaN,999,9.97397397397397
999,0,9.97597597597598,NaN,999,9.97597597597598
999,0,9.97397397397397,NaN,999,9.97397397397397
999,0,9.97497497497497,NaN,999,9.97497497497497
999,0,9.97597597597598,NaN,999,9.97597597597598
998,0,9.97795591182365,NaN,998,9.97795591182365
999,0,9.97797797797798,NaN,999,9.97797797797798
999,0,9.97697697697698,NaN,999,9.97697697697698
998,0,9.97795591182365,NaN,998,9.97795591182365
999,0,9.97797797797798,NaN,999,9.97797797797798
999,0,9.97897897897898,NaN,999,9.97897897897898
999,0,9.97797797797798,NaN,999,9.97797797797798
999,0,9.97997997997998,NaN,999,9.97997997997998
998,0,9.97995991983968,NaN,998,9.97995991983968
999,0,9.98098098098098,NaN,999,9.98098098098098
998,0,9.97995991983968,NaN,998,9.97995991983968
999,0,9.98498498498498,NaN,999,9.98498498498498
999,0,9.98698698698699,NaN,999,9.98698698698699
999,0,9.98798798798799,NaN,999,9.98798798798799
999,0,9.98998998998999,NaN,999,9.98998998998999
998,0,9.98897795591182,NaN,998,9.98897795591182
999,0,9.98998998998999,NaN,999,9.98998998998999
998,0,9.98697394789579,NaN,998,9.98697394789579
998,0,9.98797595190381,NaN,998,9.98797595190381
997,0,9.98696088264794,NaN,997,9.98696088264794
999,0,9.98498498498498,NaN,999,9.98498498498498
998,0,9.98597194388778,NaN,998,9.98597194388778
998,0,9.98496993987976,NaN,998,9.98496993987976
