forward_num,reverse_num,forward_rate,reverse_rate,organism_num,organism_rate
5,5,5.0,5.0,10,5.0
5,5,5.0,5.0,10,5.0
5,5,5.0,5.0,10,5.0
6,5,5.83333333333333,5.0,11,5.45454545454545
7,7,5.42857142857143,5.57142857142857,14,5.5
9,8,5.33333333333333,5.25,17,5.29411764705882
11,10,5.81818181818182,5.0,21,5.42857142857143
13,11,5.61538461538461,4.90909090909091,24,5.29166666666667
16,14,6.0,5.07142857142857,30,5.56666666666667
19,14,5.78947368421053,5.07142857142857,33,5.48484848484848
23,19,5.82608695652174,5.84210526315789,42,5.83333333333333
30,21,5.93333333333333,6.04761904761905,51,5.98039215686275
36,27,6.11111111111111,5.66666666666667,63,5.92063492063492
43,32,6.04651162790698,5.75,75,5.92
54,39,6.05555555555556,6.12820512820513,93,6.08602150537634
66,47,6.04545454545455,6.06382978723404,113,6.05309734513274
78,55,6.03846153846154,6.23636363636364,133,6.1203007518797
97,67,6.04123711340206,6.32835820895522,164,6.15853658536585
118,81,5.95762711864407,6.33333333333333,199,6.1105527638191
150,97,5.86,6.29896907216495,247,6.03238866396761
181,118,5.79005524861878,6.35593220338983,299,6.0133779264214
220,144,5.86818181818182,6.31944444444444,364,6.0467032967033
270,174,5.91111111111111,6.27586206896552,444,6.05405405405405
333,219,5.84384384384384,6.24657534246575,552,6.0036231884058
405,268,5.76296296296296,6.23134328358209,673,5.94947994056464
491,320,5.81466395112016,6.24375,811,5.98397040690506
593,393,5.81787521079258,6.23155216284987,986,5.98275862068965
609,389,5.8423645320197,6.18251928020566,998,5.9749498997996
604,395,5.75165562913907,6.19493670886076,999,5.92692692692693
616,382,5.59253246753247,6.20680628272251,998,5.82765531062124
606,393,5.5990099009901,6.16030534351145,999,5.81981981981982
605,393,5.6099173553719,6.08651399491094,998,5.79759519038076
604,395,5.56622516556291,6.11898734177215,999,5.78478478478478
609,390,5.60591133004926,6.16923076923077,999,5.82582582582583
609,390,5.54679802955665,6.15384615384615,999,5.78378378378378
610,389,5.57049180327869,6.13624678663239,999,5.79079079079079
592,406,5.53885135135135,6.14532019704434,998,5.78557114228457
598,400,5.46321070234114,6.1425,998,5.73547094188377
606,392,5.46534653465347,6.12755102040816,998,5.72545090180361
599,400,5.48580968280467,6.2125,999,5.77677677677678
599,400,5.50918196994992,6.1575,999,5.76876876876877
597,401,5.49413735343384,6.09226932668329,998,5.73446893787575
602,395,5.44518272425249,6.13670886075949,997,5.71915747241725
601,397,5.35108153078203,6.08312342569269,998,5.64228456913828
602,397,5.26910299003322,6.11083123425693,999,5.6036036036036
603,394,5.2636815920398,6.06091370558376,997,5.57873620862588
599,398,5.2771285475793,5.9572864321608,997,5.54864593781344
601,395,5.30116472545757,5.9620253164557,996,5.56325301204819
607,391,5.31466227347611,5.88235294117647,998,5.53707414829659
607,391,5.32125205930807,5.9309462915601,998,5.56012024048096
613,385,5.39477977161501,5.94545454545455,998,5.60721442885772
615,384,5.40162601626016,5.8984375,999,5.59259259259259
615,384,5.36585365853659,5.875,999,5.56156156156156
618,380,5.39482200647249,5.85263157894737,998,5.56913827655311
623,375,5.36115569823435,5.78933333333333,998,5.52204408817635
622,377,5.38102893890675,5.71883289124668,999,5.50850850850851
625,373,5.4864,5.71045576407507,998,5.57014028056112
625,372,5.4752,5.71505376344086,997,5.56469408224674
631,368,5.47860538827258,5.62771739130435,999,5.53353353353353
624,372,5.5,5.60483870967742,996,5.53915662650602
637,362,5.54788069073783,5.61602209944751,999,5.57257257257257
642,357,5.59034267912773,5.65826330532213,999,5.61461461461461
642,357,5.59968847352025,5.60504201680672,999,5.6016016016016
638,361,5.53291536050157,5.65096952908587,999,5.57557557557558
635,363,5.53228346456693,5.53994490358127,998,5.53507014028056
629,368,5.53100158982512,5.6195652173913,997,5.56369107321966
624,373,5.51442307692308,5.71045576407507,997,5.58776328986961
621,378,5.51851851851852,5.75661375661376,999,5.60860860860861
618,379,5.542071197411,5.71503957783641,997,5.60782347041123
616,383,5.53896103896104,5.72323759791123,999,5.60960960960961
613,385,5.54975530179445,5.71688311688312,998,5.61422845691383
609,389,5.54187192118227,5.75835475578406,998,5.62625250501002
615,384,5.49430894308943,5.70833333333333,999,5.57657657657658
615,383,5.53333333333333,5.62924281984334,998,5.57014028056112
611,388,5.48936170212766,5.63659793814433,999,5.54654654654655
594,404,5.47306397306397,5.61881188118812,998,5.53206412825651
601,397,5.51247920133112,5.57178841309824,998,5.53607214428858
599,398,5.46410684474124,5.58793969849246,997,5.5135406218656
590,409,5.46271186440678,5.58679706601467,999,5.51351351351351
586,410,5.51023890784983,5.53170731707317,996,5.51907630522088
588,411,5.48469387755102,5.58637469586375,999,5.52652652652653
590,407,5.53220338983051,5.64619164619165,997,5.57873620862588
590,408,5.49661016949153,5.61029411764706,998,5.54308617234469
596,403,5.50671140939597,5.5682382133995,999,5.53153153153153
597,401,5.5142378559464,5.5785536159601,998,5.54008016032064
589,410,5.55517826825127,5.65853658536585,999,5.5975975975976
591,408,5.57698815566836,5.53676470588235,999,5.56056056056056
567,431,5.49559082892416,5.58932714617169,998,5.53607214428858
562,437,5.51245551601424,5.53318077803204,999,5.52152152152152
565,434,5.49911504424779,5.54608294930876,999,5.51951951951952
573,425,5.49389179755672,5.52,998,5.50501002004008
571,427,5.40805604203152,5.61124121779859,998,5.49498997995992
575,424,5.41739130434783,5.6061320754717,999,5.4974974974975
576,421,5.38888888888889,5.6270783847981,997,5.48946840521565
590,407,5.34406779661017,5.55773955773956,997,5.43129388164493
601,398,5.36272878535774,5.55276381909548,999,5.43843843843844
597,401,5.33835845896147,5.58852867830424,998,5.43887775551102
600,398,5.36666666666667,5.61306532663317,998,5.46492985971944
591,408,5.36886632825719,5.65441176470588,999,5.48548548548549
592,407,5.43918918918919,5.6953316953317,999,5.54354354354354
593,405,5.38111298482293,5.71358024691358,998,5.51603206412826
592,406,5.42567567567568,5.67980295566502,998,5.52905811623246
603,396,5.40961857379768,5.7020202020202,999,5.52552552552553
599,400,5.39232053422371,5.6075,999,5.47847847847848
599,399,5.34056761268781,5.63659147869674,998,5.45891783567134
605,394,5.35867768595041,5.55329949238579,999,5.43543543543544
595,400,5.41176470588235,5.5725,995,5.47638190954774
599,400,5.37896494156928,5.57,999,5.45545545545546
603,396,5.39469320066335,5.56313131313131,999,5.46146146146146
614,383,5.34039087947883,5.52219321148825,997,5.41023069207623
617,380,5.27390599675851,5.53684210526316,997,5.3741223671013
623,376,5.30176565008026,5.53723404255319,999,5.39039039039039
623,375,5.31139646869984,5.50666666666667,998,5.38476953907816
618,381,5.28640776699029,5.49343832020997,999,5.36536536536537
621,378,5.3317230273752,5.43915343915344,999,5.37237237237237
619,379,5.36510500807754,5.36411609498681,998,5.36472945891784
615,384,5.44552845528455,5.38802083333333,999,5.42342342342342
615,383,5.44390243902439,5.4177545691906,998,5.43386773547094
613,386,5.40619902120718,5.4119170984456,999,5.40840840840841
601,397,5.4459234608985,5.3904282115869,998,5.42384769539078
592,407,5.48817567567568,5.23095823095823,999,5.38338338338338
597,402,5.48911222780569,5.21393034825871,999,5.37837837837838
599,398,5.57262103505843,5.26381909547739,997,5.4493480441324
605,392,5.51735537190083,5.28316326530612,997,5.42527582748245
601,397,5.5973377703827,5.34508816120907,998,5.49699398797595
599,399,5.52587646076795,5.38345864661654,998,5.4689378757515
593,406,5.57841483979764,5.48768472906404,999,5.54154154154154
598,401,5.55016722408027,5.45885286783042,999,5.51351351351351
598,401,5.52508361204013,5.47630922693267,999,5.50550550550551
595,404,5.52941176470588,5.44059405940594,999,5.49349349349349
614,385,5.46254071661238,5.3974025974026,999,5.43743743743744
618,381,5.44983818770227,5.41207349081365,999,5.43543543543544
619,379,5.40064620355412,5.39313984168865,998,5.39779559118236
615,383,5.35772357723577,5.39686684073107,998,5.37274549098196
619,380,5.35864297253635,5.43684210526316,999,5.38838838838839
608,390,5.41940789473684,5.41025641025641,998,5.41583166332665
610,389,5.42131147540984,5.43444730077121,999,5.42642642642643
609,390,5.41215106732348,5.44615384615385,999,5.42542542542543
604,394,5.42880794701987,5.51776649746193,998,5.46392785571142
608,391,5.41940789473684,5.52173913043478,999,5.45945945945946
609,389,5.44499178981938,5.49100257069409,998,5.46292585170341
604,394,5.49337748344371,5.40862944162437,998,5.45991983967936
601,396,5.51913477537438,5.37373737373737,997,5.46138415245737
597,401,5.5678391959799,5.27431421446384,998,5.4498997995992
596,403,5.56375838926174,5.23821339950372,999,5.43243243243243
594,404,5.56228956228956,5.25,998,5.43587174348697
599,399,5.47078464106845,5.30075187969925,998,5.40280561122244
592,406,5.4847972972973,5.33743842364532,998,5.4248496993988
599,399,5.49415692821369,5.40100250626566,998,5.45691382765531
601,397,5.49584026622296,5.50125944584383,998,5.49799599198397
591,405,5.54483925549915,5.47901234567901,996,5.51807228915663
594,405,5.56902356902357,5.56049382716049,999,5.56556556556557
596,403,5.56879194630872,5.64516129032258,999,5.5995995995996
600,398,5.57666666666667,5.52763819095477,998,5.55711422845691
596,403,5.55872483221477,5.46898263027295,999,5.52252252252252
599,399,5.52754590984975,5.54385964912281,998,5.53406813627254
600,399,5.47666666666667,5.57142857142857,999,5.51451451451451
602,394,5.46843853820598,5.65228426395939,996,5.54116465863454
597,401,5.52596314907873,5.64837905236908,998,5.5751503006012
621,378,5.58937198067633,5.62962962962963,999,5.6046046046046
609,390,5.61576354679803,5.57948717948718,999,5.6016016016016
608,391,5.57730263157895,5.59079283887468,999,5.58258258258258
611,388,5.60556464811784,5.54896907216495,999,5.58358358358358
619,378,5.58158319870759,5.58201058201058,997,5.58174523570712
615,384,5.6,5.609375,999,5.6036036036036
606,393,5.62871287128713,5.59033078880407,999,5.61361361361361
615,384,5.65365853658537,5.55208333333333,999,5.61461461461461
626,372,5.58626198083067,5.63172043010753,998,5.60320641282565
626,373,5.54632587859425,5.63002680965147,999,5.57757757757758
625,374,5.6032,5.62032085561497,999,5.60960960960961
628,371,5.55891719745223,5.66846361185984,999,5.5995995995996
626,373,5.53514376996805,5.70509383378016,999,5.5985985985986
624,375,5.56089743589744,5.63733333333333,999,5.58958958958959
637,361,5.59340659340659,5.58171745152355,998,5.58917835671343
631,367,5.52614896988907,5.59945504087194,998,5.55310621242485
644,355,5.54192546583851,5.53239436619718,999,5.53853853853854
641,358,5.50858034321373,5.56703910614525,999,5.52952952952953
641,355,5.56318252730109,5.53239436619718,996,5.55220883534137
643,354,5.6298600311042,5.6045197740113,997,5.62086258776329
646,352,5.65170278637771,5.50284090909091,998,5.59919839679359
651,346,5.63594470046083,5.41618497109827,997,5.55967903711133
661,338,5.65809379727685,5.46449704142012,999,5.59259259259259
660,339,5.66212121212121,5.41592920353982,999,5.57857857857858
654,344,5.71406727828746,5.58139534883721,998,5.66833667334669
653,346,5.68147013782542,5.48843930635838,999,5.61461461461461
659,338,5.59787556904401,5.52662721893491,997,5.57372116349047
654,344,5.63149847094801,5.44767441860465,998,5.56813627254509
656,342,5.60365853658537,5.48245614035088,998,5.56212424849699
664,334,5.64307228915663,5.47604790419162,998,5.58717434869739
662,336,5.63293051359517,5.46726190476191,998,5.57715430861723
652,345,5.6058282208589,5.41159420289855,997,5.53861584754263
656,343,5.61432926829268,5.39067055393586,999,5.53753753753754
657,341,5.54490106544901,5.40469208211144,998,5.49699398797595
658,341,5.54255319148936,5.39296187683284,999,5.49149149149149
651,348,5.53456221198157,5.37931034482759,999,5.48048048048048
650,348,5.55384615384615,5.35632183908046,998,5.48496993987976
647,350,5.45749613601236,5.31142857142857,997,5.4062186559679
652,344,5.42638036809816,5.28779069767442,996,5.3785140562249
646,351,5.43034055727554,5.25925925925926,997,5.37011033099298
648,351,5.40277777777778,5.31623931623932,999,5.37237237237237
643,356,5.39035769828927,5.33707865168539,999,5.37137137137137
641,356,5.29017160686427,5.40730337078652,997,5.33199598796389
645,351,5.29922480620155,5.4045584045584,996,5.3363453815261
642,357,5.34735202492212,5.35574229691877,999,5.35035035035035
646,353,5.34674922600619,5.29178470254957,999,5.32732732732733
640,358,5.35625,5.27374301675978,998,5.32665330661323
647,351,5.40185471406491,5.27635327635328,998,5.35771543086172
659,338,5.38694992412747,5.28402366863905,997,5.35205616850552
655,343,5.42137404580153,5.3469387755102,998,5.39579158316633
656,341,5.36890243902439,5.24926686217009,997,5.32798395185557
659,339,5.36722306525038,5.30678466076696,998,5.34669338677355
667,332,5.35532233883059,5.32228915662651,999,5.34434434434434
664,335,5.42620481927711,5.21492537313433,999,5.35535535535536
669,329,5.41853512705531,5.2887537993921,998,5.37575150300601
676,321,5.46005917159763,5.36448598130841,997,5.42928786359077
672,327,5.45089285714286,5.36391437308868,999,5.42242242242242
677,322,5.40768094534712,5.25155279503106,999,5.35735735735736
677,321,5.48892171344165,5.27725856697819,998,5.42084168336673
675,324,5.53037037037037,5.28086419753086,999,5.44944944944945
675,322,5.57037037037037,5.14906832298137,997,5.43430290872618
664,335,5.54668674698795,5.14328358208955,999,5.41141141141141
663,336,5.53996983408748,5.21428571428571,999,5.43043043043043
665,334,5.54135338345865,5.15269461077844,999,5.41141141141141
668,331,5.55988023952096,5.15407854984894,999,5.42542542542543
661,337,5.59152798789713,5.10089020771513,998,5.42585170340681
660,339,5.60909090909091,5.10619469026549,999,5.43843843843844
661,337,5.55219364599092,5.14540059347181,998,5.41482965931864
665,333,5.57894736842105,5.20720720720721,998,5.45490981963928
675,324,5.55407407407407,5.28703703703704,999,5.46746746746747
678,321,5.57817109144543,5.23364485981308,999,5.46746746746747
681,315,5.59911894273128,5.13333333333333,996,5.45180722891566
690,307,5.67536231884058,5.10097719869707,997,5.49849548645938
693,305,5.64790764790765,5.02295081967213,998,5.45691382765531
687,310,5.62445414847162,5.02903225806452,997,5.43931795386158
696,303,5.5933908045977,4.97359735973597,999,5.40540540540541
695,304,5.57841726618705,4.99342105263158,999,5.4004004004004
698,299,5.53581661891117,5.09698996655518,997,5.40421263791374
703,296,5.54765291607397,5.14189189189189,999,5.42742742742743
707,292,5.55869872701556,5.16438356164384,999,5.44344344344344
706,292,5.63314447592068,5.13698630136986,998,5.48797595190381
711,288,5.66526019690577,5.07986111111111,999,5.4964964964965
709,289,5.67559943582511,5.06920415224914,998,5.5
712,287,5.64606741573034,5.1219512195122,999,5.4954954954955
721,275,5.65325936199723,5.10909090909091,996,5.50301204819277
723,276,5.66804979253112,5.07246376811594,999,5.5035035035035
724,274,5.70165745856354,5.12043795620438,998,5.54208416833667
722,277,5.66759002770083,5.15162454873646,999,5.52452452452452
722,275,5.68698060941828,5.21090909090909,997,5.55566700100301
728,271,5.69368131868132,5.13653136531365,999,5.54254254254254
734,264,5.67574931880109,5.16666666666667,998,5.54108216432866
739,260,5.61028416779432,5.29230769230769,999,5.52752752752753
736,262,5.54755434782609,5.28625954198473,998,5.47895791583166
744,255,5.63172043010753,5.3843137254902,999,5.56856856856857
745,253,5.65637583892617,5.42687747035573,998,5.59819639278557
746,253,5.68364611260054,5.39525691699605,999,5.61061061061061
741,258,5.6693657219973,5.38759689922481,999,5.5965965965966
745,253,5.6241610738255,5.39920948616601,998,5.56713426853707
750,249,5.61466666666667,5.44578313253012,999,5.57257257257257
750,248,5.64666666666667,5.45161290322581,998,5.59819639278557
748,251,5.57219251336898,5.37450199203187,999,5.52252252252252
749,249,5.57943925233645,5.4136546184739,998,5.53807615230461
753,244,5.56972111553785,5.36885245901639,997,5.52056168505517
757,242,5.63276089828269,5.45454545454545,999,5.58958958958959
758,240,5.61741424802111,5.3625,998,5.5561122244489
764,235,5.54188481675393,5.47234042553191,999,5.52552552552553
760,239,5.44868421052632,5.46025104602511,999,5.45145145145145
764,234,5.46073298429319,5.54700854700855,998,5.48096192384769
768,231,5.47135416666667,5.58441558441558,999,5.4974974974975
766,233,5.47519582245431,5.47210300429185,999,5.47447447447447
769,228,5.46814044213264,5.42543859649123,997,5.45837512537613
778,221,5.45244215938303,5.42081447963801,999,5.44544544544545
773,226,5.40491591203105,5.4646017699115,999,5.41841841841842
770,229,5.45324675324675,5.4061135371179,999,5.44244244244244
774,224,5.46124031007752,5.45535714285714,998,5.45991983967936
774,225,5.47545219638243,5.38666666666667,999,5.45545545545546
774,225,5.51291989664083,5.27111111111111,999,5.45845845845846
776,223,5.49484536082474,5.33632286995516,999,5.45945945945946
773,226,5.45019404915912,5.36283185840708,999,5.43043043043043
764,235,5.48429319371728,5.44255319148936,999,5.47447447447447
768,230,5.49739583333333,5.4,998,5.4749498997996
772,226,5.46373056994819,5.32743362831858,998,5.43286573146293
770,229,5.52077922077922,5.32314410480349,999,5.47547547547548
768,231,5.54296875,5.32900432900433,999,5.49349349349349
772,225,5.5220207253886,5.33333333333333,997,5.47943831494483
768,231,5.5625,5.32034632034632,999,5.50650650650651
768,231,5.53125,5.35064935064935,999,5.48948948948949
764,235,5.56675392670157,5.44255319148936,999,5.53753753753754
765,232,5.51895424836601,5.47844827586207,997,5.50952858575727
765,234,5.53464052287582,5.40598290598291,999,5.5045045045045
765,234,5.47320261437909,5.37606837606838,999,5.45045045045045
763,235,5.48099606815203,5.23404255319149,998,5.42284569138277
773,226,5.48900388098318,5.23893805309735,999,5.43243243243243
776,223,5.43427835051546,5.28699551569507,999,5.4014014014014
779,220,5.41720154043646,5.24545454545455,999,5.37937937937938
777,222,5.39510939510939,5.43693693693694,999,5.4044044044044
783,215,5.3882503192848,5.4,998,5.39078156312625
780,218,5.36794871794872,5.37155963302752,998,5.3687374749499
783,214,5.39974457215837,5.4018691588785,997,5.40020060180542
777,222,5.42084942084942,5.34684684684685,999,5.4044044044044
775,223,5.42709677419355,5.26008968609866,998,5.38977955911824
770,227,5.45714285714286,5.26431718061674,997,5.41323971915747
771,227,5.45784695201038,5.22466960352423,998,5.40480961923848
779,220,5.46341463414634,5.27727272727273,999,5.42242242242242
785,214,5.50828025477707,5.39719626168224,999,5.48448448448448
776,223,5.48324742268041,5.41704035874439,999,5.46846846846847
783,216,5.45210727969349,5.50462962962963,999,5.46346346346346
782,213,5.41687979539642,5.38028169014085,995,5.40904522613065
791,207,5.48672566371681,5.38164251207729,998,5.46492985971944
792,207,5.47222222222222,5.33816425120773,999,5.44444444444444
796,203,5.45477386934673,5.31527093596059,999,5.42642642642643
798,200,5.468671679198,5.205,998,5.41583166332665
798,198,5.45238095238095,5.29292929292929,996,5.4206827309237
800,197,5.4075,5.28426395939086,997,5.38314944834504
804,195,5.43407960199005,5.27692307692308,999,5.4034034034034
805,193,5.48074534161491,5.24352331606218,998,5.43486973947896
807,191,5.49566294919455,5.24607329842932,998,5.44789579158317
820,179,5.50731707317073,5.23463687150838,999,5.45845845845846
821,178,5.54202192448234,5.2247191011236,999,5.48548548548549
822,176,5.47080291970803,5.125,998,5.40981963927856
818,180,5.53545232273839,5.12777777777778,998,5.46192384769539
820,178,5.56829268292683,5.20786516853933,998,5.50400801603206
820,179,5.52804878048781,5.14525139664805,999,5.45945945945946
813,186,5.54735547355474,5.1505376344086,999,5.47347347347347
809,190,5.50679851668727,5.12631578947368,999,5.43443443443443
807,192,5.52912019826518,5.1875,999,5.46346346346346
806,193,5.49255583126551,5.25906735751295,999,5.44744744744745
808,191,5.52351485148515,5.20942408376963,999,5.46346346346346
808,191,5.53589108910891,5.29842931937173,999,5.49049049049049
807,191,5.53531598513011,5.3455497382199,998,5.49899799599198
818,180,5.62958435207824,5.37222222222222,998,5.58316633266533
814,184,5.62653562653563,5.31521739130435,998,5.56913827655311
820,178,5.6,5.2752808988764,998,5.54208416833667
824,174,5.61893203883495,5.26436781609195,998,5.55711422845691
819,180,5.6031746031746,5.43333333333333,999,5.57257257257257
813,185,5.55719557195572,5.51351351351351,998,5.54909819639279
824,175,5.51941747572816,5.46857142857143,999,5.51051051051051
824,175,5.54126213592233,5.4,999,5.51651651651652
821,178,5.55663824604141,5.17977528089888,999,5.48948948948949
824,175,5.49029126213592,5.18285714285714,999,5.43643643643644
828,170,5.45289855072464,5.31764705882353,998,5.42985971943888
827,172,5.46432889963724,5.22093023255814,999,5.42242242242242
828,171,5.49275362318841,5.3625730994152,999,5.47047047047047
831,167,5.54271961492178,5.32335329341317,998,5.5060120240481
836,163,5.50956937799043,5.44171779141104,999,5.4984984984985
835,164,5.50059880239521,5.49390243902439,999,5.4994994994995
837,162,5.51015531660693,5.47530864197531,999,5.5045045045045
838,161,5.46420047732697,5.4472049689441,999,5.46146146146146
840,157,5.42142857142857,5.43949044585987,997,5.42427281845537
838,161,5.35441527446301,5.4472049689441,999,5.36936936936937
832,167,5.37980769230769,5.38922155688623,999,5.38138138138138
834,165,5.38968824940048,5.48484848484848,999,5.40540540540541
831,168,5.32851985559567,5.43452380952381,999,5.34634634634635
830,169,5.30722891566265,5.43786982248521,999,5.32932932932933
824,172,5.26699029126214,5.44767441860465,996,5.29819277108434
831,167,5.3453670276775,5.51497005988024,998,5.37374749498998
838,161,5.35441527446301,5.47204968944099,999,5.37337337337337
838,161,5.39737470167064,5.46583850931677,999,5.40840840840841
843,156,5.41992882562278,5.54487179487179,999,5.43943943943944
849,149,5.43345111896349,5.60402684563758,998,5.45891783567134
841,156,5.48156956004756,5.83333333333333,997,5.53660982948847
843,156,5.47568208778173,5.85897435897436,999,5.53553553553554
835,161,5.46706586826347,5.77639751552795,996,5.51706827309237
835,163,5.44311377245509,5.79754601226994,998,5.50100200400802
837,161,5.46117084826762,5.70807453416149,998,5.50100200400802
840,159,5.43928571428571,5.59748427672956,999,5.46446446446446
832,165,5.42307692307692,5.43636363636364,997,5.42527582748245
839,160,5.4088200238379,5.59375,999,5.43843843843844
834,162,5.41846522781775,5.62962962962963,996,5.45281124497992
837,161,5.44086021505376,5.6583850931677,998,5.47595190380762
838,161,5.4618138424821,5.67701863354037,999,5.4964964964965
838,161,5.47255369928401,5.72049689440994,999,5.51251251251251
841,156,5.46967895362663,5.64102564102564,997,5.49648946840522
842,156,5.43824228028504,5.62179487179487,998,5.46693386773547
838,160,5.42601431980907,5.725,998,5.47394789579158
840,158,5.41071428571429,5.74683544303798,998,5.46392785571142
835,162,5.38922155688623,5.87654320987654,997,5.46840521564694
836,162,5.36124401913876,5.90740740740741,998,5.4498997995992
847,152,5.3258559622196,5.84868421052632,999,5.40540540540541
855,143,5.34736842105263,5.82517482517482,998,5.41583166332665
853,144,5.36576787807737,5.90972222222222,997,5.44433299899699
856,143,5.37266355140187,5.90909090909091,999,5.44944944944945
853,146,5.3810082063306,5.86986301369863,999,5.45245245245245
859,140,5.34458672875437,5.80714285714286,999,5.40940940940941
862,136,5.29118329466357,5.77205882352941,998,5.35671342685371
859,139,5.31897555296857,5.84172661870504,998,5.39178356713427
868,131,5.34562211981567,5.81679389312977,999,5.40740740740741
857,141,5.29404900816803,5.80141843971631,998,5.36573146292585
857,141,5.31505250875146,5.82978723404255,998,5.3877755511022
850,148,5.28352941176471,5.82432432432432,998,5.36372745490982
857,141,5.29521586931155,5.94326241134752,998,5.38677354709419
852,146,5.29694835680751,6.02054794520548,998,5.40280561122244
848,151,5.27594339622642,6.01324503311258,999,5.38738738738739
849,150,5.24852767962309,5.92,999,5.34934934934935
853,144,5.19460726846424,5.9375,997,5.30190571715145
846,150,5.2210401891253,6.04666666666667,996,5.34538152610442
852,145,5.21244131455399,6.08275862068966,997,5.33901705115346
856,142,5.22663551401869,6.04225352112676,998,5.34268537074148
849,150,5.25441696113074,5.98666666666667,999,5.36436436436436
854,145,5.26814988290398,5.95172413793103,999,5.36736736736737
847,152,5.31286894923259,5.84868421052632,999,5.39439439439439
847,152,5.32821723730815,5.76973684210526,999,5.3953953953954
838,160,5.32458233890215,5.65625,998,5.37775551102204
839,159,5.31823599523242,5.71069182389937,998,5.38076152304609
837,162,5.33094384707288,5.66049382716049,999,5.38438438438438
836,162,5.29186602870813,5.66049382716049,998,5.35170340681363
835,162,5.26706586826347,5.57407407407407,997,5.31695085255767
839,159,5.24076281287247,5.54716981132075,998,5.28957915831663
842,157,5.23277909738717,5.67515923566879,999,5.3023023023023
847,152,5.25855962219599,5.61184210526316,999,5.31231231231231
844,155,5.22867298578199,5.56774193548387,999,5.28128128128128
837,160,5.24492234169653,5.50625,997,5.28686058174524
844,155,5.23815165876777,5.65161290322581,999,5.3023023023023
845,153,5.25917159763314,5.79084967320261,998,5.34068136272545
841,158,5.27467300832342,5.68354430379747,999,5.33933933933934
841,156,5.26753864447087,5.68589743589744,997,5.33299899699097
843,156,5.26571767497034,5.61538461538461,999,5.32032032032032
850,148,5.24352941176471,5.66891891891892,998,5.30661322645291
847,152,5.23258559622196,5.74342105263158,999,5.31031031031031
849,149,5.22850412249706,5.86577181208054,998,5.32364729458918
847,150,5.25029515938607,5.74666666666667,997,5.32497492477432
849,150,5.20848056537102,5.76,999,5.29129129129129
838,159,5.22076372315036,5.78616352201258,997,5.31093279839519
833,164,5.20528211284514,5.57926829268293,997,5.26680040120361
835,163,5.25508982035928,5.52760736196319,998,5.29959919839679
834,163,5.20383693045564,5.41717791411043,997,5.23871614844534
839,160,5.16448152562575,5.38125,999,5.1991991991992
837,161,5.21385902031063,5.42857142857143,998,5.24849699398798
837,162,5.1816009557945,5.40123456790123,999,5.21721721721722
839,158,5.16805721096544,5.36075949367089,997,5.19859578736209
840,159,5.23333333333333,5.28301886792453,999,5.24124124124124
834,165,5.28776978417266,5.33333333333333,999,5.2952952952953
836,163,5.36244019138756,5.29447852760736,999,5.35135135135135
841,157,5.4090368608799,5.43949044585987,998,5.41382765531062
844,153,5.38507109004739,5.41830065359477,997,5.3901705115346
849,150,5.3886925795053,5.46666666666667,999,5.4004004004004
847,149,5.35064935064935,5.49664429530201,996,5.37248995983936
848,149,5.34316037735849,5.47651006711409,997,5.36308926780341
849,150,5.39104829210836,5.62666666666667,999,5.42642642642643
847,149,5.35891381345927,5.71140939597315,996,5.41164658634538
849,150,5.33686690223793,5.68666666666667,999,5.38938938938939
849,150,5.2979976442874,5.77333333333333,999,5.36936936936937
851,148,5.24676850763807,5.78378378378378,999,5.32632632632633
850,149,5.21294117647059,5.69798657718121,999,5.28528528528529
842,156,5.27553444180523,5.65384615384615,998,5.33466933867735
839,158,5.30870083432658,5.65822784810127,997,5.36409227683049
847,151,5.3211334120425,5.68211920529801,998,5.37575150300601
851,147,5.26674500587544,5.68707482993197,998,5.32865731462926
851,148,5.22326674500588,5.62837837837838,999,5.28328328328328
848,151,5.25707547169811,5.62251655629139,999,5.31231231231231
849,150,5.30624263839812,5.54666666666667,999,5.34234234234234
846,153,5.29550827423168,5.64052287581699,999,5.34834834834835
845,154,5.30295857988166,5.62987012987013,999,5.35335335335335
848,151,5.32311320754717,5.6887417218543,999,5.37837837837838
849,148,5.34746760895171,5.62837837837838,997,5.38916750250752
852,146,5.29577464788732,5.55479452054795,998,5.33366733466934
855,143,5.25146198830409,5.51048951048951,998,5.28857715430862
855,144,5.2327485380117,5.49305555555556,999,5.27027027027027
860,139,5.27209302325581,5.50359712230216,999,5.3043043043043
856,143,5.28621495327103,5.48951048951049,999,5.31531531531532
850,148,5.3,5.5,998,5.32965931863727
853,146,5.30832356389215,5.50684931506849,999,5.33733733733734
850,149,5.38823529411765,5.55704697986577,999,5.41341341341341
847,152,5.38488783943329,5.55263157894737,999,5.41041041041041
848,149,5.40212264150943,5.35570469798658,997,5.39518555667001
860,138,5.3546511627907,5.31884057971014,998,5.3496993987976
858,141,5.27505827505828,5.32624113475177,999,5.28228228228228
850,148,5.27294117647059,5.33108108108108,998,5.2815631262525
860,138,5.28837209302326,5.40579710144928,998,5.30460921843687
865,132,5.29364161849711,5.31060606060606,997,5.29588766298897
871,128,5.29735935706085,5.4375,999,5.31531531531532
863,135,5.32329084588644,5.42962962962963,998,5.3376753507014
863,134,5.25608342989571,5.48507462686567,997,5.28686058174524
871,128,5.24799081515499,5.4453125,999,5.27327327327327
862,137,5.19953596287703,5.43795620437956,999,5.23223223223223
862,137,5.24013921113689,5.33576642335766,999,5.25325325325325
868,130,5.18433179723502,5.36153846153846,998,5.20741482965932
868,129,5.18663594470046,5.37984496124031,997,5.21163490471414
879,119,5.18543799772469,5.39495798319328,998,5.21042084168337
875,122,5.192,5.48360655737705,997,5.22768304914744
881,118,5.16118047673099,5.46610169491525,999,5.1971971971972
880,119,5.15909090909091,5.36974789915966,999,5.18418418418418
884,115,5.09502262443439,5.28695652173913,999,5.11711711711712
882,116,5.13151927437642,5.31034482758621,998,5.15230460921844
880,118,5.12954545454545,5.3135593220339,998,5.15130260521042
888,111,5.18581081081081,5.22522522522523,999,5.19019019019019
891,107,5.27721661054994,5.23364485981308,998,5.27254509018036
885,114,5.30169491525424,5.26315789473684,999,5.2972972972973
883,116,5.35220838052095,5.39655172413793,999,5.35735735735736
887,112,5.34498308906426,5.41071428571429,999,5.35235235235235
885,114,5.35706214689266,5.36842105263158,999,5.35835835835836
891,106,5.40291806958474,5.58490566037736,997,5.4222668004012
889,110,5.36220472440945,5.66363636363636,999,5.3953953953954
892,107,5.35986547085202,5.7196261682243,999,5.3983983983984
891,108,5.35353535353535,5.87037037037037,999,5.40940940940941
887,111,5.34047350620068,5.77477477477477,998,5.38877755511022
886,113,5.32392776523702,5.67256637168142,999,5.36336336336336
885,114,5.31412429378531,5.79824561403509,999,5.36936936936937
882,117,5.28798185941043,5.91452991452991,999,5.36136136136136
886,112,5.33069977426637,5.77678571428571,998,5.38076152304609
884,115,5.34615384615385,5.68695652173913,999,5.38538538538539
885,113,5.31638418079096,5.67256637168142,998,5.35671342685371
880,118,5.31136363636364,5.61016949152542,998,5.34669338677355
876,123,5.28196347031963,5.71544715447155,999,5.33533533533534
879,120,5.27758816837315,5.8,999,5.34034034034034
874,124,5.2837528604119,5.74193548387097,998,5.34068136272545
881,117,5.33484676503973,5.65811965811966,998,5.37274549098196
881,118,5.30533484676504,5.55932203389831,999,5.33533533533534
878,121,5.30979498861048,5.63636363636364,999,5.34934934934935
876,123,5.31050228310502,5.6260162601626,999,5.34934934934935
876,123,5.34246575342466,5.57723577235772,999,5.37137137137137
876,123,5.3824200913242,5.47967479674797,999,5.39439439439439
881,118,5.35300794551646,5.61016949152542,999,5.38338338338338
878,119,5.32687927107061,5.5546218487395,997,5.35406218655968
875,122,5.31085714285714,5.4672131147541,997,5.32998996990973
878,121,5.28815489749431,5.41322314049587,999,5.3033033033033
882,113,5.29478458049887,5.28318584070797,995,5.29346733668342
884,114,5.27036199095023,5.2719298245614,998,5.27054108216433
885,114,5.31977401129943,5.14035087719298,999,5.2992992992993
886,111,5.33069977426637,5.16216216216216,997,5.31193580742227
894,105,5.34787472035794,5.03809523809524,999,5.31531531531532
894,105,5.33221476510067,5.24761904761905,999,5.32332332332332
898,100,5.34187082405345,4.94,998,5.30160320641283
894,103,5.35346756152125,4.83495145631068,997,5.29989969909729
891,107,5.42985409652076,5.00934579439252,998,5.38476953907816
896,102,5.47433035714286,4.97058823529412,998,5.42284569138277
900,98,5.53444444444444,5.0,998,5.48196392785571
906,92,5.48344370860927,5.08695652173913,998,5.44689378757515
912,85,5.47916666666667,5.04705882352941,997,5.44232698094283
913,86,5.46659364731654,5.09302325581395,999,5.43443443443443
910,84,5.50989010989011,5.13095238095238,994,5.47786720321932
913,86,5.47097480832421,5.15116279069767,999,5.44344344344344
914,85,5.4617067833698,5.08235294117647,999,5.42942942942943
913,83,5.53121577217963,5.10843373493976,996,5.49598393574297
918,81,5.49019607843137,5.11111111111111,999,5.45945945945946
921,78,5.43648208469055,4.80769230769231,999,5.38738738738739
920,79,5.4195652173913,4.87341772151899,999,5.37637637637638
917,81,5.42529989094875,4.93827160493827,998,5.38577154308617
914,84,5.4835886214442,4.91666666666667,998,5.43587174348697
914,83,5.4617067833698,4.96385542168675,997,5.42026078234704
922,77,5.48698481561822,4.98701298701299,999,5.44844844844845
922,76,5.47396963123644,4.94736842105263,998,5.43386773547094
919,80,5.4961915125136,4.75,999,5.43643643643644
919,78,5.48095756256801,4.79487179487179,997,5.42728184553661
917,82,5.48200654307525,4.81707317073171,999,5.42742742742743
918,81,5.51307189542484,4.8641975308642,999,5.46046046046046
915,83,5.56830601092896,4.93975903614458,998,5.51603206412826
916,83,5.60152838427948,5.02409638554217,999,5.55355355355355
920,79,5.55217391304348,4.9873417721519,999,5.50750750750751
917,82,5.58124318429662,5.10975609756098,999,5.54254254254254
913,83,5.58598028477547,5.19277108433735,996,5.55321285140562
915,84,5.62841530054645,5.16666666666667,999,5.58958958958959
915,82,5.61639344262295,5.14634146341463,997,5.5777331995988
917,81,5.62813522355507,5.09876543209877,998,5.58517034068136
924,75,5.60930735930736,5.04,999,5.56656656656657
919,80,5.62350380848749,5.2,999,5.58958958958959
922,76,5.61822125813449,5.28947368421053,998,5.59318637274549
925,74,5.5772972972973,5.41891891891892,999,5.56556556556557
924,74,5.57467532467532,5.48648648648649,998,5.56813627254509
924,75,5.62012987012987,5.52,999,5.61261261261261
925,74,5.61621621621622,5.56756756756757,999,5.61261261261261
924,73,5.63419913419913,5.3972602739726,997,5.61685055165496
929,70,5.55543595263724,5.41428571428571,999,5.54554554554555
927,72,5.58036677454153,5.26388888888889,999,5.55755755755756
926,71,5.55723542116631,5.14084507042254,997,5.52758274824473
929,70,5.56404736275565,5.12857142857143,999,5.53353353353353
924,74,5.52272727272727,5.09459459459459,998,5.49098196392786
919,78,5.49727965179543,5.07692307692308,997,5.46439317953862
922,76,5.45661605206074,5.09210526315789,998,5.42885771543086
924,75,5.46320346320346,5.09333333333333,999,5.43543543543544
923,76,5.43878656554713,4.98684210526316,999,5.4044044044044
919,80,5.43743199129489,5.025,999,5.4044044044044
919,79,5.49292709466812,5.08860759493671,998,5.46092184368737
917,81,5.44711014176663,5.0,998,5.41082164328657
917,81,5.46782988004362,5.08641975308642,998,5.43687374749499
913,85,5.45892661555312,5.12941176470588,998,5.43086172344689
915,83,5.50601092896175,5.25301204819277,998,5.48496993987976
921,77,5.46796959826276,5.36363636363636,998,5.45991983967936
918,81,5.4760348583878,5.32098765432099,999,5.46346346346346
921,78,5.46688382193268,5.43589743589744,999,5.46446446446446
920,79,5.44021739130435,5.41772151898734,999,5.43843843843844
920,77,5.43478260869565,5.37662337662338,997,5.43029087261785
916,80,5.43013100436681,5.4,996,5.42771084337349
913,86,5.47207009857612,5.33720930232558,999,5.46046046046046
912,87,5.47478070175439,5.22988505747126,999,5.45345345345345
913,85,5.40416210295728,5.30588235294118,998,5.39579158316633
913,86,5.41073384446878,5.26744186046512,999,5.3983983983984
912,86,5.44627192982456,5.15116279069767,998,5.42084168336673
912,87,5.44078947368421,5.20689655172414,999,5.42042042042042
910,88,5.47582417582418,5.28409090909091,998,5.45891783567134
912,87,5.5,5.29885057471264,999,5.48248248248248
914,84,5.50656455142232,5.35714285714286,998,5.4939879759519
919,80,5.50272034820457,5.6,999,5.51051051051051
914,85,5.48577680525164,5.38823529411765,999,5.47747747747748
912,87,5.44407894736842,5.47126436781609,999,5.44644644644645
916,82,5.48362445414847,5.48780487804878,998,5.48396793587174
917,82,5.46455834242094,5.45121951219512,999,5.46346346346346
912,85,5.45285087719298,5.45882352941176,997,5.45336008024072
910,88,5.43846153846154,5.60227272727273,998,5.45290581162325
909,88,5.46974697469747,5.55681818181818,997,5.47743229689067
911,87,5.4390779363337,5.58620689655172,998,5.45190380761523
907,90,5.4244762954796,5.48888888888889,997,5.43029087261785
913,84,5.43592552026287,5.44047619047619,997,5.43630892678034
910,88,5.44725274725275,5.40909090909091,998,5.4438877755511
912,85,5.38925438596491,5.25882352941176,997,5.37813440320963
917,82,5.35659760087241,5.29268292682927,999,5.35135135135135
915,82,5.39125683060109,5.31707317073171,997,5.3851554663992
917,80,5.38386041439477,5.425,997,5.38716148445336
918,81,5.37908496732026,5.40740740740741,999,5.38138138138138
924,75,5.40692640692641,5.45333333333333,999,5.41041041041041
920,78,5.43152173913044,5.35897435897436,998,5.42585170340681
922,76,5.35574837310195,5.44736842105263,998,5.3627254509018
922,76,5.4002169197397,5.57894736842105,998,5.41382765531062
923,76,5.38353196099675,5.71052631578947,999,5.40840840840841
920,79,5.32826086956522,5.65822784810127,999,5.35435435435435
919,79,5.31338411316649,5.54430379746835,998,5.33166332665331
913,84,5.31982475355969,5.42857142857143,997,5.32898696088265
916,81,5.34279475982533,5.24691358024691,997,5.33500501504514
911,88,5.33479692645445,5.39772727272727,999,5.34034034034034
911,87,5.36882546652031,5.33333333333333,998,5.36573146292585
916,83,5.38755458515284,5.1566265060241,999,5.36836836836837
914,83,5.37855579868709,5.21686746987952,997,5.36509528585757
916,83,5.382096069869,5.14457831325301,999,5.36236236236236
913,85,5.38225629791895,5.21176470588235,998,5.36773547094188
912,86,5.33991228070175,5.22093023255814,998,5.32965931863727
916,83,5.3264192139738,5.26506024096386,999,5.32132132132132
913,86,5.32749178532311,5.23255813953488,999,5.31931931931932
914,84,5.32603938730853,5.39285714285714,998,5.33166332665331
920,78,5.35760869565217,5.46153846153846,998,5.36573146292585
922,77,5.37310195227766,5.37662337662338,999,5.37337337337337
921,76,5.38653637350706,5.47368421052632,997,5.39317953861585
922,77,5.39154013015184,5.5974025974026,999,5.40740740740741
922,75,5.37744034707158,5.50666666666667,997,5.38716148445336
922,77,5.37418655097614,5.64935064935065,999,5.3953953953954
920,77,5.39673913043478,5.92207792207792,997,5.43731193580742
923,75,5.33152762730228,5.92,998,5.37575150300601
925,73,5.30162162162162,5.75342465753425,998,5.33466933867735
930,69,5.29354838709677,5.82608695652174,999,5.33033033033033
931,65,5.30397422126745,5.86153846153846,996,5.34036144578313
937,61,5.26787620064034,5.67213114754098,998,5.29258517034068
935,63,5.2951871657754,5.76190476190476,998,5.32464929859719
934,64,5.32226980728051,5.953125,998,5.3627254509018
939,60,5.32055378061768,6.18333333333333,999,5.37237237237237
942,56,5.34607218683652,6.125,998,5.38977955911824
941,58,5.35175345377258,6.12068965517241,999,5.3963963963964
941,57,5.27630180658874,6.05263157894737,998,5.32064128256513
943,56,5.28419936373277,6.16071428571429,999,5.33333333333333
937,62,5.27214514407684,5.91935483870968,999,5.31231231231231
936,63,5.28952991452991,5.87301587301587,999,5.32632632632633
934,65,5.32441113490364,5.70769230769231,999,5.34934934934935
931,68,5.33727175080559,5.60294117647059,999,5.35535535535536
930,69,5.27096774193548,5.50724637681159,999,5.28728728728729
927,71,5.28586839266451,5.54929577464789,998,5.30460921843687
931,67,5.25349087003222,5.61194029850746,998,5.27755511022044
934,64,5.28586723768737,5.515625,998,5.30060120240481
932,67,5.28648068669528,5.65671641791045,999,5.31131131131131
928,70,5.29094827586207,5.64285714285714,998,5.31563126252505
933,65,5.31404072883173,5.76923076923077,998,5.3436873747495
932,67,5.34656652360515,5.64179104477612,999,5.36636636636637
930,68,5.35913978494624,5.77941176470588,998,5.3877755511022
929,69,5.40365984930032,6.01449275362319,998,5.44589178356713
925,74,5.39027027027027,5.85135135135135,999,5.42442442442442
921,77,5.41693811074919,5.96103896103896,998,5.45891783567134
916,81,5.43340611353712,5.83950617283951,997,5.46639919759278
922,77,5.38503253796095,5.71428571428571,999,5.41041041041041
923,76,5.4192849404117,5.89473684210526,999,5.45545545545546
920,79,5.43152173913044,5.9873417721519,999,5.47547547547548
920,79,5.48695652173913,5.89873417721519,999,5.51951951951952
926,72,5.49784017278618,5.91666666666667,998,5.52805611222445
926,73,5.46436285097192,5.95890410958904,999,5.5005005005005
923,75,5.41711809317443,5.88,998,5.45190380761523
924,74,5.44264069264069,5.7027027027027,998,5.46192384769539
927,72,5.46494066882416,5.81944444444444,999,5.49049049049049
927,71,5.41639697950378,5.84507042253521,998,5.44689378757515
926,73,5.37041036717063,5.84931506849315,999,5.40540540540541
927,71,5.40021574973031,5.98591549295775,998,5.44188376753507
926,71,5.44276457883369,5.77464788732394,997,5.46639919759278
923,76,5.44853737811484,5.75,999,5.47147147147147
916,81,5.43668122270742,5.83950617283951,997,5.46940822467402
916,81,5.41921397379913,5.77777777777778,997,5.44834503510532
915,83,5.4896174863388,5.72289156626506,998,5.50901803607214
918,80,5.46514161220044,5.7,998,5.48396793587174
915,84,5.43715846994535,5.83333333333333,999,5.47047047047047
915,83,5.37049180327869,5.65060240963855,998,5.3937875751503
914,85,5.40262582056893,5.49411764705882,999,5.41041041041041
905,93,5.45414364640884,5.38709677419355,998,5.44789579158317
904,94,5.46017699115044,5.3936170212766,998,5.45390781563126
903,96,5.43300110741971,5.48958333333333,999,5.43843843843844
908,90,5.5011013215859,5.47777777777778,998,5.49899799599198
909,87,5.53465346534653,5.59770114942529,996,5.54016064257028
913,85,5.53231106243154,5.50588235294118,998,5.53006012024048
911,85,5.51481888035126,5.51764705882353,996,5.51506024096386
906,92,5.50331125827815,5.31521739130435,998,5.48597194388778
907,92,5.40463065049614,5.30434782608696,999,5.3953953953954
904,94,5.34955752212389,5.46808510638298,998,5.36072144288577
906,93,5.30242825607064,5.50537634408602,999,5.32132132132132
903,95,5.39867109634551,5.45263157894737,998,5.40380761523046
911,88,5.34906695938529,5.30681818181818,999,5.34534534534535
901,98,5.36736958934517,5.36734693877551,999,5.36736736736737
902,97,5.38248337028825,5.45360824742268,999,5.38938938938939
903,96,5.3344407530454,5.4375,999,5.34434434434434
901,98,5.31631520532741,5.51020408163265,999,5.33533533533534
906,93,5.31898454746137,5.46236559139785,999,5.33233233233233
904,94,5.30973451327434,5.51063829787234,998,5.32865731462926
903,95,5.31893687707641,5.6,998,5.34569138276553
904,94,5.35840707964602,5.77659574468085,998,5.39779559118236
904,94,5.40929203539823,5.75531914893617,998,5.44188376753507
899,99,5.40266963292547,5.86868686868687,998,5.44889779559118
897,98,5.33221850613155,5.74489795918367,995,5.37286432160804
895,101,5.32625698324022,5.96039603960396,996,5.39056224899598
903,96,5.32115171650055,6.01041666666667,999,5.38738738738739
899,99,5.31145717463849,6.0,998,5.37975951903808
901,95,5.34850166481687,6.02105263157895,996,5.41265060240964
902,97,5.29157427937916,6.06185567010309,999,5.36636636636637
904,94,5.28097345132743,6.0,998,5.34869739478958
908,90,5.26541850220264,5.9,998,5.32264529058116
904,94,5.2853982300885,6.01063829787234,998,5.35370741482966
902,96,5.31374722838137,6.07291666666667,998,5.38677354709419
901,98,5.32963374028857,5.95918367346939,999,5.39139139139139
896,103,5.265625,6.03883495145631,999,5.34534534534535
897,101,5.31215161649944,6.06930693069307,998,5.38877755511022
898,99,5.3162583518931,5.96969696969697,997,5.38114343029087
898,100,5.33073496659243,6.06,998,5.40380761523046
901,98,5.32519422863485,6.18367346938776,999,5.40940940940941
905,94,5.33038674033149,6.11702127659574,999,5.4044044044044
903,95,5.33111849390919,6.12631578947368,998,5.40681362725451
903,96,5.35326688815061,6.10416666666667,999,5.42542542542543
895,103,5.38882681564246,5.93203883495146,998,5.44488977955912
895,103,5.38100558659218,5.92233009708738,998,5.43687374749499
894,103,5.40268456375839,5.92233009708738,997,5.45636910732197
888,109,5.47747747747748,5.84403669724771,997,5.51755265797392
891,108,5.46127946127946,5.85185185185185,999,5.5035035035035
891,106,5.46576879910213,5.84905660377358,997,5.50651955867603
889,109,5.46344206974128,5.78899082568807,998,5.49899799599198
901,98,5.44062153163152,5.77551020408163,999,5.47347347347347
898,101,5.41314031180401,5.84158415841584,999,5.45645645645646
894,105,5.35123042505593,5.91428571428571,999,5.41041041041041
898,100,5.38084632516704,6.05,998,5.44789579158317
892,105,5.40582959641256,5.99047619047619,997,5.46740220661986
898,100,5.39977728285078,5.99,998,5.45891783567134
895,102,5.44916201117318,5.98039215686275,997,5.50351053159478
889,110,5.44094488188976,5.86363636363636,999,5.48748748748749
888,111,5.41103603603604,5.92792792792793,999,5.46846846846847
889,109,5.39482564679415,5.96330275229358,998,5.45691382765531
891,108,5.4320987654321,5.98148148148148,999,5.49149149149149
893,106,5.44792833146697,6.04716981132075,999,5.51151151151151
900,99,5.38666666666667,5.84848484848485,999,5.43243243243243
901,97,5.37402885682575,5.94845360824742,998,5.42985971943888
901,96,5.35849056603774,6.03125,997,5.42326980942828
902,97,5.37139689578714,5.98969072164948,999,5.43143143143143
901,97,5.34406215316315,6.02061855670103,998,5.40981963927856
904,95,5.28429203539823,6.06315789473684,999,5.35835835835836
906,93,5.34326710816777,5.95698924731183,999,5.4004004004004
899,100,5.35372636262514,5.79,999,5.3973973973974
898,100,5.35523385300668,5.75,998,5.39478957915832
898,100,5.3173719376392,5.62,998,5.34769539078156
901,97,5.30521642619312,5.47422680412371,998,5.32164328657315
902,97,5.31263858093126,5.71134020618557,999,5.35135135135135
896,98,5.31696428571429,5.66326530612245,994,5.35110663983903
905,93,5.3524861878453,5.75268817204301,998,5.38977955911824
898,99,5.37639198218263,5.71717171717172,997,5.41023069207623
897,101,5.36343366778149,5.79207920792079,998,5.40681362725451
898,100,5.39532293986637,5.93,998,5.44889779559118
891,106,5.33557800224467,5.85849056603774,997,5.39117352056168
896,102,5.31919642857143,5.82352941176471,998,5.37074148296593
893,106,5.32362821948488,5.80188679245283,999,5.37437437437437
890,109,5.29887640449438,5.90825688073395,999,5.36536536536537
889,109,5.27671541057368,5.85321100917431,998,5.33967935871743
891,108,5.25589225589226,5.88888888888889,999,5.32432432432432
884,112,5.32239819004525,5.92857142857143,996,5.39056224899598
884,114,5.29864253393665,5.97368421052632,998,5.37575150300601
881,117,5.25198637911464,5.82051282051282,998,5.3186372745491
880,118,5.30113636363636,5.73728813559322,998,5.35270541082164
880,118,5.28068181818182,5.63559322033898,998,5.32264529058116
874,125,5.31006864988558,5.496,999,5.33333333333333
873,123,5.34249713631157,5.56910569105691,996,5.37048192771084
876,123,5.30593607305936,5.49593495934959,999,5.32932932932933
875,124,5.31657142857143,5.4758064516129,999,5.33633633633634
875,124,5.31428571428571,5.45161290322581,999,5.33133133133133
874,124,5.3512585812357,5.38709677419355,998,5.35571142284569
874,123,5.2974828375286,5.44715447154472,997,5.31594784353059
871,126,5.23995407577497,5.33333333333333,997,5.25175526579739
875,124,5.29028571428571,5.2741935483871,999,5.28828828828829
865,132,5.27976878612717,5.35606060606061,997,5.28986960882648
870,129,5.31149425287356,5.27131782945736,999,5.30630630630631
864,134,5.31944444444444,5.47014925373134,998,5.33967935871743
863,134,5.33371958285052,5.46268656716418,997,5.35105315947844
864,134,5.3287037037037,5.6044776119403,998,5.36573146292585
863,136,5.28968713789108,5.56617647058824,999,5.32732732732733
860,139,5.3093023255814,5.58992805755396,999,5.34834834834835
857,142,5.26721120186698,5.61267605633803,999,5.31631631631632
858,141,5.3018648018648,5.4468085106383,999,5.32232232232232
857,142,5.31505250875146,5.41549295774648,999,5.32932932932933
858,141,5.33682983682984,5.41843971631206,999,5.34834834834835
855,144,5.32280701754386,5.31944444444444,999,5.32232232232232
854,145,5.25175644028103,5.32413793103448,999,5.26226226226226
852,147,5.24647887323944,5.30612244897959,999,5.25525525525526
856,143,5.24182242990654,5.35664335664336,999,5.25825825825826
856,142,5.26869158878505,5.36619718309859,998,5.28256513026052
863,135,5.30822711471611,5.25925925925926,998,5.30160320641283
867,132,5.2479815455594,5.37121212121212,999,5.26426426426426
864,135,5.28009259259259,5.48148148148148,999,5.30730730730731
872,126,5.2993119266055,5.55555555555556,998,5.33166332665331
873,126,5.26345933562428,5.45238095238095,999,5.28728728728729
866,133,5.31870669745958,5.43609022556391,999,5.33433433433433
864,134,5.32986111111111,5.43283582089552,998,5.3436873747495
869,129,5.32796317606444,5.48062015503876,998,5.34769539078156
871,126,5.36509758897819,5.38888888888889,997,5.36810431293882
868,131,5.35138248847926,5.37404580152672,999,5.35435435435435
868,131,5.42396313364055,5.29007633587786,999,5.40640640640641
861,136,5.45063879210221,5.44117647058824,997,5.4493480441324
865,134,5.50057803468208,5.41044776119403,999,5.48848848848849
867,132,5.51787773933103,5.51515151515152,999,5.51751751751752
866,133,5.44803695150115,5.54135338345865,999,5.46046046046046
863,135,5.43105446118192,5.48888888888889,998,5.43887775551102
865,131,5.48554913294798,5.48091603053435,996,5.48493975903614
869,129,5.50402761795167,5.51937984496124,998,5.5060120240481
866,133,5.50461893764434,5.37593984962406,999,5.48748748748749
862,135,5.46751740139211,5.32592592592593,997,5.44834503510532
866,133,5.49076212471132,5.32330827067669,999,5.46846846846847
860,138,5.47906976744186,5.41304347826087,998,5.46993987975952
864,135,5.43171296296296,5.41481481481481,999,5.42942942942943
865,133,5.5028901734104,5.45112781954887,998,5.49599198396794
864,135,5.51736111111111,5.41481481481481,999,5.5035035035035
866,133,5.56581986143187,5.35338345864662,999,5.53753753753754
866,132,5.57505773672055,5.34090909090909,998,5.54408817635271
868,130,5.56912442396313,5.5,998,5.56012024048096
870,129,5.51149425287356,5.4031007751938,999,5.4974974974975
871,128,5.52009184845006,5.5390625,999,5.52252252252252
867,132,5.47058823529412,5.62121212121212,999,5.49049049049049
863,133,5.50753186558517,5.6015037593985,996,5.52008032128514
869,129,5.48791714614499,5.75193798449612,998,5.52204408817635
874,123,5.50228832951945,5.69105691056911,997,5.52557673019057
870,129,5.51034482758621,5.65891472868217,999,5.52952952952953
873,124,5.55441008018328,5.64516129032258,997,5.56569709127382
868,130,5.53456221198157,5.74615384615385,998,5.56212424849699
864,131,5.54050925925926,5.86259541984733,995,5.58291457286432
874,124,5.57894736842105,5.83870967741935,998,5.61122244488978
878,120,5.59681093394077,5.825,998,5.62424849699399
876,123,5.59018264840183,6.05691056910569,999,5.64764764764765
871,128,5.53960964408726,5.828125,999,5.57657657657658
877,121,5.57240592930445,5.85123966942149,998,5.6062124248497
876,121,5.56963470319635,5.66115702479339,997,5.58074222668004
879,119,5.53242320819113,5.74789915966387,998,5.55811623246493
888,111,5.53603603603604,5.72072072072072,999,5.55655655655656
885,114,5.47457627118644,5.78947368421053,999,5.51051051051051
887,111,5.5163472378805,5.81081081081081,998,5.54909819639279
884,115,5.50565610859729,5.83478260869565,999,5.54354354354354
879,120,5.50967007963595,5.88333333333333,999,5.55455455455455
879,118,5.48805460750853,5.94067796610169,997,5.54162487462387
887,112,5.49379932356257,5.94642857142857,999,5.54454454454454
885,113,5.51299435028249,6.07079646017699,998,5.57615230460922
887,112,5.52198421645998,6.08035714285714,999,5.58458458458458
885,113,5.56723163841808,6.15044247787611,998,5.63326653306613
893,106,5.60806270996641,6.02830188679245,999,5.65265265265265
895,103,5.57430167597765,6.10679611650485,998,5.62925851703407
898,100,5.49331848552339,6.05,998,5.54909819639279
897,101,5.51059085841695,6.02970297029703,998,5.56312625250501
896,102,5.47433035714286,5.96078431372549,998,5.52404809619238
897,102,5.44258639910814,5.96078431372549,999,5.4954954954955
904,94,5.40818584070797,6.07446808510638,998,5.47094188376754
901,95,5.44173140954495,5.87368421052632,996,5.48293172690763
906,93,5.4083885209713,5.88172043010753,999,5.45245245245245
900,99,5.40222222222222,5.80808080808081,999,5.44244244244244
904,95,5.42588495575221,5.71578947368421,999,5.45345345345345
906,93,5.48565121412804,5.68817204301075,999,5.5045045045045
905,94,5.46629834254144,5.82978723404255,999,5.5005005005005
902,95,5.53658536585366,5.73684210526316,997,5.55566700100301
900,98,5.51444444444444,5.6734693877551,998,5.53006012024048
896,103,5.5390625,5.71844660194175,999,5.55755755755756
898,101,5.59688195991091,5.83168316831683,999,5.62062062062062
908,91,5.55726872246696,5.63736263736264,999,5.56456456456456
907,92,5.55347298787211,5.81521739130435,999,5.57757757757758
912,86,5.57236842105263,5.90697674418605,998,5.60120240480962
914,85,5.5218818380744,5.83529411764706,999,5.54854854854855
914,84,5.48687089715536,5.77380952380952,998,5.51102204408818
907,90,5.55347298787211,5.73333333333333,997,5.56970912738215
918,81,5.55555555555556,5.7037037037037,999,5.56756756756757
918,81,5.53812636165577,5.60493827160494,999,5.54354354354354
915,84,5.56393442622951,5.76190476190476,999,5.58058058058058
914,84,5.55908096280088,5.58333333333333,998,5.56112224448898
914,85,5.57658643326039,5.63529411764706,999,5.58158158158158
920,79,5.53695652173913,5.56962025316456,999,5.53953953953954
920,79,5.57391304347826,5.58227848101266,999,5.57457457457457
922,74,5.56507592190889,5.60810810810811,996,5.56827309236948
922,75,5.54338394793926,5.69333333333333,997,5.55466399197593
920,77,5.57065217391304,5.68831168831169,997,5.57973921765296
920,79,5.6,5.75949367088608,999,5.61261261261261
921,78,5.60694896851249,5.80769230769231,999,5.62262262262262
919,80,5.65614798694233,5.9375,999,5.67867867867868
921,78,5.60586319218241,5.93589743589744,999,5.63163163163163
928,71,5.63254310344828,5.76056338028169,999,5.64164164164164
928,70,5.64439655172414,5.84285714285714,998,5.65831663326653
928,70,5.61853448275862,5.78571428571429,998,5.63026052104208
931,68,5.59398496240602,5.69117647058824,999,5.6006006006006
929,68,5.51130247578041,5.5,997,5.51053159478435
929,68,5.52852529601722,5.70588235294118,997,5.54062186559679
937,62,5.49946638207044,5.61290322580645,999,5.50650650650651
934,65,5.52569593147752,5.70769230769231,999,5.53753753753754
934,64,5.53854389721627,5.59375,998,5.54208416833667
934,65,5.52141327623126,5.70769230769231,999,5.53353353353353
930,68,5.50645161290323,5.52941176470588,998,5.50801603206413
933,64,5.52518756698821,5.734375,997,5.53861584754263
936,62,5.49679487179487,5.83870967741935,998,5.51803607214429
935,64,5.49839572192513,5.796875,999,5.51751751751752
935,64,5.46737967914439,5.859375,999,5.49249249249249
937,62,5.49626467449306,5.88709677419355,999,5.52052052052052
935,64,5.49197860962567,5.984375,999,5.52352352352352
929,69,5.4983853606028,5.94202898550725,998,5.52905811623246
930,69,5.47311827956989,5.8695652173913,999,5.5005005005005
932,66,5.3980686695279,5.81818181818182,998,5.42585170340681
931,67,5.41783029001074,5.80597014925373,998,5.4438877755511
931,66,5.41353383458647,5.93939393939394,997,5.44834503510532
933,66,5.42872454448017,6.16666666666667,999,5.47747747747748
930,69,5.50430107526882,5.97101449275362,999,5.53653653653654
930,69,5.51935483870968,6.0,999,5.55255255255255
925,74,5.54918918918919,5.94594594594595,999,5.57857857857858
925,72,5.58378378378378,5.875,997,5.60481444332999
926,69,5.55399568034557,5.84057971014493,995,5.57386934673367
932,66,5.50429184549356,5.96969696969697,998,5.53507014028056
930,69,5.51827956989247,6.04347826086957,999,5.55455455455455
932,66,5.50643776824034,5.93939393939394,998,5.53507014028056
929,70,5.53498385360603,5.95714285714286,999,5.56456456456456
929,70,5.55113024757804,6.24285714285714,999,5.5995995995996
931,67,5.5187969924812,6.26865671641791,998,5.56913827655311
933,66,5.52197213290461,6.28787878787879,999,5.57257257257257
934,65,5.57815845824411,6.07692307692308,999,5.61061061061061
933,64,5.59914255091104,6.265625,997,5.641925777332
929,69,5.6221743810549,6.26086956521739,998,5.66633266533066
929,70,5.59311087190527,6.11428571428571,999,5.62962962962963
929,69,5.54790096878364,6.17391304347826,998,5.59118236472946
930,69,5.53118279569892,6.04347826086957,999,5.56656656656657
930,69,5.52795698924731,6.08695652173913,999,5.56656656656657
927,72,5.51240560949299,6.125,999,5.55655655655656
931,68,5.53813104189044,6.14705882352941,999,5.57957957957958
926,72,5.53347732181425,6.09722222222222,998,5.57414829659319
924,74,5.55844155844156,6.24324324324324,998,5.60921843687375
921,78,5.57654723127036,6.16666666666667,999,5.62262262262262
924,75,5.51190476190476,6.18666666666667,999,5.56256256256256
926,73,5.58423326133909,6.0958904109589,999,5.62162162162162
924,74,5.61471861471861,6.12162162162162,998,5.65230460921844
920,76,5.60434782608696,6.09210526315789,996,5.64156626506024
922,76,5.62581344902386,6.15789473684211,998,5.66633266533066
921,78,5.60043431053203,6.20512820512821,999,5.64764764764765
920,79,5.55,6.39240506329114,999,5.61661661661662
913,86,5.57831325301205,6.40697674418605,999,5.64964964964965
912,86,5.5109649122807,6.24418604651163,998,5.57414829659319
910,85,5.52087912087912,6.48235294117647,995,5.60301507537688
913,84,5.51478641840088,6.47619047619048,997,5.59578736208626
916,83,5.48580786026201,6.25301204819277,999,5.54954954954955
917,80,5.51145038167939,6.2625,997,5.57171514543631
917,82,5.53762268266085,6.26829268292683,999,5.5975975975976
919,80,5.49401523394995,6.375,999,5.56456456456456
916,81,5.49126637554585,6.55555555555556,997,5.5777331995988
917,82,5.45038167938931,6.57317073170732,999,5.54254254254254
917,81,5.4721919302072,6.45679012345679,998,5.55210420841683
923,75,5.45178764897075,6.53333333333333,998,5.53306613226453
922,77,5.47722342733189,6.46753246753247,999,5.55355355355355
922,77,5.50759219088937,6.35064935064935,999,5.57257257257257
917,80,5.53980370774264,6.2875,997,5.59979939819458
918,79,5.54139433551198,6.34177215189873,997,5.60481444332999
918,80,5.52287581699346,6.3875,998,5.59218436873747
921,78,5.54614549402823,6.44871794871795,999,5.61661661661662
918,81,5.61546840958606,6.51851851851852,999,5.68868868868869
914,84,5.66739606126915,6.48809523809524,998,5.73647294589178
905,91,5.62541436464088,6.35164835164835,996,5.69176706827309
902,96,5.64855875831486,6.26041666666667,998,5.70741482965932
900,97,5.61666666666667,6.31958762886598,997,5.68505516549649
907,92,5.58875413450937,6.30434782608696,999,5.65465465465465
903,96,5.56921373200443,6.38541666666667,999,5.64764764764765
897,102,5.56410256410256,6.22549019607843,999,5.63163163163163
903,96,5.56367663344408,6.23958333333333,999,5.62862862862863
896,101,5.55357142857143,6.23762376237624,997,5.62286860581745
900,99,5.57666666666667,6.22222222222222,999,5.64064064064064
900,98,5.57111111111111,6.22448979591837,998,5.63527054108216
907,91,5.55788313120176,6.36263736263736,998,5.6312625250501
903,94,5.53931339977852,6.37234042553191,997,5.61785356068205
901,98,5.53163152053274,6.3265306122449,999,5.60960960960961
903,96,5.57475083056478,6.30208333333333,999,5.64464464464464
910,89,5.59230769230769,6.32584269662921,999,5.65765765765766
913,86,5.54764512595838,6.09302325581395,999,5.59459459459459
910,87,5.53076923076923,6.20689655172414,997,5.58976930792377
917,81,5.55398037077426,6.28395061728395,998,5.61322645290581
913,84,5.53888280394304,6.17857142857143,997,5.59277833500501
912,86,5.52631578947368,6.25581395348837,998,5.58917835671343
908,90,5.45484581497797,6.38888888888889,998,5.53907815631263
909,90,5.52035203520352,6.45555555555556,999,5.6046046046046
904,95,5.57300884955752,6.4,999,5.65165165165165
904,95,5.54977876106195,6.44210526315789,999,5.63463463463463
906,92,5.46467991169978,6.30434782608696,998,5.54208416833667
908,90,5.46145374449339,6.27777777777778,998,5.53507014028056
908,90,5.55176211453744,6.3,998,5.61923847695391
913,86,5.5618838992333,6.24418604651163,999,5.62062062062062
911,87,5.56201975850713,6.1264367816092,998,5.61122244488978
906,93,5.57064017660044,6.11827956989247,999,5.62162162162162
903,95,5.58250276854928,6.08421052631579,998,5.63026052104208
899,99,5.60956618464961,5.97979797979798,998,5.64629258517034
898,100,5.56458797327394,5.87,998,5.59519038076152
897,102,5.48940914158305,5.76470588235294,999,5.51751751751752
895,102,5.48379888268156,5.7843137254902,997,5.51454363089268
898,101,5.44988864142539,5.66336633663366,999,5.47147147147147
899,100,5.47830923248053,5.64,999,5.49449449449449
