forward_num,reverse_num,forward_rate,reverse_rate,organism_num,organism_rate
50,50,5.5,5.5,100,5.5
67,60,5.77611940298507,5.88333333333333,127,5.82677165354331
77,73,5.83116883116883,5.9041095890411,150,5.86666666666667
98,86,5.63265306122449,5.77906976744186,184,5.70108695652174
124,101,5.68548387096774,5.74257425742574,225,5.71111111111111
141,126,5.68794326241135,5.91269841269841,267,5.7940074906367
168,152,5.70833333333333,5.76315789473684,320,5.734375
213,177,5.73708920187793,5.74011299435028,390,5.73846153846154
262,216,5.6793893129771,5.77777777777778,478,5.72384937238494
308,261,5.69480519480519,5.85057471264368,569,5.76625659050967
380,307,5.69473684210526,5.81758957654723,687,5.74963609898108
461,371,5.75921908893709,5.84366576819407,832,5.796875
555,442,5.74774774774775,5.86651583710407,997,5.80040120361083
552,447,5.72101449275362,5.84340044742729,999,5.77577577577578
557,441,5.7737881508079,5.87981859410431,998,5.82064128256513
562,437,5.73487544483986,5.91533180778032,999,5.81381381381381
562,436,5.74555160142349,5.86009174311927,998,5.79559118236473
563,436,5.72291296625222,5.7545871559633,999,5.73673673673674
564,434,5.74290780141844,5.7258064516129,998,5.73547094188377
572,427,5.73951048951049,5.72131147540984,999,5.73173173173173
579,419,5.67875647668394,5.67064439140811,998,5.67535070140281
578,419,5.66608996539792,5.58711217183771,997,5.63289869608827
574,425,5.61498257839721,5.50117647058824,999,5.56656656656657
577,422,5.64124783362218,5.46208530805687,999,5.56556556556557
585,414,5.64444444444444,5.45893719806763,999,5.56756756756757
580,419,5.60344827586207,5.46062052505967,999,5.54354354354354
585,414,5.59316239316239,5.44927536231884,999,5.53353353353353
587,411,5.60477001703577,5.47688564476886,998,5.55210420841683
583,416,5.63121783876501,5.44951923076923,999,5.55555555555556
582,417,5.66838487972509,5.54196642685851,999,5.61561561561562
583,416,5.64150943396226,5.58173076923077,999,5.61661661661662
583,414,5.60034305317324,5.52657004830918,997,5.56970912738215
584,415,5.6027397260274,5.54939759036145,999,5.58058058058058
585,414,5.64444444444444,5.54830917874396,999,5.6046046046046
585,414,5.58803418803419,5.48550724637681,999,5.54554554554555
590,409,5.56271186440678,5.50366748166259,999,5.53853853853854
599,399,5.60601001669449,5.5187969924812,998,5.57114228456914
584,414,5.63869863013699,5.55072463768116,998,5.60220440881764
583,415,5.58319039451115,5.60722891566265,998,5.59318637274549
588,410,5.62244897959184,5.6,998,5.61322645290581
593,406,5.56829679595278,5.58374384236453,999,5.57457457457457
595,403,5.63865546218487,5.59057071960298,998,5.61923847695391
588,411,5.63605442176871,5.60583941605839,999,5.62362362362362
597,402,5.53433835845896,5.51990049751244,999,5.52852852852853
595,404,5.56302521008403,5.50247524752475,999,5.53853853853854
605,394,5.52066115702479,5.5989847715736,999,5.55155155155155
589,410,5.55178268251273,5.63414634146341,999,5.58558558558559
587,412,5.4923339011925,5.61893203883495,999,5.54454454454454
594,405,5.45286195286195,5.65925925925926,999,5.53653653653654
601,397,5.45424292845258,5.73551637279597,998,5.56613226452906
598,401,5.45317725752508,5.70324189526185,999,5.55355355355355
597,402,5.54606365159129,5.75870646766169,999,5.63163163163163
595,403,5.56974789915966,5.75682382133995,998,5.64529058116232
599,399,5.55926544240401,5.76942355889724,998,5.64328657314629
597,402,5.54103852596315,5.71641791044776,999,5.61161161161161
597,401,5.52093802345059,5.62344139650873,998,5.56212424849699
607,392,5.52883031301483,5.60714285714286,999,5.55955955955956
612,386,5.44607843137255,5.60103626943005,998,5.5060120240481
615,383,5.45853658536585,5.6266318537859,998,5.52304609218437
611,388,5.40589198036007,5.67783505154639,999,5.51151151151151
605,393,5.45289256198347,5.66666666666667,998,5.53707414829659
615,384,5.43739837398374,5.63541666666667,999,5.51351351351351
616,383,5.43506493506494,5.56396866840731,999,5.48448448448448
621,378,5.43478260869565,5.59523809523809,999,5.4954954954955
625,374,5.3376,5.62299465240642,999,5.44444444444444
612,387,5.2843137254902,5.64341085271318,999,5.42342342342342
616,383,5.29545454545455,5.61096605744125,999,5.41641641641642
617,379,5.3160453808752,5.61741424802111,996,5.43072289156626
624,375,5.28846153846154,5.65866666666667,999,5.42742742742743
613,385,5.30668841761827,5.65974025974026,998,5.44288577154309
618,379,5.32847896440129,5.62269129287599,997,5.44032096288867
616,382,5.37012987012987,5.66753926701571,998,5.48396793587174
624,375,5.3525641025641,5.776,999,5.51151151151151
627,372,5.35566188197767,5.72043010752688,999,5.49149149149149
623,373,5.3900481540931,5.7372654155496,996,5.52008032128514
625,374,5.3424,5.66577540106952,999,5.46346346346346
616,382,5.31331168831169,5.58638743455497,998,5.41783567134269
623,376,5.29213483146067,5.60372340425532,999,5.40940940940941
620,379,5.29032258064516,5.54353562005277,999,5.38638638638639
610,388,5.25081967213115,5.52577319587629,998,5.35771543086172
606,392,5.18316831683168,5.48469387755102,998,5.30160320641283
613,386,5.20554649265905,5.48445595854922,999,5.31331331331331
614,384,5.21661237785016,5.56770833333333,998,5.35170340681363
604,394,5.15894039735099,5.54568527918782,998,5.31162324649299
601,398,5.14642262895175,5.50753768844221,999,5.29029029029029
599,398,5.09515859766277,5.52010050251256,997,5.26479438314945
598,400,5.08528428093646,5.4725,998,5.24048096192385
595,401,5.09915966386555,5.51122194513716,996,5.26506024096386
607,392,5.10378912685338,5.5280612244898,999,5.27027027027027
607,392,5.1334431630972,5.53826530612245,999,5.29229229229229
602,396,5.13621262458472,5.52272727272727,998,5.28957915831663
608,391,5.19243421052632,5.55242966751918,999,5.33333333333333
614,384,5.24104234527687,5.48697916666667,998,5.33567134268537
622,377,5.22668810289389,5.45623342175066,999,5.31331331331331
620,379,5.21612903225806,5.39577836411609,999,5.28428428428428
614,385,5.28338762214984,5.43896103896104,999,5.34334334334334
621,378,5.34621578099839,5.34391534391534,999,5.34534534534535
611,387,5.30932896890344,5.34108527131783,998,5.32164328657315
609,390,5.3743842364532,5.41025641025641,999,5.38838838838839
607,392,5.3673805601318,5.24489795918367,999,5.31931931931932
606,391,5.44884488448845,5.35294117647059,997,5.41123370110331
616,382,5.42045454545455,5.35602094240838,998,5.39579158316633
613,385,5.42251223491028,5.39480519480519,998,5.41182364729459
615,384,5.45365853658537,5.36979166666667,999,5.42142142142142
615,384,5.38536585365854,5.34375,999,5.36936936936937
625,374,5.376,5.31016042780749,999,5.35135135135135
623,374,5.330658105939,5.28877005347594,997,5.31494483450351
623,375,5.30016051364366,5.30933333333333,998,5.30360721442886
631,368,5.32012678288431,5.42391304347826,999,5.35835835835836
632,367,5.30379746835443,5.42234332425068,999,5.34734734734735
618,381,5.26699029126214,5.38320209973753,999,5.31131131131131
611,387,5.27823240589198,5.45219638242894,998,5.34569138276553
622,377,5.27331189710611,5.44031830238727,999,5.33633633633634
619,379,5.32471728594507,5.54353562005277,998,5.40781563126253
617,380,5.3128038897893,5.57631578947368,997,5.41323971915747
621,378,5.31078904991948,5.51587301587302,999,5.38838838838839
618,381,5.28478964401295,5.60629921259843,999,5.40740740740741
620,379,5.28870967741936,5.54881266490765,999,5.38738738738739
606,392,5.28382838283828,5.56122448979592,998,5.39278557114228
616,383,5.26298701298701,5.54830287206266,999,5.37237237237237
620,379,5.31290322580645,5.56992084432718,999,5.41041041041041
620,378,5.2758064516129,5.55820105820106,998,5.38276553106212
611,387,5.30932896890344,5.63049095607235,998,5.43386773547094
620,379,5.31290322580645,5.60686015831135,999,5.42442442442442
616,381,5.3961038961039,5.61942257217848,997,5.481444332999
619,380,5.36510500807754,5.54736842105263,999,5.43443443443443
615,382,5.4260162601626,5.46858638743455,997,5.44232698094283
602,397,5.41196013289037,5.46851385390428,999,5.43443443443443
612,387,5.41830065359477,5.43152454780362,999,5.42342342342342
601,396,5.49251247920133,5.48737373737374,997,5.49047141424273
600,399,5.48666666666667,5.43609022556391,999,5.46646646646647
607,391,5.48434925864909,5.44501278772379,998,5.4689378757515
593,406,5.51939291736931,5.43103448275862,999,5.48348348348348
597,402,5.47571189279732,5.41542288557214,999,5.45145145145145
591,407,5.41455160744501,5.49140049140049,998,5.44589178356713
597,402,5.3785594639866,5.48507462686567,999,5.42142142142142
605,393,5.35702479338843,5.50636132315522,998,5.41583166332665
607,392,5.38714991762768,5.59438775510204,999,5.46846846846847
604,395,5.40728476821192,5.56708860759494,999,5.47047047047047
599,398,5.45242070116861,5.58542713567839,997,5.50551654964895
601,397,5.47088186356073,5.5264483627204,998,5.49298597194389
608,391,5.48684210526316,5.48849104859335,999,5.48748748748749
605,392,5.4495867768595,5.43112244897959,997,5.44232698094283
604,394,5.48013245033113,5.39340101522843,998,5.44589178356713
607,392,5.51565074135091,5.36734693877551,999,5.45745745745746
621,378,5.51851851851852,5.37037037037037,999,5.46246246246246
610,388,5.53934426229508,5.29381443298969,998,5.4438877755511
605,393,5.6099173553719,5.33587786259542,998,5.50200400801603
603,396,5.51741293532338,5.28282828282828,999,5.42442442442442
598,399,5.57023411371237,5.32330827067669,997,5.47141424272818
606,393,5.55775577557756,5.38422391857506,999,5.48948948948949
615,383,5.59186991869919,5.37075718015666,998,5.50701402805611
622,377,5.54983922829582,5.37135278514589,999,5.48248248248248
621,376,5.61352657004831,5.35372340425532,997,5.51554663991976
619,380,5.61066235864297,5.29210526315789,999,5.48948948948949
630,369,5.62857142857143,5.32791327913279,999,5.51751751751752
635,364,5.58267716535433,5.35164835164835,999,5.4984984984985
634,365,5.60883280757098,5.33972602739726,999,5.51051051051051
623,375,5.62439807383628,5.29866666666667,998,5.50200400801603
627,371,5.57735247208931,5.2722371967655,998,5.46392785571142
628,370,5.53025477707006,5.2027027027027,998,5.40881763527054
625,373,5.5248,5.171581769437,998,5.39278557114228
625,374,5.44,5.24064171122995,999,5.36536536536537
627,371,5.46730462519936,5.16172506738544,998,5.35370741482966
625,372,5.4944,5.1505376344086,997,5.36609829488465
625,372,5.5088,5.15591397849462,997,5.37713139418255
635,363,5.55433070866142,5.12947658402204,998,5.3997995991984
635,364,5.53858267716535,5.2967032967033,999,5.45045045045045
625,373,5.4624,5.27882037533512,998,5.3937875751503
627,370,5.5311004784689,5.27027027027027,997,5.43430290872618
645,353,5.46976744186046,5.23229461756374,998,5.38577154308617
639,360,5.46009389671362,5.25277777777778,999,5.38538538538539
650,349,5.41846153846154,5.25787965616046,999,5.36236236236236
646,351,5.41331269349845,5.1965811965812,997,5.3370110330993
651,347,5.43625192012289,5.19020172910663,998,5.35070140280561
647,351,5.42040185471406,5.15099715099715,998,5.32565130260521
654,344,5.44954128440367,5.15406976744186,998,5.34769539078156
667,332,5.45727136431784,5.15963855421687,999,5.35835835835836
681,318,5.3920704845815,5.13836477987421,999,5.31131131131131
684,315,5.43713450292398,5.12063492063492,999,5.33733733733734
689,310,5.43831640058055,5.18064516129032,999,5.35835835835836
689,308,5.46153846153846,5.16558441558442,997,5.37011033099298
698,300,5.44269340974212,5.14333333333333,998,5.35270541082164
706,292,5.48583569405099,5.11643835616438,998,5.37775551102204
702,297,5.52136752136752,5.1010101010101,999,5.3963963963964
703,296,5.51351351351351,5.125,999,5.3983983983984
707,292,5.53323903818953,5.13698630136986,999,5.41741741741742
702,296,5.54985754985755,5.13175675675676,998,5.42585170340681
698,300,5.64183381088825,5.11333333333333,998,5.48296593186373
701,298,5.63908701854494,5.08724832214765,999,5.47447447447447
709,290,5.57686882933709,5.11034482758621,999,5.44144144144144
715,284,5.64195804195804,5.15492957746479,999,5.5035035035035
724,275,5.62845303867403,5.07636363636364,999,5.47647647647648
726,273,5.60055096418733,5.01831501831502,999,5.44144144144144
728,271,5.5521978021978,4.96678966789668,999,5.39339339339339
730,268,5.54794520547945,4.97761194029851,998,5.39478957915832
740,259,5.51486486486487,4.98069498069498,999,5.37637637637638
727,269,5.54332874828061,5.0185873605948,996,5.40160642570281
723,276,5.52282157676349,4.94565217391304,999,5.36336336336336
723,276,5.53250345781466,4.89855072463768,999,5.35735735735736
721,277,5.5631067961165,5.09386281588448,998,5.43286573146293
723,274,5.55601659751037,5.01094890510949,997,5.4062186559679
722,277,5.54709141274238,5.14801444043321,999,5.43643643643644
730,268,5.51780821917808,5.09701492537313,998,5.40480961923848
725,274,5.53241379310345,5.13503649635036,999,5.42342342342342
733,265,5.57162346521146,5.09811320754717,998,5.44589178356713
727,270,5.52132049518569,5.18148148148148,997,5.42928786359077
725,272,5.55724137931035,5.15441176470588,997,5.44734202607823
728,271,5.53846153846154,5.14022140221402,999,5.43043043043043
724,273,5.5732044198895,5.12820512820513,997,5.45135406218656
724,274,5.58701657458564,5.11678832116788,998,5.45791583166333
729,270,5.58984910836763,5.18518518518519,999,5.48048048048048
735,263,5.58503401360544,5.21292775665399,998,5.48697394789579
730,267,5.60547945205479,5.23220973782772,997,5.50551654964895
735,264,5.6530612244898,5.23484848484848,999,5.54254254254254
734,265,5.64305177111717,5.2377358490566,999,5.53553553553554
735,264,5.61496598639456,5.25757575757576,999,5.52052052052052
729,270,5.63923182441701,5.22962962962963,999,5.52852852852853
734,265,5.65395095367847,5.24528301886792,999,5.54554554554555
729,270,5.70644718792867,5.1962962962963,999,5.56856856856857
732,267,5.6707650273224,5.23595505617978,999,5.55455455455455
731,268,5.64569083447332,5.23507462686567,999,5.53553553553554
728,271,5.71703296703297,5.1070110701107,999,5.55155155155155
735,264,5.70884353741497,5.09848484848485,999,5.54754754754755
739,259,5.74424898511502,5.1003861003861,998,5.57715430861723
740,259,5.77702702702703,5.07335907335907,999,5.59459459459459
746,253,5.76407506702413,5.12252964426877,999,5.6016016016016
743,253,5.68102288021534,5.07905138339921,996,5.5281124497992
748,251,5.70454545454545,5.14741035856574,999,5.56456456456456
749,249,5.67690253671562,5.18473895582329,998,5.55410821643287
752,247,5.66755319148936,5.25910931174089,999,5.56656656656657
752,246,5.65824468085106,5.32520325203252,998,5.57615230460922
752,247,5.65558510638298,5.32388663967611,999,5.57357357357357
752,247,5.68351063829787,5.2834008097166,999,5.58458458458458
758,241,5.68865435356201,5.31535269709544,999,5.5985985985986
751,247,5.64980026631158,5.39271255060729,998,5.58617234468938
750,248,5.66533333333333,5.30645161290323,998,5.57615230460922
752,246,5.66489361702128,5.30487804878049,998,5.57615230460922
759,240,5.63109354413702,5.2625,999,5.54254254254254
760,238,5.63947368421053,5.34873949579832,998,5.57014028056112
772,227,5.64766839378238,5.23348017621145,999,5.55355355355355
774,224,5.67829457364341,5.21875,998,5.5751503006012
778,221,5.72622107969152,5.05882352941176,999,5.57857857857858
780,219,5.69615384615385,5.11415525114155,999,5.56856856856857
776,223,5.68298969072165,5.14798206278027,999,5.56356356356356
776,221,5.74355670103093,5.04524886877828,997,5.58876629889669
785,214,5.71464968152866,5.07009345794393,999,5.57657657657658
788,210,5.67258883248731,5.18095238095238,998,5.56913827655311
792,206,5.67676767676768,5.29126213592233,998,5.59719438877756
801,197,5.74906367041199,5.31979695431472,998,5.66432865731463
799,200,5.78598247809762,5.3,999,5.68868868868869
796,203,5.74120603015075,5.36945812807882,999,5.66566566566567
806,193,5.68734491315136,5.39378238341969,999,5.63063063063063
808,191,5.67574257425743,5.30366492146597,999,5.6046046046046
808,191,5.71534653465347,5.21989528795812,999,5.62062062062062
807,190,5.7360594795539,5.21578947368421,997,5.63691073219659
807,192,5.69144981412639,5.09375,999,5.57657657657658
814,185,5.65970515970516,4.93513513513513,999,5.52552552552553
811,187,5.64364981504316,5.01069518716578,998,5.5250501002004
813,183,5.65436654366544,4.98907103825137,996,5.53212851405623
814,182,5.57371007371007,5.0,996,5.46887550200803
814,182,5.65847665847666,4.93956043956044,996,5.52710843373494
811,188,5.63501849568434,4.97340425531915,999,5.51051051051051
807,192,5.61338289962825,4.99479166666667,999,5.49449449449449
820,179,5.65853658536585,4.94972067039106,999,5.53153153153153
824,174,5.63592233009709,4.97701149425287,998,5.52104208416834
819,178,5.7045177045177,5.10112359550562,997,5.59679037111334
822,176,5.67518248175182,5.04545454545455,998,5.56412825651303
823,175,5.63304981773998,4.98857142857143,998,5.52004008016032
820,178,5.62926829268293,4.98876404494382,998,5.51503006012024
816,183,5.63725490196078,5.02732240437158,999,5.52552552552553
821,175,5.6857490864799,5.07428571428571,996,5.57831325301205
830,169,5.61807228915663,5.10650887573965,999,5.53153153153153
831,168,5.62575210589651,5.16666666666667,999,5.54854854854855
833,165,5.56542617046819,5.11515151515152,998,5.49098196392786
835,164,5.55568862275449,5.01219512195122,999,5.46646646646647
831,168,5.52105896510229,4.875,999,5.41241241241241
834,164,5.5,4.8109756097561,998,5.38677354709419
833,166,5.48379351740696,4.81325301204819,999,5.37237237237237
835,164,5.49461077844311,4.77439024390244,999,5.37637637637638
836,163,5.45454545454545,4.93865030674847,999,5.37037037037037
832,165,5.49278846153846,4.92727272727273,997,5.39919759277833
840,158,5.41309523809524,4.9746835443038,998,5.3436873747495
835,163,5.41916167664671,5.09815950920245,998,5.36673346693387
839,157,5.41954707985697,5.0828025477707,996,5.36646586345381
835,163,5.40958083832335,5.16564417177914,998,5.36973947895792
837,160,5.41218637992832,5.2125,997,5.38014042126379
844,155,5.41943127962085,5.12258064516129,999,5.37337337337337
848,146,5.50235849056604,4.99315068493151,994,5.42756539235412
838,160,5.48687350835322,5.0,998,5.40881763527054
842,157,5.51543942992874,4.91082802547771,999,5.42042042042042
846,153,5.53309692671395,4.88888888888889,999,5.43443443443443
851,147,5.52526439482961,4.89795918367347,998,5.43286573146293
852,146,5.47183098591549,4.97260273972603,998,5.39879759519038
856,143,5.48714953271028,5.10489510489511,999,5.43243243243243
856,141,5.48831775700935,5.1063829787234,997,5.43430290872618
859,139,5.44935972060536,5.05035971223022,998,5.3937875751503
852,147,5.44953051643192,5.01360544217687,999,5.38538538538539
850,147,5.45411764705882,4.93877551020408,997,5.37813440320963
851,145,5.43948296122209,4.91724137931034,996,5.36345381526104
851,147,5.41598119858989,5.00680272108844,998,5.35571142284569
847,150,5.42148760330578,5.14666666666667,997,5.38014042126379
845,153,5.43905325443787,5.18300653594771,998,5.3997995991984
848,151,5.42570754716981,5.17218543046358,999,5.38738738738739
834,163,5.41846522781775,5.1840490797546,997,5.38014042126379
843,156,5.38078291814947,5.1474358974359,999,5.34434434434434
841,157,5.36741973840666,5.09554140127389,998,5.32464929859719
833,165,5.36014405762305,5.03030303030303,998,5.30561122244489
836,161,5.31818181818182,5.05590062111801,997,5.27582748244734
834,165,5.29616306954436,4.96969696969697,999,5.24224224224224
836,161,5.26315789473684,5.01863354037267,997,5.22367101303912
835,163,5.30419161676647,4.97546012269939,998,5.25050100200401
839,158,5.29320619785459,4.96835443037975,997,5.24172517552658
844,153,5.29857819905213,4.88888888888889,997,5.23570712136409
848,151,5.3313679245283,4.94701986754967,999,5.27327327327327
850,149,5.34588235294118,4.94630872483221,999,5.28628628628629
846,152,5.34633569739953,5.00657894736842,998,5.29458917835671
849,150,5.34511189634865,5.00666666666667,999,5.29429429429429
849,150,5.3356890459364,5.00666666666667,999,5.28628628628629
843,154,5.27402135231317,5.00649350649351,997,5.23269809428285
842,156,5.30760095011876,5.0,998,5.25951903807615
846,153,5.3274231678487,4.93464052287582,999,5.26726726726727
844,154,5.40402843601896,4.90909090909091,998,5.32765531062124
837,162,5.36439665471924,5.0,999,5.30530530530531
835,163,5.3437125748503,4.92024539877301,998,5.27454909819639
834,165,5.38009592326139,4.98181818181818,999,5.31431431431431
837,161,5.39068100358423,4.96273291925466,998,5.32164328657315
831,166,5.42478941034898,4.95180722891566,997,5.34603811434303
837,162,5.41099163679809,5.03086419753086,999,5.34934934934935
832,166,5.41225961538461,4.93975903614458,998,5.33366733466934
838,161,5.41646778042959,5.19254658385093,999,5.38038038038038
835,164,5.4562874251497,5.14024390243902,999,5.4044044044044
838,160,5.49880668257757,5.05625,998,5.42785571142285
837,162,5.44324970131422,5.12345679012346,999,5.39139139139139
830,168,5.46626506024096,5.22619047619048,998,5.42585170340681
832,167,5.52644230769231,5.26347305389222,999,5.48248248248248
829,170,5.51507840772014,5.32352941176471,999,5.48248248248248
837,160,5.57228195937873,5.28125,997,5.52557673019057
828,171,5.60507246376812,5.27485380116959,999,5.54854854854855
829,168,5.63329312424608,5.09523809523809,997,5.54262788365095
837,160,5.68458781362007,5.04375,997,5.58174523570712
841,158,5.71105826397146,5.05696202531646,999,5.60760760760761
839,159,5.67580452920143,4.94968553459119,998,5.56012024048096
838,161,5.68019093078759,4.95652173913043,999,5.56356356356356
842,156,5.61995249406176,4.93589743589744,998,5.51302605210421
842,157,5.61163895486936,4.97452229299363,999,5.51151151151151
844,155,5.62322274881517,4.96774193548387,999,5.52152152152152
842,156,5.64251781472684,5.01923076923077,998,5.54509018036072
845,153,5.57396449704142,5.05228758169935,998,5.4939879759519
839,159,5.60071513706794,5.12578616352201,998,5.5250501002004
840,157,5.60238095238095,5.15923566878981,997,5.53259779338014
843,154,5.62158956109134,5.05844155844156,997,5.5346038114343
843,156,5.61209964412811,5.16025641025641,999,5.54154154154154
842,157,5.61282660332542,5.15923566878981,999,5.54154154154154
844,153,5.57701421800948,5.22222222222222,997,5.52256770310933
852,146,5.58568075117371,5.24657534246575,998,5.53607214428858
852,146,5.6150234741784,5.19178082191781,998,5.55310621242485
852,146,5.62441314553991,5.25342465753425,998,5.57014028056112
853,146,5.58968347010551,5.28767123287671,999,5.54554554554555
855,144,5.6187134502924,5.1875,999,5.55655655655656
853,146,5.58147713950762,5.39041095890411,999,5.55355355355355
857,142,5.56709451575263,5.3169014084507,999,5.53153153153153
860,139,5.56976744186047,5.33093525179856,999,5.53653653653654
858,139,5.55827505827506,5.32374100719424,997,5.52557673019057
863,133,5.52143684820394,5.45112781954887,996,5.51204819277108
865,134,5.54913294797688,5.32089552238806,999,5.51851851851852
868,131,5.53341013824885,5.29770992366412,999,5.5025025025025
867,132,5.57093425605536,5.28787878787879,999,5.53353353353353
868,131,5.55414746543779,5.36641221374046,999,5.52952952952953
866,133,5.50461893764434,5.27067669172932,999,5.47347347347347
864,134,5.45023148148148,5.22388059701493,998,5.41983967935872
864,134,5.41898148148148,5.26865671641791,998,5.39879759519038
867,132,5.44636678200692,5.25,999,5.42042042042042
865,134,5.46936416184971,5.25373134328358,999,5.44044044044044
865,133,5.43352601156069,5.21804511278195,998,5.40480961923848
864,133,5.47685185185185,5.17293233082707,997,5.43630892678034
869,130,5.50172612197929,5.3,999,5.47547547547548
868,131,5.45046082949309,5.31297709923664,999,5.43243243243243
870,129,5.51149425287356,5.23255813953488,999,5.47547547547548
871,128,5.54420206659013,5.3671875,999,5.52152152152152
871,128,5.53501722158439,5.2421875,999,5.4974974974975
875,122,5.45714285714286,5.12295081967213,997,5.41624874623872
877,122,5.45610034207526,4.99180327868852,999,5.3993993993994
868,130,5.47235023041475,5.02307692307692,998,5.41382765531062
868,131,5.49539170506912,4.9236641221374,999,5.42042042042042
874,123,5.50228832951945,5.0650406504065,997,5.44834503510532
874,125,5.56407322654462,5.032,999,5.4974974974975
874,125,5.53546910755149,5.16,999,5.48848848848849
871,128,5.56257175660161,5.2421875,999,5.52152152152152
874,125,5.5091533180778,5.36,999,5.49049049049049
868,131,5.56221198156682,5.23664122137405,999,5.51951951951952
867,132,5.6078431372549,5.24242424242424,999,5.55955955955956
860,139,5.58720930232558,5.34532374100719,999,5.55355355355355
862,137,5.53712296983759,5.32116788321168,999,5.50750750750751
866,132,5.54157043879908,5.31818181818182,998,5.51202404809619
860,137,5.53023255813954,5.43795620437956,997,5.51755265797392
861,138,5.50522648083624,5.42753623188406,999,5.49449449449449
861,137,5.52961672473868,5.41605839416058,998,5.51402805611222
858,140,5.54195804195804,5.3,998,5.50801603206413
860,137,5.58372093023256,5.29197080291971,997,5.54363089267803
864,134,5.55439814814815,5.37313432835821,998,5.53006012024048
858,141,5.502331002331,5.36170212765957,999,5.48248248248248
861,138,5.4541231126597,5.27536231884058,999,5.42942942942943
853,146,5.40328253223916,5.29452054794521,999,5.38738738738739
859,139,5.33760186263097,5.32374100719424,998,5.33567134268537
861,138,5.39953542392567,5.34782608695652,999,5.39239239239239
856,142,5.42873831775701,5.33802816901408,998,5.41583166332665
856,143,5.4696261682243,5.37762237762238,999,5.45645645645646
857,141,5.4830805134189,5.30496453900709,998,5.45791583166333
862,137,5.46983758700696,5.0948905109489,999,5.41841841841842
862,137,5.43155452436195,5.14598540145985,999,5.39239239239239
862,136,5.39559164733179,5.19117647058824,998,5.36773547094188
858,141,5.39277389277389,5.20567375886525,999,5.36636636636637
863,135,5.33024333719583,5.06666666666667,998,5.29458917835671
863,134,5.32676709154114,5.22388059701493,997,5.31293881644935
875,124,5.38857142857143,5.18548387096774,999,5.36336336336336
874,125,5.40617848970252,5.248,999,5.38638638638639
881,116,5.422247446084,5.14655172413793,997,5.3901705115346
883,116,5.41902604756512,5.1551724137931,999,5.38838838838839
878,120,5.42596810933941,5.13333333333333,998,5.39078156312625
881,118,5.42338251986379,5.22033898305085,999,5.3993993993994
883,116,5.39524348810872,5.36206896551724,999,5.39139139139139
887,111,5.41149943630214,5.3963963963964,998,5.40981963927856
889,109,5.429696287964,5.36697247706422,998,5.42284569138277
885,114,5.45988700564972,5.49122807017544,999,5.46346346346346
880,118,5.46477272727273,5.45762711864407,998,5.46392785571142
883,115,5.46885617214043,5.50434782608696,998,5.47294589178357
884,115,5.45361990950226,5.50434782608696,999,5.45945945945946
889,110,5.43644544431946,5.62727272727273,999,5.45745745745746
885,114,5.46892655367232,5.69298245614035,999,5.49449449449449
889,109,5.44656917885264,5.75229357798165,998,5.47995991983968
888,110,5.44594594594595,5.66363636363636,998,5.46993987975952
879,119,5.43230944254835,5.60504201680672,998,5.45290581162325
880,118,5.45568181818182,5.50847457627119,998,5.46192384769539
884,115,5.43438914027149,5.55652173913044,999,5.44844844844845
884,113,5.46266968325792,5.58407079646018,997,5.47642928786359
885,113,5.43728813559322,5.61946902654867,998,5.45791583166333
884,114,5.49660633484163,5.63157894736842,998,5.51202404809619
887,112,5.45208568207441,5.63392857142857,999,5.47247247247247
887,112,5.46448703494927,5.72321428571429,999,5.49349349349349
888,111,5.51689189189189,5.63063063063063,999,5.52952952952953
888,109,5.49662162162162,5.53211009174312,997,5.50050150451354
892,106,5.4719730941704,5.60377358490566,998,5.48597194388778
891,107,5.42199775533109,5.55140186915888,998,5.43587174348697
887,111,5.40022547914318,5.5045045045045,998,5.41182364729459
885,114,5.41920903954802,5.37719298245614,999,5.41441441441441
880,117,5.4375,5.34188034188034,997,5.42627883650953
882,117,5.47845804988662,5.20512820512821,999,5.44644644644645
883,116,5.48471121177803,5.39655172413793,999,5.47447447447447
891,107,5.47250280583614,5.42990654205607,998,5.46793587174349
888,111,5.40315315315315,5.43243243243243,999,5.40640640640641
891,108,5.43097643097643,5.4537037037037,999,5.43343343343343
890,108,5.42921348314607,5.49074074074074,998,5.43587174348697
895,104,5.47486033519553,5.5,999,5.47747747747748
899,99,5.42269187986652,5.55555555555556,998,5.43587174348697
899,99,5.39599555061179,5.54545454545455,998,5.41082164328657
896,102,5.4453125,5.69607843137255,998,5.47094188376754
892,106,5.41816143497758,5.52830188679245,998,5.42985971943888
894,105,5.45637583892617,5.52380952380952,999,5.46346346346346
895,103,5.43016759776536,5.62135922330097,998,5.4498997995992
898,100,5.47772828507795,5.76,998,5.5060120240481
894,104,5.46196868008949,5.69230769230769,998,5.48597194388778
897,100,5.47045707915273,5.79,997,5.5025075225677
895,101,5.43798882681564,5.84158415841584,996,5.4789156626506
895,103,5.38435754189944,5.71844660194175,998,5.4188376753507
893,105,5.37290033594625,5.83809523809524,998,5.42184368737475
896,101,5.35267857142857,5.68316831683168,997,5.38615847542628
897,101,5.38127090301003,5.66336633663366,998,5.40981963927856
891,108,5.334455667789,5.66666666666667,999,5.37037037037037
896,103,5.31696428571429,5.63106796116505,999,5.34934934934935
900,98,5.32222222222222,5.61224489795918,998,5.35070140280561
903,95,5.33997785160576,5.55789473684211,998,5.36072144288577
898,100,5.33296213808463,5.72,998,5.37174348697395
905,94,5.3292817679558,5.73404255319149,999,5.36736736736737
906,92,5.2924944812362,5.91304347826087,998,5.3496993987976
906,90,5.3233995584989,5.86666666666667,996,5.37248995983936
904,95,5.33407079646018,5.87368421052632,999,5.38538538538539
904,95,5.38274336283186,5.89473684210526,999,5.43143143143143
907,90,5.37375964718853,5.72222222222222,997,5.40521564694082
907,91,5.35391400220507,5.78021978021978,998,5.39278557114228
910,86,5.3043956043956,5.86046511627907,996,5.35240963855422
906,90,5.3476821192053,5.8,996,5.38855421686747
909,90,5.35203520352035,5.98888888888889,999,5.40940940940941
910,89,5.37032967032967,6.01123595505618,999,5.42742742742743
912,87,5.39035087719298,6.17241379310345,999,5.45845845845846
909,88,5.37843784378438,6.14772727272727,997,5.44633901705115
905,93,5.35690607734807,6.11827956989247,998,5.42785571142285
908,90,5.43171806167401,5.87777777777778,998,5.47194388777555
913,86,5.42059145673603,5.7906976744186,999,5.45245245245245
908,88,5.41079295154185,5.71590909090909,996,5.43775100401606
917,82,5.39367502726281,5.70731707317073,999,5.41941941941942
917,82,5.42966194111232,5.90243902439024,999,5.46846846846847
918,80,5.47930283224401,6.05,998,5.5250501002004
909,90,5.49174917491749,6.04444444444444,999,5.54154154154154
909,86,5.48954895489549,6.11627906976744,995,5.54371859296482
913,85,5.51369112814896,6.04705882352941,998,5.55911823647295
914,84,5.51203501094092,6.21428571428571,998,5.57114228456914
910,89,5.47472527472527,6.37078651685393,999,5.55455455455455
912,85,5.52083333333333,6.27058823529412,997,5.58475426278837
915,84,5.47650273224044,6.30952380952381,999,5.54654654654655
913,85,5.46549835706462,6.4,998,5.54509018036072
907,91,5.44542447629548,6.38461538461539,998,5.5310621242485
912,87,5.4375,6.50574712643678,999,5.53053053053053
910,88,5.47362637362637,6.44318181818182,998,5.55911823647295
913,86,5.44249726177437,6.40697674418605,999,5.52552552552553
919,80,5.46354733405876,6.35,999,5.53453453453453
922,77,5.43492407809111,6.44155844155844,999,5.51251251251251
919,79,5.41349292709467,6.43037974683544,998,5.4939879759519
917,78,5.38604143947655,6.48717948717949,995,5.47236180904523
924,75,5.41450216450216,6.56,999,5.5005005005005
922,76,5.41540130151844,6.53947368421053,998,5.50100200400802
920,79,5.41195652173913,6.67088607594937,999,5.51151151151151
920,79,5.39021739130435,6.59493670886076,999,5.48548548548549
917,82,5.41112322791712,6.53658536585366,999,5.5035035035035
914,84,5.45295404814004,6.36904761904762,998,5.53006012024048
913,86,5.46221248630887,6.27906976744186,999,5.53253253253253
911,88,5.49835345773875,6.38636363636364,999,5.57657657657658
914,85,5.5109409190372,6.32941176470588,999,5.58058058058058
910,88,5.51978021978022,6.375,998,5.59519038076152
913,85,5.50164293537788,6.4,998,5.57815631262525
914,84,5.49234135667396,6.38095238095238,998,5.56713426853707
909,90,5.43674367436744,6.41111111111111,999,5.52452452452452
902,94,5.42461197339246,6.57446808510638,996,5.53313253012048
905,94,5.45082872928177,6.73404255319149,999,5.57157157157157
900,99,5.46444444444444,6.68686868686869,999,5.58558558558559
899,100,5.50723025583982,6.63,999,5.61961961961962
893,106,5.45240761478164,6.49056603773585,999,5.56256256256256
890,108,5.45505617977528,6.51851851851852,998,5.57014028056112
898,101,5.39532293986637,6.41584158415842,999,5.4984984984985
896,102,5.40848214285714,6.48039215686275,998,5.51803607214429
896,101,5.45647321428571,6.5049504950495,997,5.56268806419258
893,103,5.46808510638298,6.47572815533981,996,5.57228915662651
903,96,5.43078626799557,6.35416666666667,999,5.51951951951952
896,100,5.4140625,6.27,996,5.5
899,100,5.37708565072303,6.35,999,5.47447447447447
900,99,5.44222222222222,6.4040404040404,999,5.53753753753754
891,106,5.37149270482604,6.31132075471698,997,5.47141424272818
891,108,5.34006734006734,6.30555555555556,999,5.44444444444444
890,109,5.33595505617978,6.3302752293578,999,5.44444444444444
888,110,5.35135135135135,6.27272727272727,998,5.45290581162325
886,112,5.28329571106095,6.41964285714286,998,5.41082164328657
881,116,5.21339387060159,6.36206896551724,997,5.34704112337011
881,118,5.24858115777526,6.43220338983051,999,5.38838838838839
880,118,5.32272727272727,6.42372881355932,998,5.45290581162325
880,119,5.36136363636364,6.26050420168067,999,5.46846846846847
883,115,5.38618346545866,6.23478260869565,998,5.48396793587174
883,116,5.36919592298981,6.17241379310345,999,5.46246246246246
886,112,5.40857787810384,6.0625,998,5.48196392785571
887,111,5.37767756482525,5.98198198198198,998,5.44488977955912
882,114,5.32993197278912,5.95614035087719,996,5.40160642570281
882,116,5.30725623582766,6.01724137931035,998,5.38977955911824
882,117,5.3390022675737,6.11965811965812,999,5.43043043043043
884,115,5.32918552036199,6.0695652173913,999,5.41441441441441
889,110,5.34420697412823,6.09090909090909,999,5.42642642642643
891,108,5.334455667789,6.13888888888889,999,5.42142142142142
881,117,5.36662883087401,6.02564102564103,998,5.4438877755511
887,112,5.37316798196167,6.01785714285714,999,5.44544544544545
886,113,5.40970654627539,6.04424778761062,999,5.48148148148148
882,116,5.37414965986395,6.04310344827586,998,5.45190380761523
884,115,5.3472850678733,6.0695652173913,999,5.43043043043043
886,113,5.3882618510158,6.23008849557522,999,5.48348348348348
880,119,5.40681818181818,6.10084033613445,999,5.48948948948949
876,121,5.44063926940639,6.27272727272727,997,5.54162487462387
881,117,5.46424517593644,6.20512820512821,998,5.55110220440882
877,119,5.44811858608894,6.2436974789916,996,5.54317269076305
882,116,5.41950113378685,6.28448275862069,998,5.52004008016032
885,114,5.39322033898305,6.02631578947368,999,5.46546546546547
883,116,5.44620611551529,6.04310344827586,999,5.51551551551552
884,114,5.40723981900453,6.10526315789474,998,5.48697394789579
891,108,5.40516273849607,6.07407407407407,999,5.47747747747748
884,115,5.41742081447964,5.99130434782609,999,5.48348348348348
880,119,5.45227272727273,6.04201680672269,999,5.52252252252252
874,124,5.48741418764302,6.0,998,5.55110220440882
873,126,5.48339060710195,5.93650793650794,999,5.54054054054054
869,128,5.48791714614499,5.859375,997,5.53560682046138
870,127,5.51264367816092,5.88188976377953,997,5.55967903711133
871,128,5.4902411021814,5.8828125,999,5.54054054054054
867,132,5.4002306805075,5.82575757575758,999,5.45645645645646
867,131,5.43252595155709,5.90839694656489,998,5.49498997995992
870,129,5.42528735632184,5.90697674418605,999,5.48748748748749
867,131,5.48212226066897,5.85496183206107,998,5.5310621242485
865,133,5.45549132947977,5.89473684210526,998,5.51402805611222
871,128,5.49138920780712,5.9453125,999,5.54954954954955
868,131,5.47695852534562,5.95419847328244,999,5.53953953953954
869,128,5.43728423475259,5.8671875,997,5.49247743229689
867,132,5.43944636678201,5.71969696969697,999,5.47647647647648
865,132,5.42774566473988,5.56818181818182,997,5.44633901705115
864,133,5.38773148148148,5.61654135338346,997,5.41825476429288
860,138,5.36744186046512,5.6304347826087,998,5.40380761523046
860,137,5.33720930232558,5.62043795620438,997,5.37612838515547
867,132,5.38638985005767,5.63636363636364,999,5.41941941941942
871,128,5.38920780711825,5.6796875,999,5.42642642642643
873,125,5.39862542955326,5.616,998,5.42585170340681
872,127,5.40252293577982,5.51181102362205,999,5.41641641641642
868,130,5.41244239631336,5.68461538461538,998,5.44789579158317
863,135,5.4252607184241,5.93333333333333,998,5.4939879759519
857,142,5.43757292882147,5.86619718309859,999,5.4984984984985
858,140,5.38811188811189,5.83571428571429,998,5.45090180360721
851,147,5.3689776733255,5.8843537414966,998,5.44488977955912
857,140,5.32438739789965,5.87142857142857,997,5.4012036108325
860,137,5.30813953488372,5.7956204379562,997,5.37512537612839
860,139,5.24651162790698,5.74820143884892,999,5.31631631631632
862,136,5.20649651972158,5.61764705882353,998,5.2625250501002
866,132,5.19284064665127,5.62878787878788,998,5.25050100200401
869,129,5.27502876869965,5.65116279069767,998,5.32364729458918
874,124,5.2837528604119,5.64516129032258,998,5.32865731462926
872,125,5.35206422018349,5.784,997,5.4062186559679
874,124,5.3512585812357,5.70967741935484,998,5.39579158316633
870,128,5.35057471264368,5.78125,998,5.40581162324649
871,126,5.30884041331803,5.8015873015873,997,5.37111334002006
873,126,5.33447880870561,5.70634920634921,999,5.38138138138138
866,132,5.31062355658199,5.51515151515152,998,5.3376753507014
866,131,5.31870669745958,5.35114503816794,997,5.32296890672016
867,132,5.27335640138408,5.62878787878788,999,5.32032032032032
865,133,5.27630057803468,5.6015037593985,998,5.31963927855711
868,130,5.34331797235023,5.56153846153846,998,5.37174348697395
864,134,5.33912037037037,5.57462686567164,998,5.37074148296593
863,135,5.32676709154114,5.59259259259259,998,5.3627254509018
860,138,5.3453488372093,5.60144927536232,998,5.38076152304609
860,139,5.40813953488372,5.54676258992806,999,5.42742742742743
862,136,5.39327146171694,5.57352941176471,998,5.41783567134269
857,141,5.40140023337223,5.65957446808511,998,5.43787575150301
860,138,5.4,5.71739130434783,998,5.4438877755511
864,134,5.40856481481481,5.76865671641791,998,5.45691382765531
867,132,5.39100346020761,5.75757575757576,999,5.43943943943944
863,136,5.32444959443801,5.70588235294118,999,5.37637637637638
862,137,5.3631090487239,5.70802919708029,999,5.41041041041041
857,140,5.36289381563594,5.59285714285714,997,5.39518555667001
863,135,5.28736964078795,5.60740740740741,998,5.33066132264529
860,138,5.28953488372093,5.64492753623188,998,5.33867735470942
857,140,5.2928821470245,5.66428571428571,997,5.34503510531595
859,140,5.31897555296857,5.52142857142857,999,5.34734734734735
863,134,5.3441483198146,5.55970149253731,997,5.37311935807422
862,136,5.36890951276102,5.44852941176471,998,5.37975951903808
856,142,5.33411214953271,5.38732394366197,998,5.34168336673347
855,142,5.34035087719298,5.36619718309859,997,5.34403209628887
848,151,5.25825471698113,5.35761589403973,999,5.27327327327327
850,149,5.28470588235294,5.31543624161074,999,5.28928928928929
848,148,5.29952830188679,5.45945945945946,996,5.32329317269076
848,151,5.34080188679245,5.50331125827815,999,5.36536536536537
847,152,5.28689492325856,5.55263157894737,999,5.32732732732733
852,146,5.25704225352113,5.6986301369863,998,5.32164328657315
854,143,5.29274004683841,5.66433566433566,997,5.34603811434303
854,143,5.33957845433255,5.75524475524475,997,5.39919759277833
851,147,5.33137485311398,5.69387755102041,998,5.38476953907816
854,143,5.36885245901639,5.8041958041958,997,5.43129388164493
866,133,5.33949191685912,5.69924812030075,999,5.38738738738739
873,126,5.3516609392898,5.82539682539683,999,5.41141141141141
872,127,5.37614678899083,5.74803149606299,999,5.42342342342342
867,130,5.38985005767013,5.8,997,5.44332998996991
874,123,5.36613272311213,5.83739837398374,997,5.42427281845537
875,123,5.35428571428571,5.6260162601626,998,5.3877755511022
876,121,5.29452054794521,5.63636363636364,997,5.33600802407222
874,123,5.30549199084668,5.56910569105691,997,5.33801404212638
878,121,5.31321184510251,5.65289256198347,999,5.35435435435435
876,123,5.35502283105023,5.64227642276423,999,5.39039039039039
878,121,5.37129840546697,5.68595041322314,999,5.40940940940941
880,117,5.32613636363636,5.7008547008547,997,5.37011033099298
875,122,5.33028571428571,5.69672131147541,997,5.37512537612839
878,120,5.29840546697039,5.54166666666667,998,5.32765531062124
875,122,5.30857142857143,5.50819672131148,997,5.33299899699097
878,121,5.31776765375854,5.52892561983471,999,5.34334334334334
878,121,5.33257403189066,5.63636363636364,999,5.36936936936937
886,112,5.38374717832957,5.63392857142857,998,5.41182364729459
881,116,5.38024971623156,5.53448275862069,997,5.39819458375125
884,114,5.43778280542986,5.47368421052632,998,5.44188376753507
883,115,5.40543601359003,5.50434782608696,998,5.41683366733467
885,114,5.37627118644068,5.39473684210526,999,5.37837837837838
886,112,5.372460496614,5.54464285714286,998,5.39178356713427
887,111,5.37091319052988,5.45945945945946,998,5.38076152304609
885,114,5.38531073446328,5.43859649122807,999,5.39139139139139
887,112,5.49830890642616,5.46428571428571,999,5.49449449449449
888,111,5.55067567567568,5.64864864864865,999,5.56156156156156
886,113,5.5665914221219,5.68141592920354,999,5.57957957957958
888,111,5.56306306306306,5.71171171171171,999,5.57957957957958
882,115,5.58730158730159,5.57391304347826,997,5.58575727181545
880,118,5.54204545454545,5.55932203389831,998,5.54408817635271
879,120,5.50739476678043,5.56666666666667,999,5.51451451451451
884,115,5.53393665158371,5.41739130434783,999,5.52052052052052
887,111,5.54340473506201,5.5045045045045,998,5.53907815631263
887,112,5.52536640360767,5.48214285714286,999,5.52052052052052
889,109,5.4859392575928,5.59633027522936,998,5.49799599198397
893,106,5.494960806271,5.5377358490566,999,5.4994994994995
887,110,5.42841037204059,5.58181818181818,997,5.44533600802407
883,114,5.39524348810872,5.49122807017544,997,5.4062186559679
884,115,5.43665158371041,5.51304347826087,999,5.44544544544545
882,116,5.45691609977324,5.55172413793103,998,5.46793587174349
888,111,5.4222972972973,5.77477477477477,999,5.46146146146146
883,116,5.44280860702152,5.76724137931035,999,5.48048048048048
886,113,5.42099322799097,5.76991150442478,999,5.46046046046046
887,112,5.45659526493799,5.67857142857143,999,5.48148148148148
889,110,5.47019122609674,5.66363636363636,999,5.49149149149149
888,110,5.47297297297297,5.62727272727273,998,5.48997995991984
892,107,5.44394618834081,5.68224299065421,999,5.46946946946947
889,110,5.46569178852643,5.58181818181818,999,5.47847847847848
885,114,5.43728813559322,5.57017543859649,999,5.45245245245245
887,110,5.40360766629087,5.54545454545455,997,5.41925777331996
880,119,5.37045454545455,5.40336134453782,999,5.37437437437437
885,114,5.4225988700565,5.32456140350877,999,5.41141141141141
876,123,5.45662100456621,5.3739837398374,999,5.44644644644645
873,125,5.40091638029782,5.44,998,5.40581162324649
871,126,5.40298507462687,5.52380952380952,997,5.41825476429288
868,128,5.41589861751152,5.4453125,996,5.41967871485944
868,129,5.39516129032258,5.45736434108527,997,5.40320962888666
868,128,5.40552995391705,5.5546875,996,5.42469879518072
868,130,5.40437788018433,5.66153846153846,998,5.43787575150301
861,136,5.38792102206736,5.53676470588235,997,5.40822467402207
864,134,5.36805555555556,5.50746268656716,998,5.38677354709419
865,134,5.33410404624277,5.50746268656716,999,5.35735735735736
863,135,5.38470451911935,5.47407407407407,998,5.39679358717435
860,138,5.32790697674419,5.40579710144928,998,5.33867735470942
860,139,5.36744186046512,5.38848920863309,999,5.37037037037037
864,135,5.3912037037037,5.42222222222222,999,5.3953953953954
863,135,5.3765932792584,5.5037037037037,998,5.3937875751503
859,140,5.38998835855646,5.52142857142857,999,5.40840840840841
853,146,5.35638921453693,5.56849315068493,999,5.38738738738739
849,148,5.32391048292108,5.48648648648649,997,5.34804413239719
848,150,5.31839622641509,5.34,998,5.32164328657315
852,146,5.30399061032864,5.38356164383562,998,5.31563126252505
852,146,5.33568075117371,5.42465753424658,998,5.34869739478958
855,143,5.26783625730994,5.31468531468532,998,5.27454909819639
855,142,5.27368421052632,5.34507042253521,997,5.28385155466399
858,141,5.28088578088578,5.32624113475177,999,5.28728728728729
851,147,5.26086956521739,5.29931972789116,998,5.26653306613226
852,146,5.31807511737089,5.24657534246575,998,5.30761523046092
856,143,5.3481308411215,5.22377622377622,999,5.33033033033033
858,140,5.26806526806527,5.2,998,5.25851703406814
859,139,5.31315483119907,5.26618705035971,998,5.30661322645291
861,138,5.29152148664344,5.26811594202899,999,5.28828828828829
860,139,5.34651162790698,5.38129496402878,999,5.35135135135135
865,134,5.35953757225434,5.37313432835821,999,5.36136136136136
854,142,5.38524590163934,5.3169014084507,996,5.37550200803213
852,147,5.33333333333333,5.31292517006803,999,5.33033033033033
857,142,5.39673278879813,5.35211267605634,999,5.39039039039039
863,135,5.37311703360371,5.34814814814815,998,5.36973947895792
864,134,5.35416666666667,5.36567164179105,998,5.35571142284569
859,139,5.30151338766007,5.25179856115108,998,5.29458917835671
865,132,5.32485549132948,5.33333333333333,997,5.3259779338014
874,125,5.34210526315789,5.296,999,5.33633633633634
868,129,5.32603686635945,5.18604651162791,997,5.30792377131394
863,135,5.29432213209734,5.11851851851852,998,5.27054108216433
854,144,5.27868852459016,5.20138888888889,998,5.26753507014028
867,131,5.25028835063437,5.18320610687023,998,5.24148296593186
859,139,5.27357392316647,5.07194244604317,998,5.24549098196393
855,142,5.17076023391813,5.16901408450704,997,5.17051153460381
853,144,5.1453692848769,5.18055555555556,997,5.15045135406219
858,140,5.16550116550117,5.29285714285714,998,5.18336673346693
866,133,5.18013856812933,5.21052631578947,999,5.18418418418418
857,142,5.19136522753792,5.19014084507042,999,5.19119119119119
859,138,5.21653084982538,5.15942028985507,997,5.2086258776329
853,144,5.1957796014068,5.13194444444444,997,5.18655967903711
853,146,5.13247362250879,5.15753424657534,999,5.13613613613614
846,151,5.18912529550827,5.06622516556291,997,5.17051153460381
842,156,5.23396674584323,5.08974358974359,998,5.21142284569138
846,153,5.20212765957447,5.37254901960784,999,5.22822822822823
844,153,5.19668246445498,5.31372549019608,997,5.21464393179539
848,150,5.28537735849057,5.40666666666667,998,5.30360721442886
850,148,5.24117647058824,5.60135135135135,998,5.29458917835671
848,151,5.21698113207547,5.54304635761589,999,5.26626626626627
849,150,5.26855123674912,5.45333333333333,999,5.2962962962963
857,142,5.22170361726954,5.30985915492958,999,5.23423423423423
855,144,5.22923976608187,5.26388888888889,999,5.23423423423423
848,149,5.20400943396226,5.26174496644295,997,5.21263791374122
851,148,5.213866039953,5.22972972972973,999,5.21621621621622
848,151,5.27240566037736,5.22516556291391,999,5.26526526526527
851,147,5.26556991774383,5.34013605442177,998,5.27655310621242
849,148,5.23557126030624,5.35135135135135,997,5.25275827482447
852,147,5.32981220657277,5.42857142857143,999,5.34434434434434
844,154,5.28672985781991,5.47402597402597,998,5.31563126252505
846,151,5.28014184397163,5.49668874172185,997,5.31293881644935
857,142,5.32438739789965,5.45070422535211,999,5.34234234234234
857,141,5.32555425904317,5.38297872340426,998,5.33366733466934
854,143,5.34309133489461,5.30769230769231,997,5.33801404212638
851,147,5.35487661574618,5.28571428571429,998,5.34468937875751
854,145,5.3559718969555,5.30344827586207,999,5.34834834834835
858,141,5.36946386946387,5.22695035460993,999,5.34934934934935
858,139,5.38461538461539,5.1294964028777,997,5.34904714142427
858,139,5.44172494172494,5.07194244604317,997,5.3901705115346
859,140,5.38067520372526,4.95714285714286,999,5.32132132132132
863,136,5.31865585168019,5.125,999,5.29229229229229
859,139,5.37019790454016,5.23021582733813,998,5.35070140280561
861,138,5.40882694541231,5.17391304347826,999,5.37637637637638
858,140,5.3997668997669,5.15,998,5.36472945891784
857,141,5.44224037339557,5.24113475177305,998,5.41382765531062
861,137,5.44947735191638,5.21897810218978,998,5.41783567134269
863,134,5.49710312862109,5.11940298507463,997,5.44633901705115
862,136,5.4292343387471,5.19852941176471,998,5.39779559118236
861,137,5.465737514518,5.2043795620438,998,5.42985971943888
861,138,5.45876887340302,5.22463768115942,999,5.42642642642643
864,134,5.4224537037037,5.20149253731343,998,5.39278557114228
862,136,5.38051044083527,5.09558823529412,998,5.34168336673347
861,137,5.35075493612079,5.05109489051095,998,5.30961923847695
861,137,5.39140534262485,4.86861313868613,998,5.31963927855711
865,134,5.33410404624277,4.91791044776119,999,5.27827827827828
864,132,5.31828703703704,4.97727272727273,996,5.27309236947791
858,141,5.32167832167832,4.97872340425532,999,5.27327327327327
867,132,5.30449826989619,5.0,999,5.26426426426426
863,134,5.28389339513326,5.1865671641791,997,5.27081243731194
868,131,5.32603686635945,5.19847328244275,999,5.30930930930931
872,125,5.31651376146789,5.208,997,5.30290872617854
877,122,5.36602052451539,5.36885245901639,999,5.36636636636637
872,125,5.37614678899083,5.176,997,5.35105315947844
872,126,5.37385321100917,5.27777777777778,998,5.36172344689379
870,129,5.3367816091954,5.24806201550388,999,5.32532532532533
878,120,5.31662870159453,5.19166666666667,998,5.30160320641283
877,122,5.30558722919042,5.22131147540984,999,5.2952952952953
870,127,5.29310344827586,5.32283464566929,997,5.29689067201605
871,127,5.26980482204363,5.18110236220472,998,5.25851703406814
877,122,5.29532497149373,5.24590163934426,999,5.28928928928929
872,127,5.31192660550459,5.33070866141732,999,5.31431431431431
868,131,5.28110599078341,5.29007633587786,999,5.28228228228228
872,127,5.27866972477064,5.24409448818898,999,5.27427427427427
875,124,5.28457142857143,5.38709677419355,999,5.2972972972973
878,121,5.33485193621868,5.22314049586777,999,5.32132132132132
871,128,5.27669345579793,5.125,999,5.25725725725726
871,127,5.25832376578645,5.13385826771654,998,5.24248496993988
875,124,5.312,5.01612903225806,999,5.27527527527528
876,121,5.30936073059361,5.11570247933884,997,5.28585757271815
877,121,5.31128848346636,5.1900826446281,998,5.29659318637275
884,114,5.34389140271493,5.34210526315789,998,5.3436873747495
883,116,5.37938844847112,5.38793103448276,999,5.38038038038038
882,116,5.3843537414966,5.31896551724138,998,5.37675350701403
880,119,5.44431818181818,5.4453781512605,999,5.44444444444444
882,116,5.48526077097506,5.46551724137931,998,5.48296593186373
883,115,5.43941109852775,5.41739130434783,998,5.43687374749499
882,117,5.41383219954649,5.34188034188034,999,5.40540540540541
878,120,5.42369020501139,5.30833333333333,998,5.40981963927856
884,115,5.49095022624434,5.34782608695652,999,5.47447447447447
880,119,5.41477272727273,5.49579831932773,999,5.42442442442442
876,123,5.42922374429224,5.48780487804878,999,5.43643643643644
874,124,5.46224256292906,5.51612903225806,998,5.4689378757515
876,123,5.42351598173516,5.52845528455285,999,5.43643643643644
875,124,5.37257142857143,5.43548387096774,999,5.38038038038038
880,119,5.37045454545455,5.50420168067227,999,5.38638638638639
885,114,5.37062146892655,5.49122807017544,999,5.38438438438438
879,119,5.38907849829352,5.34453781512605,998,5.38376753507014
878,120,5.38496583143508,5.36666666666667,998,5.38276553106212
877,121,5.45039908779932,5.33057851239669,998,5.43587174348697
877,122,5.45039908779932,5.35245901639344,999,5.43843843843844
881,117,5.46765039727582,5.56410256410256,998,5.47895791583166
879,120,5.51877133105802,5.53333333333333,999,5.52052052052052
877,122,5.51311288483466,5.45901639344262,999,5.50650650650651
884,115,5.44343891402715,5.79130434782609,999,5.48348348348348
876,122,5.42237442922374,5.71311475409836,998,5.45791583166333
874,124,5.39702517162471,5.63709677419355,998,5.42685370741483
865,132,5.45780346820809,5.66666666666667,997,5.48545636910732
864,133,5.45023148148148,5.70676691729323,997,5.48445336008024
864,133,5.47685185185185,5.63157894736842,997,5.4974924774323
865,134,5.46705202312139,5.58208955223881,999,5.48248248248248
874,124,5.44508009153318,5.56451612903226,998,5.45991983967936
874,123,5.44050343249428,5.51219512195122,997,5.4493480441324
876,123,5.49086757990868,5.39024390243902,999,5.47847847847848
880,119,5.46590909090909,5.41176470588235,999,5.45945945945946
877,122,5.46864310148233,5.41803278688525,999,5.46246246246246
873,124,5.4524627720504,5.34677419354839,997,5.43931795386158
869,130,5.4614499424626,5.3,999,5.44044044044044
869,129,5.45109321058688,5.34108527131783,998,5.43687374749499
870,129,5.46781609195402,5.2015503875969,999,5.43343343343343
867,130,5.48212226066897,5.26153846153846,997,5.45336008024072
870,129,5.4632183908046,5.32558139534884,999,5.44544544544545
866,133,5.44688221709007,5.44360902255639,999,5.44644644644645
865,134,5.41618497109827,5.32835820895522,999,5.4044044044044
861,137,5.41811846689895,5.25547445255474,998,5.39579158316633
864,133,5.40972222222222,5.13533834586466,997,5.37311935807422
866,133,5.40531177829099,5.20300751879699,999,5.37837837837838
862,135,5.36890951276102,5.34074074074074,997,5.36509528585757
861,137,5.4123112659698,5.32846715328467,998,5.40080160320641
858,141,5.42890442890443,5.43971631205674,999,5.43043043043043
847,151,5.42384887839433,5.45033112582781,998,5.42785571142285
854,145,5.47423887587822,5.37931034482759,999,5.46046046046046
851,147,5.46768507638073,5.48299319727891,998,5.46993987975952
859,138,5.51571594877765,5.69565217391304,997,5.54062186559679
865,134,5.52254335260116,5.70149253731343,999,5.54654654654655
875,124,5.51428571428571,5.69354838709677,999,5.53653653653654
872,127,5.52866972477064,5.52755905511811,999,5.52852852852853
876,123,5.50570776255708,5.65853658536585,999,5.52452452452452
881,117,5.47219069239501,5.63247863247863,998,5.49098196392786
887,112,5.53551296505073,5.67857142857143,999,5.55155155155155
888,111,5.53828828828829,5.81981981981982,999,5.56956956956957
889,108,5.53768278965129,5.9537037037037,997,5.5827482447342
885,113,5.5728813559322,5.97345132743363,998,5.61823647294589
890,109,5.54719101123596,5.88990825688073,999,5.58458458458458
888,109,5.48085585585586,6.03669724770642,997,5.54162487462387
886,113,5.45936794582393,6.02654867256637,999,5.52352352352352
884,112,5.43552036199095,5.83035714285714,996,5.47991967871486
881,118,5.51305334846765,5.82203389830508,999,5.54954954954955
882,113,5.45918367346939,5.85840707964602,995,5.50452261306533
881,117,5.48581157775255,5.94871794871795,998,5.54008016032064
884,114,5.45588235294118,6.0,998,5.51803607214429
885,113,5.48022598870056,5.98230088495575,998,5.53707414829659
886,111,5.46952595936795,6.01801801801802,997,5.53059177532598
888,111,5.50337837837838,6.17117117117117,999,5.57757757757758
889,110,5.47694038245219,6.05454545454545,999,5.54054054054054
885,112,5.45762711864407,5.88392857142857,997,5.50551654964895
885,114,5.42372881355932,5.85964912280702,999,5.47347347347347
883,116,5.39750849377123,5.77586206896552,999,5.44144144144144
884,114,5.34276018099547,5.62280701754386,998,5.374749498998
880,119,5.34886363636364,5.57983193277311,999,5.37637637637638
878,120,5.35079726651481,5.55833333333333,998,5.37575150300601
875,123,5.368,5.59349593495935,998,5.39579158316633
875,123,5.37142857142857,5.48780487804878,998,5.38577154308617
868,131,5.43778801843318,5.41221374045802,999,5.43443443443443
868,130,5.46543778801843,5.33846153846154,998,5.44889779559118
874,124,5.45080091533181,5.24193548387097,998,5.4248496993988
880,119,5.42045454545455,5.25210084033613,999,5.4004004004004
881,118,5.46878547105562,5.33898305084746,999,5.45345345345345
880,119,5.41704545454545,5.31932773109244,999,5.40540540540541
875,124,5.40228571428571,5.20161290322581,999,5.37737737737738
876,123,5.48287671232877,5.19512195121951,999,5.44744744744745
878,121,5.46583143507973,5.15702479338843,999,5.42842842842843
876,123,5.45890410958904,5.13008130081301,999,5.41841841841842
884,114,5.51470588235294,5.13157894736842,998,5.47094188376754
887,111,5.4836527621195,5.21621621621622,998,5.45390781563126
885,112,5.45762711864407,5.15178571428571,997,5.42326980942828
880,118,5.46590909090909,4.95762711864407,998,5.40581162324649
876,122,5.48401826484018,5.00819672131148,998,5.42585170340681
877,122,5.49600912200684,5.02459016393443,999,5.43843843843844
878,120,5.50455580865604,5.00833333333333,998,5.44488977955912
884,115,5.46493212669683,5.12173913043478,999,5.42542542542543
887,112,5.50620067643743,5.13392857142857,999,5.46446446446446
885,113,5.53672316384181,5.20353982300885,998,5.49899799599198
887,112,5.46786922209696,5.08035714285714,999,5.42442442442442
885,114,5.46101694915254,5.10526315789474,999,5.42042042042042
884,111,5.40723981900453,5.11711711711712,995,5.3748743718593
878,121,5.41685649202733,5.30578512396694,999,5.4034034034034
885,114,5.43841807909604,5.31578947368421,999,5.42442442442442
882,116,5.47845804988662,5.3448275862069,998,5.46292585170341
887,111,5.46335963923337,5.46846846846847,998,5.46392785571142
886,112,5.41422121896163,5.29464285714286,998,5.40080160320641
885,111,5.41694915254237,5.25225225225225,996,5.39859437751004
888,108,5.40653153153153,5.27777777777778,996,5.3925702811245
890,109,5.37415730337079,5.3302752293578,999,5.36936936936937
890,108,5.40449438202247,5.30555555555556,998,5.3937875751503
892,106,5.3957399103139,5.40566037735849,998,5.39679358717435
895,103,5.42234636871508,5.37864077669903,998,5.41783567134269
888,110,5.37162162162162,5.30909090909091,998,5.36472945891784
886,112,5.36794582392776,5.35714285714286,998,5.36673346693387
885,112,5.41242937853107,5.26785714285714,997,5.39618856569709
881,117,5.40181611804767,5.24786324786325,998,5.38376753507014
875,123,5.43885714285714,5.23577235772358,998,5.41382765531062
871,127,5.45005740528129,5.25196850393701,998,5.4248496993988
877,120,5.41847206385405,5.34166666666667,997,5.40922768304915
880,118,5.42727272727273,5.42372881355932,998,5.42685370741483
877,122,5.41847206385405,5.37704918032787,999,5.41341341341341
880,119,5.4,5.36974789915966,999,5.3963963963964
886,113,5.42212189616253,5.29203539823009,999,5.40740740740741
882,117,5.38888888888889,5.44444444444444,999,5.3953953953954
879,120,5.39249146757679,5.38333333333333,999,5.39139139139139
886,113,5.4334085778781,5.4070796460177,999,5.43043043043043
887,112,5.41600901916573,5.5,999,5.42542542542543
886,112,5.45936794582393,5.41964285714286,998,5.45490981963928
890,109,5.46516853932584,5.19266055045872,999,5.43543543543544
901,98,5.49278579356271,5.10204081632653,999,5.45445445445445
901,97,5.5149833518313,5.16494845360825,998,5.48096192384769
900,99,5.50333333333333,5.05050505050505,999,5.45845845845846
897,101,5.52842809364549,5.00990099009901,998,5.47595190380762
907,92,5.54024255788313,4.97826086956522,999,5.48848848848849
904,95,5.53982300884956,4.85263157894737,999,5.47447447447447
905,94,5.51160220994475,4.84042553191489,999,5.44844844844845
905,93,5.52154696132597,5.02150537634409,998,5.4749498997996
907,92,5.46857772877618,4.93478260869565,999,5.41941941941942
911,88,5.52689352360044,5.19318181818182,999,5.4974974974975
906,91,5.48233995584989,5.27472527472527,997,5.46339017051153
911,88,5.46212952799122,5.375,999,5.45445445445445
910,88,5.45494505494506,5.18181818181818,998,5.43086172344689
910,89,5.43076923076923,5.15730337078652,999,5.40640640640641
907,92,5.40683572216097,5.19565217391304,999,5.38738738738739
903,95,5.43853820598007,5.27368421052632,998,5.42284569138277
912,86,5.47478070175439,5.22093023255814,998,5.45290581162325
913,86,5.50930996714129,5.36046511627907,999,5.4964964964965
916,82,5.48908296943231,5.39024390243902,998,5.48096192384769
921,78,5.48317046688382,5.3974358974359,999,5.47647647647648
917,82,5.4154852780807,5.30487804878049,999,5.40640640640641
917,80,5.36641221374046,5.325,997,5.36308926780341
918,81,5.41938997821351,5.49382716049383,999,5.42542542542543
917,81,5.41221374045802,5.44444444444444,998,5.41482965931864
920,79,5.41413043478261,5.53164556962025,999,5.42342342342342
917,80,5.36205016357688,5.65,997,5.3851554663992
916,82,5.36572052401747,5.68292682926829,998,5.39178356713427
912,86,5.38925438596491,5.53488372093023,998,5.40180360721443
913,86,5.40087623220153,5.34883720930233,999,5.3963963963964
913,83,5.42387732749179,5.30120481927711,996,5.4136546184739
917,80,5.37513631406761,5.3125,997,5.37011033099298
917,80,5.32606324972737,5.4,997,5.33199598796389
907,90,5.31642778390298,5.17777777777778,997,5.30391173520562
912,86,5.38706140350877,5.3953488372093,998,5.3877755511022
913,85,5.37787513691128,5.58823529411765,998,5.39579158316633
914,84,5.34573304157549,5.52380952380952,998,5.36072144288577
916,83,5.29585152838428,5.49397590361446,999,5.31231231231231
917,81,5.29334787350055,5.37037037037037,998,5.29959919839679
921,77,5.32681867535288,5.23376623376623,998,5.31963927855711
926,73,5.3488120950324,5.17808219178082,999,5.33633633633634
926,73,5.37149028077754,5.16438356164384,999,5.35635635635636
924,74,5.36904761904762,5.28378378378378,998,5.3627254509018
916,77,5.33842794759825,5.27272727272727,993,5.33333333333333
920,79,5.35,5.25316455696202,999,5.34234234234234
918,79,5.33660130718954,5.26582278481013,997,5.33099297893681
918,81,5.35511982570806,5.35802469135802,999,5.35535535535536
924,74,5.37770562770563,5.41891891891892,998,5.38076152304609
925,72,5.44864864864865,5.375,997,5.44332998996991
929,70,5.46286329386437,5.34285714285714,999,5.45445445445445
