forward_num,reverse_num,forward_rate,reverse_rate,organism_num,organism_rate
5,5,5.0,5.0,10,5.0
5,4,5.0,5.25,9,5.11111111111111
5,4,5.0,5.25,9,5.11111111111111
6,5,5.33333333333333,5.6,11,5.45454545454545
7,6,5.42857142857143,5.66666666666667,13,5.53846153846154
8,7,5.375,5.57142857142857,15,5.46666666666667
11,9,5.54545454545455,5.88888888888889,20,5.7
12,12,5.83333333333333,5.66666666666667,24,5.75
12,12,5.83333333333333,5.66666666666667,24,5.75
18,18,6.0,5.88888888888889,36,5.94444444444444
18,18,6.0,5.88888888888889,36,5.94444444444444
24,22,5.83333333333333,5.90909090909091,46,5.8695652173913
32,30,6.125,6.2,62,6.16129032258065
36,33,6.0,6.09090909090909,69,6.04347826086957
44,43,6.0,5.93023255813953,87,5.96551724137931
60,59,6.26666666666667,6.22033898305085,119,6.2436974789916
64,59,6.125,6.22033898305085,123,6.17073170731707
88,82,6.0,6.07317073170732,170,6.03529411764706
120,114,6.26666666666667,6.33333333333333,234,6.2991452991453
120,114,6.26666666666667,6.33333333333333,234,6.2991452991453
120,114,6.26666666666667,6.33333333333333,234,6.2991452991453
240,228,6.26666666666667,6.33333333333333,468,6.2991452991453
240,228,6.26666666666667,6.33333333333333,468,6.2991452991453
240,228,6.26666666666667,6.33333333333333,468,6.2991452991453
432,420,6.44444444444444,6.48571428571429,852,6.46478873239437
464,447,6.3448275862069,6.39149888143177,911,6.36772777167947
517,482,6.32301740812379,6.43775933609959,999,6.37837837837838
512,486,6.369140625,6.44855967078189,998,6.40781563126253
511,488,6.34833659491194,6.42008196721311,999,6.38338338338338
506,492,6.3399209486166,6.3739837398374,998,6.35671342685371
511,488,6.36399217221135,6.43237704918033,999,6.3973973973974
514,485,6.33657587548638,6.44123711340206,999,6.38738738738739
510,487,6.36078431372549,6.43121149897331,997,6.39518555667001
518,480,6.35135135135135,6.41666666666667,998,6.38276553106212
513,486,6.35867446393762,6.39917695473251,999,6.37837837837838
523,475,6.38432122370937,6.42105263157895,998,6.40180360721443
533,465,6.3921200750469,6.42365591397849,998,6.40681362725451
536,463,6.40298507462687,6.44492440604752,999,6.42242242242242
543,455,6.42725598526703,6.44395604395604,998,6.43486973947896
548,450,6.4470802919708,6.48222222222222,998,6.46292585170341
544,455,6.45404411764706,6.48351648351648,999,6.46746746746747
544,455,6.45036764705882,6.47692307692308,999,6.46246246246246
549,450,6.47176684881603,6.46444444444444,999,6.46846846846847
546,452,6.47985347985348,6.47345132743363,998,6.47695390781563
540,458,6.4537037037037,6.46288209606987,998,6.45791583166333
540,458,6.46111111111111,6.44978165938865,998,6.45591182364729
538,461,6.46654275092937,6.48156182212581,999,6.47347347347347
535,464,6.46915887850467,6.47844827586207,999,6.47347347347347
536,462,6.46082089552239,6.504329004329,998,6.48096192384769
537,462,6.46741154562384,6.52380952380952,999,6.49349349349349
533,464,6.45966228893058,6.52155172413793,997,6.48846539618857
527,472,6.47248576850095,6.51483050847458,999,6.49249249249249
532,467,6.48308270676692,6.53104925053533,999,6.50550550550551
532,465,6.45112781954887,6.49677419354839,997,6.47241725175527
527,470,6.46869070208729,6.50212765957447,997,6.48445336008024
526,471,6.49239543726236,6.52229299363057,997,6.50651955867603
527,470,6.49525616698292,6.52978723404255,997,6.51153460381143
520,478,6.47307692307692,6.49163179916318,998,6.48196392785571
518,481,6.5,6.53014553014553,999,6.51451451451451
518,480,6.4980694980695,6.56458333333333,998,6.53006012024048
520,479,6.50769230769231,6.57202505219207,999,6.53853853853854
521,477,6.52207293666027,6.57442348008386,998,6.54709418837675
524,474,6.52862595419847,6.58016877637131,998,6.55310621242485
530,468,6.54339622641509,6.59188034188034,998,6.56613226452906
536,460,6.53544776119403,6.60652173913043,996,6.56827309236948
539,460,6.53061224489796,6.61304347826087,999,6.56856856856857
543,456,6.54327808471455,6.60526315789474,999,6.57157157157157
549,450,6.56102003642987,6.61555555555556,999,6.58558558558559
555,442,6.57837837837838,6.61764705882353,997,6.59578736208626
552,446,6.57246376811594,6.60986547085202,998,6.58917835671343
550,449,6.58363636363636,6.62360801781737,999,6.6016016016016
553,446,6.60578661844485,6.63004484304933,999,6.61661661661662
549,450,6.591985428051,6.62666666666667,999,6.60760760760761
547,452,6.58135283363803,6.61504424778761,999,6.5965965965966
543,455,6.58931860036832,6.61758241758242,998,6.60220440881764
548,451,6.61313868613139,6.62527716186253,999,6.61861861861862
546,452,6.61538461538461,6.61283185840708,998,6.61422845691383
555,443,6.59459459459459,6.61625282167043,998,6.60420841683367
553,445,6.60578661844485,6.6247191011236,998,6.61422845691383
549,450,6.60655737704918,6.62,999,6.61261261261261
551,448,6.60617059891107,6.62723214285714,999,6.61561561561562
550,449,6.61272727272727,6.61915367483296,999,6.61561561561562
545,454,6.58165137614679,6.61453744493392,999,6.5965965965966
535,464,6.5981308411215,6.60129310344828,999,6.5995995995996
545,454,6.59816513761468,6.61894273127753,999,6.60760760760761
537,462,6.58100558659218,6.6038961038961,999,6.59159159159159
524,475,6.59541984732824,6.59157894736842,999,6.59359359359359
527,472,6.58823529411765,6.58474576271186,999,6.58658658658659
530,469,6.59056603773585,6.57995735607676,999,6.58558558558559
523,476,6.59847036328872,6.56302521008403,999,6.58158158158158
516,483,6.58333333333333,6.56728778467909,999,6.57557557557558
517,481,6.58027079303675,6.54677754677755,998,6.56412825651303
513,485,6.60038986354776,6.55876288659794,998,6.58016032064128
514,484,6.59727626459144,6.5599173553719,998,6.57915831663327
510,488,6.57450980392157,6.5594262295082,998,6.56713426853707
515,482,6.58446601941748,6.55186721991701,997,6.56870611835507
515,484,6.59611650485437,6.57644628099174,999,6.58658658658659
512,487,6.59765625,6.58932238193018,999,6.59359359359359
521,478,6.59117082533589,6.581589958159,999,6.58658658658659
514,485,6.58365758754864,6.57113402061856,999,6.57757757757758
516,482,6.56395348837209,6.58713692946058,998,6.5751503006012
521,477,6.59117082533589,6.58909853249476,998,6.59018036072144
515,483,6.59611650485437,6.60041407867495,998,6.59819639278557
521,478,6.59309021113244,6.61506276150628,999,6.6036036036036
520,478,6.60384615384615,6.62761506276151,998,6.61523046092184
518,480,6.6003861003861,6.61875,998,6.60921843687375
518,481,6.61196911196911,6.60914760914761,999,6.61061061061061
521,477,6.61036468330134,6.61844863731656,998,6.61422845691383
518,481,6.61389961389961,6.63409563409563,999,6.62362362362362
506,492,6.63636363636364,6.63821138211382,998,6.6372745490982
512,486,6.619140625,6.64197530864198,998,6.63026052104208
515,484,6.61941747572815,6.63842975206612,999,6.62862862862863
519,480,6.64354527938343,6.6375,999,6.64064064064064
511,488,6.65557729941292,6.64754098360656,999,6.65165165165165
512,486,6.654296875,6.64814814814815,998,6.65130260521042
524,475,6.6412213740458,6.65894736842105,999,6.64964964964965
531,467,6.64595103578154,6.66595289079229,998,6.65531062124249
530,468,6.64339622641509,6.66666666666667,998,6.65430861723447
530,469,6.64528301886792,6.66098081023454,999,6.65265265265265
535,464,6.63738317757009,6.67672413793103,999,6.65565565565566
541,456,6.63031423290203,6.68859649122807,997,6.65697091273822
550,449,6.62727272727273,6.68819599109131,999,6.65465465465465
545,453,6.62385321100917,6.69094922737307,998,6.65430861723447
544,454,6.60845588235294,6.69162995594714,998,6.64629258517034
535,463,6.63551401869159,6.69546436285097,998,6.66332665330661
540,457,6.6462962962963,6.70021881838074,997,6.67101303911735
533,465,6.64352720450281,6.70967741935484,998,6.67434869739479
537,460,6.63687150837989,6.71521739130435,997,6.67301905717151
541,458,6.63216266173752,6.71397379912664,999,6.66966966966967
544,455,6.63602941176471,6.70549450549451,999,6.66766766766767
548,451,6.63868613138686,6.70731707317073,999,6.66966966966967
550,449,6.62545454545455,6.68596881959911,999,6.65265265265265
546,453,6.65384615384615,6.6953642384106,999,6.67267267267267
552,444,6.66485507246377,6.70045045045045,996,6.68072289156626
548,450,6.66240875912409,6.69555555555556,998,6.67735470941884
552,447,6.68659420289855,6.69127516778523,999,6.68868868868869
555,444,6.69189189189189,6.69369369369369,999,6.69269269269269
566,431,6.68551236749117,6.7122969837587,997,6.69709127382146
573,426,6.68760907504363,6.7018779342723,999,6.69369369369369
572,427,6.69405594405594,6.72833723653396,999,6.70870870870871
576,421,6.68923611111111,6.73159144893112,997,6.70712136409228
571,428,6.68126094570928,6.73130841121495,999,6.7027027027027
566,433,6.68904593639576,6.7459584295612,999,6.71371371371371
570,429,6.7,6.74358974358974,999,6.71871871871872
571,428,6.70577933450088,6.73831775700935,999,6.71971971971972
573,424,6.70506108202443,6.72877358490566,997,6.71514543630893
576,423,6.70659722222222,6.73522458628842,999,6.71871871871872
583,416,6.70154373927959,6.74519230769231,999,6.71971971971972
582,416,6.70962199312715,6.74278846153846,998,6.72344689378758
572,426,6.72027972027972,6.74178403755869,998,6.72945891783567
564,435,6.72517730496454,6.74252873563218,999,6.73273273273273
562,435,6.72953736654804,6.73563218390805,997,6.73219658976931
564,434,6.73404255319149,6.74193548387097,998,6.7374749498998
565,434,6.74690265486726,6.74423963133641,999,6.74574574574575
561,437,6.74866310160428,6.73684210526316,998,6.7434869739479
557,441,6.73967684021544,6.74149659863946,998,6.74048096192385
554,445,6.76173285198556,6.75280898876404,999,6.75775775775776
553,446,6.76130198915009,6.75784753363229,999,6.75975975975976
553,445,6.75587703435805,6.74831460674157,998,6.75250501002004
547,452,6.76416819012797,6.74557522123894,999,6.75575575575576
558,441,6.77060931899642,6.76190476190476,999,6.76676676676677
553,444,6.78300180831826,6.75675675675676,997,6.77131394182548
546,452,6.77838827838828,6.75221238938053,998,6.76653306613226
542,457,6.78966789667897,6.75054704595186,999,6.77177177177177
548,450,6.78467153284672,6.76,998,6.77354709418838
548,449,6.7956204379562,6.75055679287305,997,6.7753259779338
547,450,6.78793418647166,6.76,997,6.7753259779338
547,450,6.78793418647166,6.76222222222222,997,6.77632898696088
546,453,6.78754578754579,6.77262693156733,999,6.78078078078078
539,460,6.7847866419295,6.77391304347826,999,6.77977977977978
540,458,6.77592592592593,6.76637554585153,998,6.77154308617235
542,456,6.7859778597786,6.75657894736842,998,6.77254509018036
549,449,6.77959927140255,6.76169265033408,998,6.77154308617235
550,448,6.78181818181818,6.75892857142857,998,6.77154308617235
550,449,6.79272727272727,6.77060133630289,999,6.78278278278278
550,449,6.78181818181818,6.77505567928731,999,6.77877877877878
551,448,6.78402903811252,6.79017857142857,999,6.78678678678679
557,442,6.78635547576302,6.789592760181,999,6.78778778778779
561,438,6.7843137254902,6.79452054794521,999,6.78878878878879
566,431,6.78268551236749,6.79118329466357,997,6.78635907723169
567,432,6.79188712522046,6.79398148148148,999,6.79279279279279
573,424,6.79581151832461,6.79481132075472,997,6.79538615847543
567,432,6.79717813051146,6.80324074074074,999,6.7997997997998
571,427,6.80735551663748,6.79391100702576,998,6.80160320641283
568,430,6.81514084507042,6.79302325581395,998,6.80561122244489
566,431,6.81625441696113,6.78422273781903,997,6.802407221665
563,435,6.81172291296625,6.77931034482759,998,6.79759519038076
562,436,6.81672597864769,6.78440366972477,998,6.80260521042084
559,436,6.81574239713775,6.78899082568807,995,6.80402010050251
570,428,6.81929824561403,6.77803738317757,998,6.80160320641283
567,432,6.81481481481481,6.76851851851852,999,6.79479479479479
569,428,6.81722319859403,6.77102803738318,997,6.79739217652959
573,426,6.79930191972077,6.76995305164319,999,6.78678678678679
564,433,6.79609929078014,6.77367205542725,997,6.78635907723169
565,433,6.8,6.76905311778291,998,6.78657314629258
564,435,6.81914893617021,6.7632183908046,999,6.79479479479479
551,446,6.82577132486388,6.76233183856502,997,6.79739217652959
553,445,6.81012658227848,6.75730337078652,998,6.78657314629258
554,444,6.81768953068592,6.7545045045045,998,6.78957915831663
559,440,6.82289803220036,6.74318181818182,999,6.78778778778779
561,438,6.83778966131907,6.74429223744292,999,6.7967967967968
572,427,6.8479020979021,6.75175644028103,999,6.80680680680681
573,426,6.83944153577661,6.75821596244131,999,6.8048048048048
576,423,6.83680555555556,6.74940898345154,999,6.7997997997998
578,420,6.83217993079585,6.77142857142857,998,6.80661322645291
575,424,6.83478260869565,6.77122641509434,999,6.80780780780781
587,411,6.83134582623509,6.76885644768856,998,6.80561122244489
586,411,6.82252559726962,6.76885644768856,997,6.80040120361083
589,410,6.83191850594227,6.77804878048781,999,6.80980980980981
591,408,6.83587140439932,6.76960784313725,999,6.80880880880881
584,415,6.85445205479452,6.76626506024096,999,6.81781781781782
576,422,6.85763888888889,6.77962085308057,998,6.82464929859719
581,418,6.8605851979346,6.78947368421053,999,6.83083083083083
582,417,6.86426116838488,6.76978417266187,999,6.82482482482482
574,425,6.87108013937282,6.76941176470588,999,6.82782782782783
573,426,6.8760907504363,6.77464788732394,999,6.83283283283283
571,427,6.87565674255692,6.77985948477752,998,6.83466933867735
573,426,6.8848167539267,6.77230046948357,999,6.83683683683684
576,422,6.88888888888889,6.77488151658768,998,6.84068136272545
570,429,6.89122807017544,6.78321678321678,999,6.84484484484484
575,423,6.88347826086957,6.79432624113475,998,6.84569138276553
582,417,6.88316151202749,6.79376498800959,999,6.84584584584585
579,419,6.88773747841105,6.80668257756563,998,6.85370741482966
578,421,6.89100346020761,6.80285035629454,999,6.85385385385385
576,422,6.90451388888889,6.79857819905213,998,6.85971943887776
577,421,6.90641247833622,6.81235154394299,998,6.86673346693387
574,425,6.91463414634146,6.82117647058824,999,6.87487487487487
577,422,6.91334488734835,6.83175355450237,999,6.87887887887888
571,427,6.92119089316988,6.82903981264637,998,6.88176352705411
573,426,6.91623036649215,6.83098591549296,999,6.87987987987988
576,423,6.91145833333333,6.83451536643026,999,6.87887887887888
572,427,6.91083916083916,6.83372365339578,999,6.87787787787788
574,424,6.91463414634146,6.83490566037736,998,6.88076152304609
578,419,6.91522491349481,6.83293556085919,997,6.88064192577733
581,417,6.91910499139415,6.81534772182254,998,6.87575150300601
581,417,6.91910499139415,6.83453237410072,998,6.88376753507014
585,414,6.92136752136752,6.85265700483092,999,6.89289289289289
585,412,6.91794871794872,6.84466019417476,997,6.8876629889669
592,406,6.92060810810811,6.8423645320197,998,6.88877755511022
589,410,6.92529711375212,6.84390243902439,999,6.89189189189189
598,401,6.92642140468227,6.86284289276808,999,6.9009009009009
598,401,6.92976588628763,6.84538653366584,999,6.8958958958959
601,397,6.93677204658902,6.83375314861461,998,6.89579158316633
596,400,6.93959731543624,6.84,996,6.8995983935743
595,403,6.94117647058824,6.8287841191067,998,6.89579158316633
586,413,6.94027303754266,6.82808716707022,999,6.89389389389389
586,413,6.94709897610922,6.83535108958838,999,6.9009009009009
585,414,6.95042735042735,6.83816425120773,999,6.9039039039039
578,419,6.95155709342561,6.81861575178998,997,6.89568706118355
582,417,6.95017182130584,6.82973621103118,999,6.8998998998999
595,404,6.94621848739496,6.83415841584158,999,6.9009009009009
582,416,6.94329896907217,6.82932692307692,998,6.89579158316633
583,416,6.94854202401372,6.82211538461539,999,6.8958958958959
595,403,6.94453781512605,6.82382133995037,998,6.89579158316633
586,412,6.9419795221843,6.83980582524272,998,6.8997995991984
590,408,6.95084745762712,6.83333333333333,998,6.90280561122244
594,405,6.94781144781145,6.84197530864198,999,6.9049049049049
589,410,6.94736842105263,6.84878048780488,999,6.90690690690691
582,417,6.95017182130584,6.83693045563549,999,6.9029029029029
582,417,6.94845360824742,6.84172661870504,999,6.9039039039039
578,419,6.94809688581315,6.85441527446301,997,6.90872617853561
577,422,6.94800693240901,6.85071090047393,999,6.90690690690691
570,427,6.95438596491228,6.84543325526932,997,6.90772316950853
577,422,6.95840554592721,6.8436018957346,999,6.90990990990991
591,408,6.95600676818951,6.8578431372549,999,6.91591591591592
579,420,6.95682210708117,6.84285714285714,999,6.90890890890891
576,422,6.96006944444444,6.8436018957346,998,6.91082164328657
582,417,6.95704467353952,6.8537170263789,999,6.91391391391391
573,426,6.95113438045375,6.85915492957746,999,6.91191191191191
575,424,6.95304347826087,6.85141509433962,999,6.90990990990991
571,428,6.95446584938704,6.84579439252336,999,6.90790790790791
565,434,6.94513274336283,6.85023041474654,999,6.9039039039039
564,434,6.9468085106383,6.84331797235023,998,6.90180360721443
568,430,6.94894366197183,6.84418604651163,998,6.90380761523046
574,423,6.94947735191638,6.85342789598109,997,6.90872617853561
582,416,6.94845360824742,6.85576923076923,998,6.90981963927856
592,407,6.95439189189189,6.85749385749386,999,6.91491491491491
582,417,6.95360824742268,6.8537170263789,999,6.91191191191191
587,411,6.95229982964225,6.84914841849148,998,6.90981963927856
592,407,6.95608108108108,6.84766584766585,999,6.91191191191191
584,414,6.95547945205479,6.85507246376812,998,6.91382765531062
587,407,6.95229982964225,6.84766584766585,994,6.90945674044266
590,409,6.95084745762712,6.83863080684597,999,6.9049049049049
589,410,6.9490662139219,6.83658536585366,999,6.9029029029029
595,404,6.94789915966387,6.82425742574257,999,6.8978978978979
600,398,6.94333333333333,6.82914572864322,998,6.89779559118236
597,400,6.94472361809045,6.8275,997,6.89769307923771
607,392,6.94233937397035,6.8265306122449,999,6.8968968968969
604,393,6.94205298013245,6.82188295165394,997,6.89468405215647
590,409,6.94406779661017,6.81662591687042,999,6.89189189189189
599,398,6.9449081803005,6.80653266331658,997,6.88966900702106
604,393,6.94370860927152,6.80661577608142,997,6.88966900702106
605,394,6.94214876033058,6.80456852791878,999,6.88788788788789
604,395,6.94370860927152,6.8,999,6.88688688688689
606,393,6.94554455445545,6.79389312977099,999,6.88588588588589
619,378,6.94668820678514,6.7989417989418,997,6.89067201604814
627,372,6.94736842105263,6.8010752688172,999,6.89289289289289
634,365,6.94479495268139,6.7972602739726,999,6.89089089089089
625,373,6.9392,6.78552278820375,998,6.88176352705411
621,377,6.94202898550725,6.78514588859416,998,6.88276553106212
619,378,6.94345718901454,6.79365079365079,997,6.88665997993982
625,374,6.9424,6.78877005347594,999,6.88488488488488
616,381,6.94155844155844,6.79527559055118,997,6.88565697091274
635,364,6.94173228346457,6.7967032967033,999,6.88888888888889
626,373,6.93929712460064,6.80697050938338,999,6.88988988988989
626,371,6.93290734824281,6.79514824797844,997,6.88164493480441
636,363,6.93553459119497,6.80440771349862,999,6.88788788788789
632,367,6.93354430379747,6.81198910081744,999,6.88888888888889
631,368,6.93026941362916,6.80163043478261,999,6.88288288288288
633,366,6.92733017377567,6.79508196721311,999,6.87887887887888
631,368,6.93185419968304,6.80163043478261,999,6.88388388388388
643,355,6.93157076205288,6.79718309859155,998,6.88376753507014
645,352,6.92558139534884,6.79545454545455,997,6.87963891675025
642,355,6.92523364485981,6.8056338028169,997,6.88264794383149
648,348,6.9212962962963,6.81034482758621,996,6.88253012048193
649,350,6.92295839753467,6.81714285714286,999,6.88588588588589
644,355,6.91770186335404,6.82253521126761,999,6.88388388388388
649,349,6.92295839753467,6.81948424068768,998,6.88677354709419
640,359,6.921875,6.80222841225627,999,6.87887887887888
637,360,6.92307692307692,6.81111111111111,997,6.88264794383149
643,356,6.93623639191291,6.79775280898876,999,6.88688688688689
625,372,6.9392,6.8010752688172,997,6.8876629889669
631,367,6.93502377179081,6.80653950953679,998,6.8877755511022
636,363,6.93710691823899,6.81267217630854,999,6.89189189189189
628,370,6.93949044585987,6.82162162162162,998,6.89579158316633
636,362,6.93238993710692,6.82872928176796,998,6.89478957915832
638,361,6.93573667711599,6.83102493074792,999,6.8978978978979
644,355,6.94099378881988,6.82253521126761,999,6.8988988988989
642,356,6.94236760124611,6.81460674157303,998,6.89679358717435
649,349,6.93374422187981,6.810888252149,998,6.89078156312625
644,353,6.9332298136646,6.80169971671388,997,6.88665997993982
641,357,6.93603744149766,6.78151260504202,998,6.88076152304609
646,352,6.92569659442724,6.78977272727273,998,6.87775551102204
653,346,6.9249617151608,6.80057803468208,999,6.88188188188188
659,340,6.92716236722307,6.79705882352941,999,6.88288288288288
660,339,6.92575757575758,6.8023598820059,999,6.88388388388388
660,339,6.93787878787879,6.79646017699115,999,6.88988988988989
665,334,6.93834586466165,6.80239520958084,999,6.89289289289289
660,336,6.94090909090909,6.80357142857143,996,6.89457831325301
660,339,6.93636363636364,6.81120943952802,999,6.89389389389389
662,336,6.94259818731118,6.82142857142857,998,6.90180360721443
655,343,6.94351145038168,6.8134110787172,998,6.89879759519038
654,345,6.9388379204893,6.81449275362319,999,6.8958958958959
664,335,6.93975903614458,6.81791044776119,999,6.8988988988989
651,344,6.94470046082949,6.82558139534884,995,6.9035175879397
653,346,6.94333843797856,6.82658959537572,999,6.9029029029029
657,342,6.94063926940639,6.84210526315789,999,6.90690690690691
655,344,6.94045801526718,6.83720930232558,999,6.9049049049049
651,347,6.94162826420891,6.82420749279539,998,6.90080160320641
644,354,6.9472049689441,6.83333333333333,998,6.90681362725451
645,353,6.94418604651163,6.84419263456091,998,6.90881763527054
646,353,6.95046439628483,6.8271954674221,999,6.90690690690691
646,353,6.94891640866873,6.8328611898017,999,6.90790790790791
652,347,6.94938650306749,6.8328530259366,999,6.90890890890891
657,341,6.9482496194825,6.84457478005865,998,6.91282565130261
650,346,6.95230769230769,6.84682080924855,996,6.91566265060241
656,343,6.94817073170732,6.84839650145773,999,6.91391391391391
654,343,6.94954128440367,6.84839650145773,997,6.91474423269809
658,341,6.95136778115502,6.83284457478006,999,6.91091091091091
654,345,6.95565749235474,6.84057971014493,999,6.91591591591592
648,349,6.9537037037037,6.85959885386819,997,6.92076228686058
648,350,6.9537037037037,6.84571428571429,998,6.91583166332665
648,351,6.9537037037037,6.84330484330484,999,6.91491491491491
647,351,6.95208655332303,6.84900284900285,998,6.91583166332665
648,351,6.95679012345679,6.84900284900285,999,6.91891891891892
638,361,6.96081504702194,6.85318559556787,999,6.92192192192192
629,370,6.96184419713831,6.85675675675676,999,6.92292292292292
635,364,6.95590551181102,6.8543956043956,999,6.91891891891892
624,374,6.95512820512821,6.85828877005348,998,6.9188376753507
631,368,6.95245641838352,6.86141304347826,999,6.91891891891892
634,365,6.95110410094637,6.86027397260274,999,6.91791791791792
627,369,6.94736842105263,6.86720867208672,996,6.91767068273092
629,369,6.95389507154213,6.87262872628726,998,6.92384769539078
636,363,6.95440251572327,6.87603305785124,999,6.92592592592593
615,384,6.95609756097561,6.875,999,6.92492492492492
617,381,6.96110210696921,6.86876640419947,998,6.92585170340681
628,369,6.96337579617834,6.86991869918699,997,6.92878635907723
615,384,6.96422764227642,6.8671875,999,6.92692692692693
622,377,6.96302250803859,6.85676392572944,999,6.92292292292292
631,368,6.9635499207607,6.86413043478261,999,6.92692692692693
640,359,6.965625,6.86350974930362,999,6.92892892892893
640,359,6.9625,6.84401114206128,999,6.91991991991992
641,358,6.96255850234009,6.83798882681564,999,6.91791791791792
637,362,6.96703296703297,6.85359116022099,999,6.92592592592593
641,357,6.96723868954758,6.84593837535014,998,6.92384769539078
644,354,6.96894409937888,6.8361581920904,998,6.92184368737475
638,358,6.97021943573668,6.84916201117318,996,6.92670682730924
640,358,6.971875,6.84078212290503,998,6.9248496993988
638,360,6.97648902821317,6.84166666666667,998,6.92785571142285
646,353,6.97368421052632,6.84985835694051,999,6.92992992992993
640,359,6.975,6.85515320334262,999,6.93193193193193
635,361,6.97322834645669,6.84487534626039,996,6.92670682730924
637,361,6.97802197802198,6.85872576177285,998,6.93486973947896
637,361,6.97331240188383,6.85872576177285,998,6.93186372745491
641,358,6.97347893915757,6.86033519553073,999,6.93293293293293
645,354,6.97519379844961,6.85028248587571,999,6.93093093093093
641,357,6.97347893915757,6.86834733893557,998,6.93587174348697
640,357,6.9765625,6.87394957983193,997,6.93981945837513
643,356,6.9751166407465,6.87640449438202,999,6.93993993993994
636,362,6.97641509433962,6.87292817679558,998,6.93887775551102
628,371,6.97770700636943,6.88409703504043,999,6.94294294294294
628,371,6.98089171974522,6.87870619946092,999,6.94294294294294
629,370,6.98092209856916,6.87567567567568,999,6.94194194194194
623,376,6.97752808988764,6.86436170212766,999,6.93493493493493
626,372,6.97923322683706,6.86827956989247,998,6.93787575150301
624,374,6.97916666666667,6.86096256684492,998,6.93486973947896
620,379,6.97903225806452,6.86807387862797,999,6.93693693693694
626,372,6.9776357827476,6.86827956989247,998,6.93687374749499
622,377,6.97909967845659,6.86206896551724,999,6.93493493493493
621,378,6.97745571658615,6.87037037037037,999,6.93693693693694
620,377,6.97741935483871,6.86737400530504,997,6.9358074222668
619,379,6.97576736672052,6.86543535620053,998,6.93386773547094
615,383,6.97560975609756,6.86161879895561,998,6.93186372745491
621,377,6.97423510466989,6.86737400530504,998,6.93386773547094
627,372,6.97607655502392,6.87365591397849,999,6.93793793793794
625,372,6.9776,6.86559139784946,997,6.9358074222668
629,369,6.97774244833068,6.88075880758808,998,6.94188376753507
631,366,6.97464342313788,6.88251366120219,997,6.94082246740221
635,363,6.97637795275591,6.87603305785124,998,6.93987975951904
641,358,6.97815912636505,6.87150837988827,999,6.93993993993994
633,366,6.97946287519747,6.87431693989071,999,6.94094094094094
648,349,6.97685185185185,6.88252148997135,997,6.94383149448345
651,347,6.97695852534562,6.88472622478386,998,6.94488977955912
653,346,6.97856049004594,6.88728323699422,999,6.94694694694695
656,343,6.97256097560976,6.88046647230321,999,6.94094094094094
650,349,6.97384615384615,6.88538681948424,999,6.94294294294294
656,343,6.97408536585366,6.88629737609329,999,6.94394394394394
651,348,6.97081413210445,6.89080459770115,999,6.94294294294294
643,354,6.96889580093313,6.88983050847458,997,6.94082246740221
633,366,6.96998420221169,6.89344262295082,999,6.94194194194194
634,364,6.97003154574132,6.8956043956044,998,6.94288577154309
632,367,6.97151898734177,6.90190735694823,999,6.94594594594595
623,375,6.97110754414125,6.89866666666667,998,6.9438877755511
623,375,6.96950240770466,6.90133333333333,998,6.9438877755511
633,365,6.96998420221169,6.8986301369863,998,6.9438877755511
633,364,6.97156398104265,6.89835164835165,997,6.94483450351053
642,357,6.97040498442368,6.89635854341737,999,6.94394394394394
643,356,6.96734059097978,6.8876404494382,999,6.93893893893894
645,354,6.96744186046512,6.88700564971751,999,6.93893893893894
646,352,6.96594427244582,6.87784090909091,998,6.93486973947896
644,355,6.96583850931677,6.87323943661972,999,6.93293293293293
649,350,6.96302003081664,6.87428571428571,999,6.93193193193193
652,347,6.96779141104294,6.87896253602305,999,6.93693693693694
657,340,6.96499238964992,6.88529411764706,997,6.93781344032096
661,337,6.96217851739788,6.88427299703264,998,6.93587174348697
665,333,6.96541353383459,6.88288288288288,998,6.93787575150301
669,330,6.95814648729447,6.88484848484848,999,6.93393393393393
661,338,6.95763993948563,6.88165680473373,999,6.93193193193193
667,331,6.95802098950525,6.87311178247734,998,6.92985971943888
676,321,6.9585798816568,6.87227414330218,997,6.93079237713139
670,328,6.95373134328358,6.88109756097561,998,6.92985971943888
676,323,6.95414201183432,6.88235294117647,999,6.93093093093093
681,318,6.94860499265786,6.87735849056604,999,6.92592592592593
675,323,6.94666666666667,6.87616099071207,998,6.92384769539078
682,317,6.94574780058651,6.86750788643533,999,6.92092092092092
669,330,6.94768310911809,6.86363636363636,999,6.91991991991992
661,335,6.94704992435704,6.88358208955224,996,6.92570281124498
658,341,6.94528875379939,6.87390029325513,999,6.92092092092092
655,343,6.94503816793893,6.87463556851312,998,6.92084168336673
655,342,6.94809160305344,6.87134502923977,997,6.92176529588766
658,341,6.95136778115502,6.87096774193548,999,6.92392392392392
656,342,6.94817073170732,6.86842105263158,998,6.92084168336673
658,341,6.95288753799392,6.87976539589443,999,6.92792792792793
656,343,6.95579268292683,6.87755102040816,999,6.92892892892893
648,350,6.95216049382716,6.88857142857143,998,6.92985971943888
643,351,6.95800933125972,6.8974358974359,994,6.93661971830986
644,355,6.95652173913043,6.89859154929577,999,6.93593593593594
643,355,6.95645412130638,6.89577464788732,998,6.93486973947896
636,362,6.96069182389937,6.89226519337017,998,6.93587174348697
649,350,6.95685670261941,6.90285714285714,999,6.93793793793794
654,345,6.95718654434251,6.91014492753623,999,6.94094094094094
658,339,6.95440729483283,6.90855457227139,997,6.93881644934804
663,336,6.95324283559578,6.90773809523809,999,6.93793793793794
657,342,6.95281582952816,6.9093567251462,999,6.93793793793794
662,337,6.94712990936556,6.90504451038576,999,6.93293293293293
650,349,6.94923076923077,6.89684813753582,999,6.93093093093093
645,350,6.95193798449612,6.9,995,6.93366834170854
647,352,6.95208655332303,6.89204545454545,999,6.93093093093093
641,356,6.95475819032761,6.89887640449438,997,6.93480441323972
639,357,6.95305164319249,6.9187675070028,996,6.94076305220884
652,345,6.95245398773006,6.92173913043478,997,6.94182547642929
648,350,6.9537037037037,6.92,998,6.94188376753507
637,361,6.95761381475667,6.9196675900277,998,6.9438877755511
648,348,6.95679012345679,6.92241379310345,996,6.94477911646586
649,349,6.95223420647149,6.92550143266476,998,6.94288577154309
641,357,6.95475819032761,6.92717086834734,998,6.94488977955912
644,355,6.95962732919255,6.93239436619718,999,6.94994994994995
644,355,6.95341614906832,6.92957746478873,999,6.94494494494494
635,363,6.95748031496063,6.93112947658402,998,6.94789579158317
637,362,6.95918367346939,6.92541436464088,999,6.94694694694695
642,355,6.9595015576324,6.92957746478873,997,6.94884653961886
648,351,6.9537037037037,6.92022792022792,999,6.94194194194194
645,353,6.95193798449612,6.92634560906516,998,6.94288577154309
644,353,6.95031055900621,6.92917847025496,997,6.94282848545637
651,347,6.94623655913978,6.92795389048991,998,6.93987975951904
641,357,6.94227769110764,6.92156862745098,998,6.93486973947896
642,357,6.94236760124611,6.92717086834734,999,6.93693693693694
634,365,6.94321766561514,6.92602739726027,999,6.93693693693694
622,377,6.94372990353698,6.92572944297082,999,6.93693693693694
630,368,6.94126984126984,6.92663043478261,998,6.93587174348697
628,369,6.94267515923567,6.93224932249322,997,6.93881644934804
618,380,6.94498381877023,6.92368421052632,998,6.93687374749499
627,371,6.94577352472089,6.91913746630728,998,6.93587174348697
628,371,6.94426751592357,6.92183288409703,999,6.93593593593594
624,372,6.94070512820513,6.90860215053763,996,6.92871485943775
631,368,6.93977812995246,6.91576086956522,999,6.93093093093093
632,366,6.93829113924051,6.91803278688525,998,6.93086172344689
635,364,6.94015748031496,6.90934065934066,999,6.92892892892893
642,357,6.94080996884735,6.90756302521008,999,6.92892892892893
645,354,6.93488372093023,6.90112994350283,999,6.92292292292292
649,349,6.93528505392912,6.9054441260745,998,6.9248496993988
652,346,6.93711656441718,6.90173410404624,998,6.9248496993988
651,348,6.93855606758833,6.89080459770115,999,6.92192192192192
659,339,6.93474962063733,6.89970501474926,998,6.92284569138277
661,336,6.93797276853253,6.89880952380952,997,6.92477432296891
659,340,6.93930197268589,6.89705882352941,999,6.92492492492492
663,334,6.94117647058824,6.88922155688623,997,6.92377131394183
664,335,6.94578313253012,6.89253731343284,999,6.92792792792793
662,336,6.94864048338369,6.89285714285714,998,6.92985971943888
662,337,6.94864048338369,6.88427299703264,999,6.92692692692693
661,336,6.94251134644478,6.88988095238095,997,6.92477432296891
650,348,6.94307692307692,6.88505747126437,998,6.92284569138277
653,344,6.93874425727412,6.88953488372093,997,6.92176529588766
653,346,6.93721286370597,6.88150289017341,999,6.91791791791792
657,342,6.94063926940639,6.88011695906433,999,6.91991991991992
658,339,6.94072948328267,6.87905604719764,997,6.9197592778335
657,342,6.93911719939117,6.87719298245614,999,6.91791791791792
658,340,6.94072948328267,6.87647058823529,998,6.9188376753507
658,340,6.94072948328267,6.88235294117647,998,6.92084168336673
673,325,6.94353640416048,6.87384615384615,998,6.92084168336673
673,326,6.94353640416048,6.87116564417178,999,6.91991991991992
669,329,6.94768310911809,6.8693009118541,998,6.92184368737475
664,333,6.94728915662651,6.88288288288288,997,6.92577733199599
670,328,6.94626865671642,6.88109756097561,998,6.9248496993988
676,323,6.95118343195266,6.88544891640867,999,6.92992992992993
674,325,6.95103857566766,6.90153846153846,999,6.93493493493493
666,333,6.95045045045045,6.9039039039039,999,6.93493493493493
666,333,6.94894894894895,6.9039039039039,999,6.93393393393393
670,329,6.94328358208955,6.90577507598784,999,6.93093093093093
666,333,6.94144144144144,6.9039039039039,999,6.92892892892893
656,343,6.94512195121951,6.90379008746356,999,6.93093093093093
656,342,6.94359756097561,6.90643274853801,998,6.93086172344689
656,343,6.9375,6.91253644314869,999,6.92892892892893
663,335,6.93514328808446,6.9134328358209,998,6.92785571142285
658,339,6.93768996960486,6.92330383480826,997,6.93279839518556
659,340,6.93626707132018,6.92647058823529,999,6.93293293293293
665,333,6.93684210526316,6.92192192192192,998,6.93186372745491
668,331,6.94161676646707,6.91842900302115,999,6.93393393393393
667,331,6.9400299850075,6.91842900302115,998,6.93286573146293
664,334,6.94427710843374,6.91017964071856,998,6.93286573146293
668,331,6.94011976047904,6.9214501510574,999,6.93393393393393
657,341,6.94520547945205,6.91495601173021,998,6.93486973947896
665,333,6.94135338345865,6.91591591591592,998,6.93286573146293
666,332,6.93993993993994,6.91265060240964,998,6.93086172344689
657,341,6.94063926940639,6.91202346041056,998,6.93086172344689
664,335,6.94427710843374,6.91641791044776,999,6.93493493493493
657,341,6.94368340943683,6.91495601173021,998,6.93386773547094
651,348,6.9431643625192,6.91091954022988,999,6.93193193193193
648,351,6.95061728395062,6.91168091168091,999,6.93693693693694
657,342,6.9482496194825,6.91520467836257,999,6.93693693693694
650,347,6.95076923076923,6.9193083573487,997,6.93981945837513
650,349,6.95076923076923,6.92263610315186,999,6.94094094094094
668,330,6.95059880239521,6.92727272727273,998,6.94288577154309
666,333,6.95045045045045,6.92192192192192,999,6.94094094094094
666,332,6.95495495495495,6.91566265060241,998,6.94188376753507
684,315,6.95760233918129,6.92063492063492,999,6.94594594594595
687,312,6.95196506550218,6.92307692307692,999,6.94294294294294
681,317,6.95007342143906,6.9211356466877,998,6.94088176352705
689,308,6.95210449927431,6.92207792207792,997,6.94282848545637
688,311,6.94622093023256,6.91961414790997,999,6.93793793793794
686,313,6.95189504373178,6.92332268370607,999,6.94294294294294
689,310,6.95791001451379,6.9258064516129,999,6.94794794794795
692,307,6.95809248554913,6.92833876221498,999,6.94894894894895
686,312,6.95626822157434,6.92307692307692,998,6.94589178356713
679,320,6.95876288659794,6.925,999,6.94794794794795
683,315,6.96632503660322,6.92063492063492,998,6.95190380761523
681,318,6.96182085168869,6.92138364779874,999,6.94894894894895
674,323,6.97181008902077,6.92879256965944,997,6.95787362086259
673,325,6.97325408618128,6.92923076923077,998,6.95891783567134
666,333,6.96996996996997,6.92792792792793,999,6.95595595595596
669,328,6.97608370702541,6.92073170731707,997,6.95787362086259
674,325,6.97477744807122,6.92307692307692,999,6.95795795795796
667,331,6.97151424287856,6.92447129909366,998,6.95591182364729
668,331,6.97305389221557,6.91842900302115,999,6.95495495495495
673,325,6.97622585438336,6.91692307692308,998,6.95691382765531
672,327,6.97619047619048,6.92966360856269,999,6.96096096096096
676,323,6.9792899408284,6.92879256965944,999,6.96296296296296
666,333,6.97897897897898,6.92192192192192,999,6.95995995995996
672,327,6.97916666666667,6.93272171253823,999,6.96396396396396
677,320,6.97932053175775,6.928125,997,6.96288866599799
676,322,6.98076923076923,6.91614906832298,998,6.95991983967936
671,326,6.97764530551416,6.92944785276074,997,6.96188565697091
672,326,6.98065476190476,6.93251533742331,998,6.96492985971944
669,329,6.98056801195815,6.92705167173252,998,6.96292585170341
672,327,6.98065476190476,6.92660550458716,999,6.96296296296296
665,333,6.97894736842105,6.92792792792793,998,6.96192384769539
660,339,6.97727272727273,6.92330383480826,999,6.95895895895896
662,336,6.9833836858006,6.91369047619048,998,6.95991983967936
659,339,6.98179059180577,6.91445427728614,998,6.95891783567134
668,331,6.98502994011976,6.91842900302115,999,6.96296296296296
669,330,6.98505231689088,6.90909090909091,999,6.95995995995996
679,319,6.98232695139912,6.90909090909091,998,6.95891783567134
680,318,6.98235294117647,6.90566037735849,998,6.95791583166333
678,318,6.98082595870206,6.88993710691824,996,6.95180722891566
676,323,6.98076923076923,6.88854489164087,999,6.95095095095095
669,325,6.98056801195815,6.89538461538462,994,6.95271629778672
668,329,6.98203592814371,6.8936170212766,997,6.95285857572718
657,342,6.98325722983257,6.87719298245614,999,6.94694694694695
653,344,6.98315467075038,6.87790697674419,997,6.94684052156469
653,345,6.98315467075038,6.88985507246377,998,6.95090180360721
644,353,6.98447204968944,6.88101983002833,997,6.94784353059178
644,354,6.9860248447205,6.88135593220339,998,6.94889779559118
643,354,6.98444790046656,6.88418079096045,997,6.94884653961886
652,347,6.98466257668712,6.88472622478386,999,6.94994994994995
641,358,6.98595943837754,6.87430167597765,999,6.94594594594595
633,364,6.98578199052133,6.87912087912088,997,6.94684052156469
644,353,6.9860248447205,6.89518413597734,997,6.95386158475426
637,361,6.98744113029827,6.89196675900277,998,6.95290581162325
631,365,6.98890649762282,6.88767123287671,996,6.95180722891566
647,350,6.98454404945904,6.88285714285714,997,6.94884653961886
641,357,6.98439937597504,6.87955182072829,998,6.94689378757515
634,365,6.98738170347003,6.87945205479452,999,6.94794794794795
644,354,6.99068322981366,6.88700564971751,998,6.95390781563126
643,356,6.99066874027994,6.89325842696629,999,6.95595595595596
642,357,6.99221183800623,6.88235294117647,999,6.95295295295295
647,352,6.99227202472952,6.88352272727273,999,6.95395395395395
627,372,6.98883572567783,6.88978494623656,999,6.95195195195195
634,363,6.99053627760252,6.88154269972452,997,6.95085255767302
637,362,6.99058084772371,6.88397790055249,999,6.95195195195195
630,368,6.98888888888889,6.87771739130435,998,6.94789579158317
637,362,6.98744113029827,6.87845303867403,999,6.94794794794795
630,368,6.98730158730159,6.88586956521739,998,6.9498997995992
623,374,6.98876404494382,6.8903743315508,997,6.9518555667001
626,372,6.98722044728435,6.9005376344086,998,6.95490981963928
630,369,6.98888888888889,6.8970189701897,999,6.95495495495495
621,377,6.98872785829308,6.89655172413793,998,6.95390781563126
614,383,6.9885993485342,6.89817232375979,997,6.95386158475426
608,390,6.98848684210526,6.8948717948718,998,6.95190380761523
616,382,6.98863636363636,6.88219895287958,998,6.94789579158317
618,381,6.98867313915858,6.88451443569554,999,6.94894894894895
617,382,6.9870340356564,6.89267015706806,999,6.95095095095095
622,377,6.98713826366559,6.88328912466844,999,6.94794794794795
620,379,6.98709677419355,6.89182058047493,999,6.95095095095095
623,375,6.98394863563403,6.888,998,6.94789579158317
619,380,6.98222940226171,6.88684210526316,999,6.94594594594595
612,387,6.98202614379085,6.88372093023256,999,6.94394394394394
606,392,6.98349834983498,6.88265306122449,998,6.9438877755511
611,388,6.98363338788871,6.89175257731959,999,6.94794794794795
620,379,6.98225806451613,6.89445910290237,999,6.94894894894895
614,385,6.98208469055375,6.89090909090909,999,6.94694694694695
617,381,6.98217179902755,6.89238845144357,998,6.94789579158317
623,376,6.98394863563403,6.90159574468085,999,6.95295295295295
618,380,6.98705501618123,6.89210526315789,998,6.95090180360721
621,378,6.98389694041868,6.90476190476191,999,6.95395395395395
629,370,6.98410174880763,6.90540540540541,999,6.95495495495495
631,366,6.98732171156894,6.9016393442623,997,6.95586760280842
642,357,6.98442367601246,6.90196078431373,999,6.95495495495495
643,356,6.98133748055988,6.90168539325843,999,6.95295295295295
639,358,6.98278560250391,6.90223463687151,997,6.95386158475426
630,369,6.98253968253968,6.90243902439024,999,6.95295295295295
641,358,6.98595943837754,6.91061452513966,999,6.95895895895896
633,364,6.98736176935229,6.91208791208791,997,6.95987963891675
634,365,6.99053627760252,6.91506849315068,999,6.96296296296296
631,368,6.99207606973059,6.90489130434783,999,6.95995995995996
626,371,6.99041533546326,6.90026954177898,997,6.95687061183551
632,362,6.99050632911392,6.9060773480663,994,6.95975855130785
633,366,6.99052132701422,6.90983606557377,999,6.96096096096096
631,368,6.98732171156894,6.90760869565217,999,6.95795795795796
622,375,6.98713826366559,6.904,997,6.95586760280842
621,376,6.98711755233494,6.90691489361702,997,6.95687061183551
614,384,6.9885993485342,6.90104166666667,998,6.95490981963928
616,382,6.98863636363636,6.90837696335079,998,6.95791583166333
618,380,6.98867313915858,6.90789473684211,998,6.95791583166333
622,377,6.9903536977492,6.90981432360743,999,6.95995995995996
627,370,6.99362041467305,6.90540540540541,997,6.96088264794383
625,374,6.9936,6.90374331550802,999,6.95995995995996
622,376,6.9935691318328,6.91755319148936,998,6.96492985971944
628,371,6.99363057324841,6.91374663072776,999,6.96396396396396
619,379,6.9967689822294,6.92348284960422,998,6.9689378757515
620,379,6.99677419354839,6.92084432717678,999,6.96796796796797
613,386,6.99673735725938,6.9300518134715,999,6.97097097097097
608,391,6.99671052631579,6.93606138107417,999,6.97297297297297
611,388,6.99672667757774,6.92268041237113,999,6.96796796796797
612,386,6.99673202614379,6.92746113989637,998,6.96993987975952
607,391,6.99835255354201,6.92838874680307,998,6.97094188376754
605,394,6.99834710743802,6.91878172588832,999,6.96696696696697
603,395,7.0,6.92911392405063,998,6.97194388777555
596,403,7.0,6.93300248138958,999,6.97297297297297
602,396,7.0,6.93686868686869,998,6.9749498997996
605,394,7.0,6.93401015228426,999,6.97397397397397
601,398,7.0,6.9321608040201,999,6.97297297297297
606,393,7.0,6.92875318066158,999,6.97197197197197
603,395,7.0,6.91898734177215,998,6.96793587174349
590,407,7.0,6.92383292383292,997,6.96890672016048
594,405,7.0,6.91851851851852,999,6.96696696696697
596,403,7.0,6.91315136476427,999,6.96496496496496
590,409,7.0,6.91687041564792,999,6.96596596596597
595,403,7.0,6.9181141439206,998,6.96693386773547
591,407,7.0,6.91400491400491,998,6.96492985971944
585,413,7.0,6.90799031476998,998,6.96192384769539
584,415,7.0,6.90361445783132,999,6.95995995995996
590,409,7.0,6.90953545232274,999,6.96296296296296
586,412,7.0,6.9004854368932,998,6.95891783567134
590,409,7.0,6.90464547677262,999,6.96096096096096
582,416,7.0,6.90384615384615,998,6.95991983967936
577,421,7.0,6.90736342042755,998,6.96092184368737
567,431,7.0,6.90023201856148,998,6.95691382765531
565,434,7.0,6.8963133640553,999,6.95495495495495
567,432,7.0,6.90046296296296,999,6.95695695695696
571,426,7.0,6.8943661971831,997,6.95486459378134
573,426,7.0,6.9037558685446,999,6.95895895895896
581,418,7.0,6.90909090909091,999,6.96196196196196
584,413,7.0,6.91767554479419,997,6.96589769307924
583,415,7.0,6.92289156626506,998,6.96793587174349
586,413,7.0,6.92493946731235,999,6.96896896896897
580,419,7.0,6.93078758949881,999,6.97097097097097
567,432,7.0,6.93518518518519,999,6.97197197197197
572,427,7.0,6.93208430913349,999,6.97097097097097
571,428,7.0,6.92990654205607,999,6.96996996996997
571,428,7.0,6.92990654205607,999,6.96996996996997
578,420,7.0,6.92857142857143,998,6.96993987975952
570,427,7.0,6.92974238875878,997,6.96990972918756
568,429,7.0,6.93240093240093,997,6.97091273821464
577,422,7.0,6.92654028436019,999,6.96896896896897
579,419,7.0,6.93556085918854,998,6.97294589178357
573,426,7.0,6.92957746478873,999,6.96996996996997
576,422,7.0,6.92890995260664,998,6.96993987975952
570,428,7.0,6.92289719626168,998,6.96693386773547
567,432,7.0,6.92824074074074,999,6.96896896896897
571,428,7.0,6.92056074766355,999,6.96596596596597
575,424,7.0,6.92688679245283,999,6.96896896896897
573,426,7.0,6.92957746478873,999,6.96996996996997
583,414,7.0,6.93478260869565,997,6.97291875626881
585,414,7.0,6.93236714975845,999,6.97197197197197
573,425,7.0,6.93411764705882,998,6.97194388777555
582,417,7.0,6.9400479616307,999,6.97497497497497
586,413,7.0,6.94188861985472,999,6.97597597597598
578,421,7.0,6.93349168646081,999,6.97197197197197
579,420,7.0,6.93095238095238,999,6.97097097097097
579,420,7.0,6.92619047619048,999,6.96896896896897
581,418,7.0,6.92344497607655,999,6.96796796796797
581,418,7.0,6.92105263157895,999,6.96696696696697
585,414,7.0,6.92028985507246,999,6.96696696696697
586,413,7.0,6.9225181598063,999,6.96796796796797
584,415,7.0,6.91807228915663,999,6.96596596596597
582,417,7.0,6.92086330935252,999,6.96696696696697
579,420,7.0,6.92142857142857,999,6.96696696696697
571,428,7.0,6.91121495327103,999,6.96196196196196
562,437,7.0,6.91533180778032,999,6.96296296296296
572,427,7.0,6.91100702576112,999,6.96196196196196
575,424,7.0,6.91509433962264,999,6.96396396396396
580,419,7.0,6.91646778042959,999,6.96496496496496
575,424,7.0,6.91745283018868,999,6.96496496496496
579,420,7.0,6.92380952380952,999,6.96796796796797
586,412,7.0,6.91990291262136,998,6.96693386773547
578,420,7.0,6.92142857142857,998,6.96693386773547
580,418,7.0,6.92822966507177,998,6.96993987975952
582,417,7.0,6.92326139088729,999,6.96796796796797
573,424,7.0,6.92216981132075,997,6.96690070210632
577,421,7.0,6.93111638954869,998,6.97094188376754
582,416,7.0,6.93028846153846,998,6.97094188376754
577,421,7.0,6.91923990498812,998,6.96593186372746
571,428,7.0,6.92056074766355,999,6.96596596596597
569,430,7.0,6.92325581395349,999,6.96696696696697
564,435,7.0,6.92413793103448,999,6.96696696696697
568,430,7.0,6.91162790697674,998,6.96192384769539
567,431,7.0,6.91183294663573,998,6.96192384769539
564,435,7.0,6.90574712643678,999,6.95895895895896
560,436,7.0,6.90137614678899,996,6.95682730923695
554,445,7.0,6.90112359550562,999,6.95595595595596
549,448,7.0,6.90848214285714,997,6.95887662988967
555,443,7.0,6.90293453724605,998,6.95691382765531
552,447,7.0,6.90380313199105,999,6.95695695695696
560,439,7.0,6.90432801822323,999,6.95795795795796
563,436,7.0,6.89908256880734,999,6.95595595595596
550,446,7.0,6.89237668161435,996,6.95180722891566
559,440,7.0,6.89772727272727,999,6.95495495495495
553,444,7.0,6.90540540540541,997,6.95787362086259
556,439,7.0,6.8997722095672,995,6.95577889447236
555,442,7.0,6.9027149321267,997,6.95687061183551
550,447,7.0,6.91051454138703,997,6.95987963891675
545,454,7.0,6.91409691629956,999,6.96096096096096
547,452,7.0,6.91371681415929,999,6.96096096096096
542,456,7.0,6.91447368421053,998,6.96092184368737
533,465,7.0,6.92258064516129,998,6.96392785571142
542,455,7.0,6.92307692307692,997,6.96489468405216
538,461,7.0,6.93058568329718,999,6.96796796796797
536,463,7.0,6.93088552915767,999,6.96796796796797
540,458,7.0,6.92139737991266,998,6.96392785571142
535,464,7.0,6.92672413793103,999,6.96596596596597
544,455,7.0,6.92967032967033,999,6.96796796796797
549,450,7.0,6.93111111111111,999,6.96896896896897
553,446,7.0,6.9304932735426,999,6.96896896896897
557,442,7.0,6.92307692307692,999,6.96596596596597
565,432,7.0,6.92361111111111,997,6.96690070210632
567,432,7.0,6.91898148148148,999,6.96496496496496
580,419,7.0,6.91646778042959,999,6.96496496496496
587,411,7.0,6.91727493917275,998,6.96593186372746
582,415,7.0,6.91084337349398,997,6.96288866599799
588,411,7.0,6.90997566909976,999,6.96296296296296
585,414,7.0,6.90821256038647,999,6.96196196196196
586,411,7.0,6.90024330900243,997,6.95887662988967
591,407,7.0,6.8968058968059,998,6.95791583166333
586,410,7.0,6.89512195121951,996,6.95682730923695
585,413,7.0,6.89830508474576,998,6.95791583166333
583,416,7.0,6.89182692307692,999,6.95495495495495
571,428,7.0,6.90420560747664,999,6.95895895895896
570,429,7.0,6.91142191142191,999,6.96196196196196
574,425,7.0,6.91058823529412,999,6.96196196196196
570,429,7.0,6.90675990675991,999,6.95995995995996
561,436,7.0,6.9105504587156,997,6.96088264794383
577,421,7.0,6.91211401425178,998,6.96292585170341
564,435,7.0,6.90804597701149,999,6.95995995995996
565,434,7.0,6.91013824884793,999,6.96096096096096
573,426,7.0,6.91549295774648,999,6.96396396396396
558,440,7.0,6.90681818181818,998,6.95891783567134
560,439,7.0,6.91116173120729,999,6.96096096096096
570,427,7.0,6.92271662763466,997,6.96690070210632
570,428,7.0,6.91588785046729,998,6.96392785571142
569,429,7.0,6.91142191142191,998,6.96192384769539
569,429,7.0,6.91608391608392,998,6.96392785571142
576,422,7.0,6.9218009478673,998,6.96693386773547
564,435,7.0,6.91264367816092,999,6.96196196196196
564,435,7.0,6.91724137931034,999,6.96396396396396
564,433,7.0,6.91916859122402,997,6.96489468405216
561,438,7.0,6.92009132420091,999,6.96496496496496
559,439,7.0,6.92027334851936,998,6.96492985971944
554,445,7.0,6.92359550561798,999,6.96596596596597
556,441,7.0,6.92290249433107,997,6.96589769307924
555,443,7.0,6.92325056433409,998,6.96593186372746
546,452,7.0,6.92699115044248,998,6.96693386773547
555,444,7.0,6.93243243243243,999,6.96996996996997
557,442,7.0,6.92760180995475,999,6.96796796796797
554,445,7.0,6.92359550561798,999,6.96596596596597
564,433,7.0,6.93764434180139,997,6.97291875626881
562,435,7.0,6.93563218390805,997,6.97191574724173
553,446,7.0,6.92600896860987,999,6.96696696696697
564,435,7.0,6.93103448275862,999,6.96996996996997
564,434,7.0,6.93548387096774,998,6.97194388777555
561,438,7.0,6.93607305936073,999,6.97197197197197
574,424,7.0,6.93396226415094,998,6.97194388777555
574,424,7.0,6.92688679245283,998,6.9689378757515
566,432,7.0,6.93055555555556,998,6.96993987975952
569,430,7.0,6.92558139534884,999,6.96796796796797
576,422,7.0,6.92890995260664,998,6.96993987975952
573,425,7.0,6.93411764705882,998,6.97194388777555
581,417,7.0,6.92565947242206,998,6.9689378757515
585,414,7.0,6.92753623188406,999,6.96996996996997
584,414,7.0,6.92995169082126,998,6.97094188376754
583,413,7.0,6.92009685230024,996,6.96686746987952
579,419,7.0,6.91885441527446,998,6.96593186372746
581,418,7.0,6.92583732057416,999,6.96896896896897
577,421,7.0,6.93349168646081,998,6.97194388777555
569,428,7.0,6.92289719626168,997,6.96690070210632
568,431,7.0,6.92343387470998,999,6.96696696696697
584,415,7.0,6.93012048192771,999,6.97097097097097
579,419,7.0,6.93078758949881,998,6.97094188376754
582,415,7.0,6.92771084337349,997,6.96990972918756
591,408,7.0,6.93382352941176,999,6.97297297297297
576,423,7.0,6.92671394799054,999,6.96896896896897
581,417,7.0,6.93285371702638,998,6.97194388777555
577,420,7.0,6.93095238095238,997,6.97091273821464
589,410,7.0,6.93658536585366,999,6.97397397397397
592,407,7.0,6.92874692874693,999,6.97097097097097
581,414,7.0,6.92753623188406,995,6.96984924623116
582,415,7.0,6.92771084337349,997,6.96990972918756
594,404,7.0,6.93069306930693,998,6.97194388777555
583,416,7.0,6.93990384615385,999,6.97497497497497
586,413,7.0,6.94430992736077,999,6.97697697697698
595,404,7.0,6.9480198019802,999,6.97897897897898
580,419,7.0,6.94749403341289,999,6.97797797797798
586,413,7.0,6.94673123486683,999,6.97797797797798
586,413,7.0,6.95157384987894,999,6.97997997997998
580,418,7.0,6.94976076555024,998,6.97895791583166
578,420,7.0,6.95,998,6.97895791583166
579,419,7.0,6.95226730310263,998,6.97995991983968
567,431,7.0,6.94895591647332,998,6.97795591182365
573,426,7.0,6.94600938967136,999,6.97697697697698
568,431,7.0,6.94895591647332,999,6.97797797797798
562,436,7.0,6.95183486238532,998,6.97895791583166
561,438,7.0,6.94063926940639,999,6.97397397397397
561,435,7.0,6.93793103448276,996,6.97289156626506
553,446,7.0,6.93273542600897,999,6.96996996996997
554,445,7.0,6.92584269662921,999,6.96696696696697
556,443,7.0,6.9255079006772,999,6.96696696696697
560,439,7.0,6.92938496583144,999,6.96896896896897
559,440,7.0,6.91818181818182,999,6.96396396396396
562,435,7.0,6.91724137931034,997,6.96389167502508
557,441,7.0,6.91609977324263,998,6.96292585170341
553,446,7.0,6.91704035874439,999,6.96296296296296
556,441,7.0,6.91383219954649,997,6.96188565697091
560,439,7.0,6.91571753986333,999,6.96296296296296
570,429,7.0,6.92307692307692,999,6.96696696696697
568,431,7.0,6.93039443155452,999,6.96996996996997
573,425,7.0,6.93647058823529,998,6.97294589178357
582,417,7.0,6.93045563549161,999,6.97097097097097
584,415,7.0,6.93253012048193,999,6.97197197197197
588,411,7.0,6.93187347931873,999,6.97197197197197
582,415,7.0,6.92771084337349,997,6.96990972918756
590,409,7.0,6.91687041564792,999,6.96596596596597
588,411,7.0,6.92457420924574,999,6.96896896896897
584,410,7.0,6.93170731707317,994,6.97183098591549
580,418,7.0,6.93062200956938,998,6.97094188376754
578,421,7.0,6.92874109263658,999,6.96996996996997
580,417,7.0,6.93285371702638,997,6.97191574724173
582,417,7.0,6.92565947242206,999,6.96896896896897
582,416,7.0,6.92788461538461,998,6.96993987975952
589,409,7.0,6.92420537897311,998,6.9689378757515
597,401,7.0,6.92019950124688,998,6.96793587174349
593,406,7.0,6.93103448275862,999,6.97197197197197
596,403,7.0,6.92059553349876,999,6.96796796796797
593,406,7.0,6.91379310344828,999,6.96496496496496
600,399,7.0,6.90726817042607,999,6.96296296296296
607,392,7.0,6.90561224489796,999,6.96296296296296
614,385,7.0,6.9038961038961,999,6.96296296296296
613,386,7.0,6.90673575129534,999,6.96396396396396
621,378,7.0,6.91269841269841,999,6.96696696696697
627,372,7.0,6.91129032258065,999,6.96696696696697
626,373,7.0,6.9142091152815,999,6.96796796796797
627,370,7.0,6.91621621621622,997,6.96890672016048
627,372,7.0,6.9005376344086,999,6.96296296296296
624,374,7.0,6.90374331550802,998,6.96392785571142
633,365,7.0,6.9013698630137,998,6.96392785571142
627,369,7.0,6.89972899728997,996,6.96285140562249
621,378,7.0,6.91005291005291,999,6.96596596596597
626,371,7.0,6.91374663072776,997,6.9679037111334
620,378,7.0,6.91798941798942,998,6.9689378757515
610,389,7.0,6.92030848329049,999,6.96896896896897
610,389,7.0,6.9280205655527,999,6.97197197197197
611,385,7.0,6.92727272727273,996,6.9718875502008
605,394,7.0,6.93147208121827,999,6.97297297297297
606,393,7.0,6.92875318066158,999,6.97197197197197
598,399,7.0,6.92481203007519,997,6.96990972918756
599,400,7.0,6.92,999,6.96796796796797
603,395,7.0,6.91898734177215,998,6.96793587174349
602,397,7.0,6.92191435768262,999,6.96896896896897
603,396,7.0,6.91919191919192,999,6.96796796796797
604,395,7.0,6.91645569620253,999,6.96696696696697
603,396,7.0,6.92171717171717,999,6.96896896896897
603,395,7.0,6.92151898734177,998,6.9689378757515
619,379,7.0,6.91292875989446,998,6.96693386773547
621,378,7.0,6.90476190476191,999,6.96396396396396
609,388,7.0,6.90721649484536,997,6.96389167502508
619,380,7.0,6.90526315789474,999,6.96396396396396
619,379,7.0,6.89973614775726,998,6.96192384769539
628,371,7.0,6.89487870619946,999,6.96096096096096
627,371,7.0,6.89487870619946,998,6.96092184368737
624,373,7.0,6.89008042895442,997,6.95887662988967
625,374,7.0,6.89304812834225,999,6.95995995995996
626,371,7.0,6.90566037735849,997,6.96489468405216
622,377,7.0,6.90716180371353,999,6.96496496496496
630,369,7.0,6.89430894308943,999,6.96096096096096
627,372,7.0,6.91397849462366,999,6.96796796796797
626,373,7.0,6.91957104557641,999,6.96996996996997
626,372,7.0,6.91129032258065,998,6.96693386773547
621,375,7.0,6.90933333333333,996,6.96586345381526
627,372,7.0,6.91129032258065,999,6.96696696696697
630,369,7.0,6.90785907859079,999,6.96596596596597
634,362,7.0,6.90055248618784,996,6.96385542168675
632,367,7.0,6.90463215258856,999,6.96496496496496
625,374,7.0,6.9144385026738,999,6.96796796796797
633,366,7.0,6.90437158469945,999,6.96496496496496
629,369,7.0,6.90243902439024,998,6.96392785571142
622,375,7.0,6.912,997,6.96690070210632
636,362,7.0,6.90055248618784,998,6.96392785571142
628,369,7.0,6.8970189701897,997,6.96188565697091
625,369,7.0,6.89430894308943,994,6.96076458752515
635,364,7.0,6.90934065934066,999,6.96696696696697
633,366,7.0,6.89617486338798,999,6.96196196196196
634,365,7.0,6.89041095890411,999,6.95995995995996
642,356,7.0,6.89606741573034,998,6.96292585170341
636,363,7.0,6.89256198347107,999,6.96096096096096
633,365,7.0,6.89315068493151,998,6.96092184368737
646,353,7.0,6.90934844192635,999,6.96796796796797
646,353,7.0,6.91218130311615,999,6.96896896896897
647,350,7.0,6.9,997,6.96489468405216
655,344,7.0,6.89825581395349,999,6.96496496496496
651,347,7.0,6.90778097982709,998,6.96793587174349
657,342,7.0,6.90350877192982,999,6.96696696696697
656,343,7.0,6.89504373177843,999,6.96396396396396
658,341,7.0,6.90909090909091,999,6.96896896896897
655,342,7.0,6.90643274853801,997,6.9679037111334
651,347,7.0,6.90778097982709,998,6.96793587174349
643,356,7.0,6.9185393258427,999,6.97097097097097
648,350,7.0,6.92857142857143,998,6.9749498997996
648,351,7.0,6.92307692307692,999,6.97297297297297
642,357,7.0,6.92436974789916,999,6.97297297297297
647,350,7.0,6.93142857142857,997,6.97592778335005
650,347,7.0,6.93659942363112,997,6.97793380140421
640,358,7.0,6.93296089385475,998,6.97595190380762
644,355,7.0,6.92957746478873,999,6.97497497497497
654,343,7.0,6.93586005830904,997,6.97793380140421
652,346,7.0,6.93063583815029,998,6.97595190380762
654,345,7.0,6.9304347826087,999,6.97597597597598
664,335,7.0,6.94029850746269,999,6.97997997997998
658,341,7.0,6.94134897360704,999,6.97997997997998
665,333,7.0,6.93993993993994,998,6.97995991983968
666,332,7.0,6.93975903614458,998,6.97995991983968
669,329,7.0,6.94528875379939,998,6.98196392785571
661,337,7.0,6.93768545994065,998,6.97895791583166
662,337,7.0,6.9406528189911,999,6.97997997997998
