forward_num,reverse_num,forward_rate,reverse_rate,organism_num,organism_rate
50,50,5.5,5.5,100,5.5
60,60,5.88333333333333,5.63333333333333,120,5.75833333333333
74,82,6.06756756756757,5.90243902439024,156,5.98076923076923
96,96,6.38541666666667,5.98958333333333,192,6.1875
117,123,6.52991452991453,6.39024390243902,240,6.45833333333333
150,146,6.96,6.62328767123288,296,6.79391891891892
180,184,7.04444444444444,6.97282608695652,364,7.00824175824176
254,230,7.34251968503937,7.15217391304348,484,7.25206611570248
302,313,7.47682119205298,7.46325878594249,615,7.46991869918699
419,384,7.81145584725537,7.52864583333333,803,7.67621419676214
506,492,7.91304347826087,7.83536585365854,998,7.874749498998
507,491,7.83826429980276,7.78004073319756,998,7.80961923847695
502,497,7.85657370517928,7.75653923541247,999,7.80680680680681
502,496,7.83466135458167,7.74395161290323,998,7.78957915831663
508,491,7.8740157480315,7.76171079429735,999,7.81881881881882
494,499,7.83805668016194,7.67735470941884,993,7.75730110775428
502,497,7.87848605577689,7.70422535211268,999,7.79179179179179
499,498,7.87775551102204,7.71285140562249,997,7.79538615847543
508,488,7.84055118110236,7.70286885245902,996,7.77309236947791
511,486,7.81800391389432,7.76954732510288,997,7.79438314944835
508,490,7.91929133858268,7.8265306122449,998,7.87374749498998
516,483,7.93992248062016,7.83022774327122,999,7.88688688688689
507,491,7.96055226824458,7.87372708757638,998,7.91783567134269
511,487,7.95303326810176,7.90554414784394,998,7.92985971943888
518,480,7.97683397683398,7.96666666666667,998,7.97194388777555
519,480,8.02119460500963,8.03333333333333,999,8.02702702702703
521,477,8.08061420345489,8.07127882599581,998,8.07615230460922
519,480,8.09826589595376,8.12708333333333,999,8.11211211211211
511,487,8.09197651663405,8.14579055441478,998,8.11823647294589
504,495,8.14285714285714,8.21212121212121,999,8.17717717717718
498,500,8.19076305220884,8.144,998,8.16733466933868
502,496,8.16334661354582,8.16129032258065,998,8.1623246492986
512,487,8.193359375,8.13552361396304,999,8.16516516516517
502,496,8.17131474103586,8.1875,998,8.17935871743487
517,482,8.23791102514507,8.21991701244813,999,8.22922922922923
519,478,8.22543352601156,8.23640167364017,997,8.23069207622869
511,488,8.22896281800391,8.26844262295082,999,8.24824824824825
508,489,8.24803149606299,8.28629856850716,997,8.26680040120361
505,494,8.21584158415842,8.32793522267206,999,8.27127127127127
505,493,8.24554455445545,8.33062880324544,998,8.2875751503006
501,498,8.25149700598802,8.28112449799197,999,8.26626626626627
499,500,8.30060120240481,8.27,999,8.28528528528529
500,498,8.31,8.32530120481928,998,8.31763527054108
508,491,8.32086614173228,8.34623217922607,999,8.33333333333333
518,481,8.3957528957529,8.36382536382536,999,8.38038038038038
518,481,8.44401544401544,8.37422037422037,999,8.41041041041041
519,479,8.41233140655106,8.37787056367432,998,8.39579158316633
525,474,8.44761904761905,8.35443037974684,999,8.4034034034034
533,465,8.46904315196998,8.39569892473118,998,8.43486973947896
541,458,8.48059149722736,8.43668122270742,999,8.46046046046046
543,455,8.50460405156538,8.49230769230769,998,8.49899799599198
544,455,8.52573529411765,8.47032967032967,999,8.5005005005005
547,451,8.54661791590494,8.50110864745011,998,8.52605210420842
560,439,8.59642857142857,8.52619589977221,999,8.56556556556557
554,445,8.5884476534296,8.58651685393258,999,8.58758758758759
550,446,8.61090909090909,8.5762331838565,996,8.59538152610442
549,450,8.60655737704918,8.53333333333333,999,8.57357357357357
553,445,8.58047016274864,8.5438202247191,998,8.56412825651303
550,449,8.62727272727273,8.60356347438753,999,8.61661661661662
548,450,8.6478102189781,8.64,998,8.64428857715431
553,446,8.67811934900542,8.60313901345291,999,8.64464464464464
548,451,8.67700729927007,8.60753880266075,999,8.64564564564565
555,443,8.68108108108108,8.60496613995485,998,8.64729458917836
550,446,8.68727272727273,8.64125560538117,996,8.66666666666667
561,435,8.71301247771836,8.62068965517241,996,8.67269076305221
571,428,8.73905429071804,8.68224299065421,999,8.71471471471471
569,430,8.73989455184534,8.71395348837209,999,8.72872872872873
575,423,8.73217391304348,8.73522458628842,998,8.73346693386774
579,418,8.7685664939551,8.74641148325359,997,8.7592778335005
573,424,8.73821989528796,8.72877358490566,997,8.73420260782347
572,427,8.73951048951049,8.74473067915691,999,8.74174174174174
582,416,8.74570446735395,8.75480769230769,998,8.74949899799599
582,416,8.74054982817869,8.79807692307692,998,8.76452905811623
588,409,8.75170068027211,8.78728606356968,997,8.76629889669007
593,405,8.74367622259696,8.77530864197531,998,8.7565130260521
595,404,8.72100840336134,8.74257425742574,999,8.72972972972973
594,404,8.75925925925926,8.75990099009901,998,8.75951903807615
589,409,8.78268251273345,8.77017114914425,998,8.77755511022044
587,412,8.78875638841567,8.77184466019417,999,8.78178178178178
591,408,8.8087986463621,8.81127450980392,999,8.80980980980981
580,417,8.82068965517241,8.81534772182254,997,8.81845536609829
570,429,8.84385964912281,8.85314685314685,999,8.84784784784785
569,429,8.88576449912127,8.86713286713287,998,8.87775551102204
574,423,8.86411149825784,8.87470449172577,997,8.86860581745236
579,420,8.87564766839378,8.93809523809524,999,8.9019019019019
574,425,8.9198606271777,8.91294117647059,999,8.91691691691692
584,414,8.91952054794521,8.92753623188406,998,8.92284569138276
575,424,8.92695652173913,8.95990566037736,999,8.94094094094094
573,424,8.92670157068063,8.95754716981132,997,8.93981945837513
575,422,8.93913043478261,9.00473933649289,997,8.96690070210632
580,418,8.96379310344828,8.99282296650718,998,8.97595190380762
580,418,8.97413793103448,8.99760765550239,998,8.98396793587174
586,413,8.99488054607509,8.96610169491525,999,8.98298298298298
584,415,9.01712328767123,8.98795180722892,999,9.00500500500501
599,399,9.03338898163606,8.97994987468672,998,9.01202404809619
598,401,9.00334448160535,8.98503740648379,999,8.995995995996
597,402,9.04020100502512,8.98258706467662,999,9.01701701701702
594,402,9.01178451178451,9.04228855721393,996,9.02409638554217
603,396,8.99668325041459,9.05555555555556,999,9.02002002002002
606,392,8.98019801980198,9.07908163265306,998,9.0190380761523
607,392,8.99011532125206,9.06632653061224,999,9.02002002002002
601,396,8.99500831946755,9.07070707070707,997,9.02507522567703
604,395,9.0,9.08607594936709,999,9.03403403403403
601,398,9.0,9.12562814070352,999,9.05005005005005
595,403,8.99663865546218,9.13895781637717,998,9.05410821643287
586,410,8.99829351535836,9.1780487804878,996,9.07228915662651
596,403,9.02348993288591,9.19602977667494,999,9.09309309309309
597,402,9.04187604690117,9.1865671641791,999,9.1001001001001
599,400,9.06343906510851,9.1875,999,9.11311311311311
606,392,9.04290429042904,9.2219387755102,998,9.11322645290581
610,388,9.06229508196721,9.21649484536082,998,9.12224448897796
608,390,9.05263157894737,9.24615384615385,998,9.12825651302605
602,397,9.05813953488372,9.272040302267,999,9.14314314314314
607,391,9.06425041186161,9.28644501278772,998,9.15130260521042
611,388,9.08019639934534,9.30154639175258,999,9.16616616616617
612,387,9.10457516339869,9.3359173126615,999,9.19419419419419
617,381,9.12803889789303,9.33595800524934,998,9.20741482965932
622,377,9.12861736334405,9.35809018567639,999,9.21521521521522
622,377,9.12861736334405,9.38992042440318,999,9.22722722722723
614,385,9.12052117263844,9.3974025974026,999,9.22722722722723
610,389,9.11475409836066,9.41388174807198,999,9.23123123123123
605,394,9.12561983471074,9.38578680203046,999,9.22822822822823
597,401,9.11222780569514,9.39650872817955,998,9.22645290581162
596,403,9.10402684563758,9.38213399503722,999,9.21621621621622
589,410,9.10696095076401,9.36829268292683,999,9.21421421421421
597,401,9.12395309882747,9.33665835411471,998,9.20941883767535
585,412,9.13846153846154,9.34223300970874,997,9.22266800401204
598,401,9.11872909698997,9.36907730673317,999,9.21921921921922
586,411,9.1296928327645,9.34306569343066,997,9.21765295887663
588,411,9.13265306122449,9.38442822384428,999,9.23623623623624
585,414,9.10940170940171,9.39371980676328,999,9.22722722722723
581,418,9.1118760757315,9.39234449760766,999,9.22922922922923
583,413,9.13379073756432,9.41646489104116,996,9.25100401606426
588,408,9.17517006802721,9.42156862745098,996,9.27610441767068
605,391,9.16694214876033,9.41687979539642,996,9.26506024096386
607,392,9.17792421746293,9.43112244897959,999,9.27727727727728
608,391,9.19736842105263,9.45780051150895,999,9.2992992992993
612,387,9.20424836601307,9.45478036175711,999,9.3013013013013
608,390,9.24671052631579,9.46923076923077,998,9.33366733466934
628,371,9.23726114649681,9.47708894878706,999,9.32632632632633
628,371,9.24363057324841,9.49056603773585,999,9.33533533533534
631,368,9.23771790808241,9.49184782608696,999,9.33133133133133
631,368,9.21870047543582,9.47826086956522,999,9.31431431431431
635,364,9.2,9.5,999,9.30930930930931
634,364,9.18296529968454,9.48901098901099,998,9.29458917835671
627,372,9.18819776714514,9.49731182795699,999,9.3033033033033
630,368,9.18888888888889,9.49728260869565,998,9.30260521042084
626,373,9.16453674121406,9.50402144772118,999,9.29129129129129
630,369,9.20793650793651,9.48509485094851,999,9.31031031031031
629,370,9.22575516693164,9.48918918918919,999,9.32332332332332
639,360,9.22222222222222,9.45833333333333,999,9.30730730730731
632,367,9.2120253164557,9.4141689373297,999,9.28628628628629
644,353,9.21583850931677,9.44192634560907,997,9.29588766298897
634,365,9.23186119873817,9.46301369863014,999,9.31631631631632
636,362,9.24685534591195,9.43093922651934,998,9.31362725450902
632,367,9.24367088607595,9.44686648501362,999,9.31831831831832
638,360,9.24137931034483,9.44722222222222,998,9.31563126252505
633,366,9.24960505529226,9.42896174863388,999,9.31531531531532
627,372,9.25996810207337,9.43010752688172,999,9.32332332332332
637,361,9.23233908948195,9.41551246537396,998,9.29859719438878
630,368,9.26825396825397,9.40489130434783,998,9.3186372745491
627,372,9.29346092503987,9.4247311827957,999,9.34234234234234
622,377,9.29099678456592,9.45358090185676,999,9.35235235235235
618,381,9.28640776699029,9.46719160104987,999,9.35535535535536
620,379,9.29032258064516,9.45382585751979,999,9.35235235235235
626,373,9.26996805111821,9.45844504021448,999,9.34034034034034
627,371,9.27272727272727,9.49056603773585,998,9.35370741482966
632,367,9.31645569620253,9.49318801089918,999,9.38138138138138
627,371,9.31419457735247,9.50134770889488,998,9.38376753507014
631,366,9.3122028526149,9.49453551912568,997,9.37913741223671
636,363,9.30974842767296,9.5068870523416,999,9.38138138138138
629,369,9.32432432432432,9.49864498644986,998,9.38877755511022
631,365,9.31378763866878,9.49041095890411,996,9.3785140562249
630,367,9.3031746031746,9.48228882833788,997,9.3691073219659
635,364,9.31338582677165,9.48901098901099,999,9.37737737737738
634,363,9.29022082018927,9.49862258953168,997,9.36609829488465
643,355,9.31881804043546,9.48732394366197,998,9.37875751503006
640,359,9.29375,9.47632311977716,999,9.35935935935936
644,354,9.3027950310559,9.44915254237288,998,9.35470941883768
642,356,9.30218068535826,9.44101123595506,998,9.35170340681363
650,349,9.30769230769231,9.4297994269341,999,9.35035035035035
659,340,9.32321699544765,9.45882352941176,999,9.36936936936937
656,342,9.29420731707317,9.4327485380117,998,9.34168336673347
667,332,9.29085457271364,9.4066265060241,999,9.32932932932933
665,334,9.27368421052632,9.43413173652695,999,9.32732732732733
664,333,9.28915662650602,9.45645645645646,997,9.34503510531595
660,338,9.28787878787879,9.44082840236686,998,9.33967935871743
657,341,9.29071537290715,9.47800586510264,998,9.35470941883768
660,339,9.29545454545454,9.48967551622419,999,9.36136136136136
661,336,9.28441754916793,9.48214285714286,997,9.35105315947844
663,335,9.27601809954751,9.4955223880597,998,9.3496993987976
665,334,9.29924812030075,9.48802395209581,999,9.36236236236236
666,332,9.32582582582583,9.48493975903614,998,9.37875751503006
667,332,9.30134932533733,9.49096385542169,999,9.36436436436436
660,339,9.30757575757576,9.48377581120944,999,9.36736736736737
656,338,9.33536585365854,9.46449704142012,994,9.37927565392354
659,340,9.32776934749621,9.46764705882353,999,9.37537537537538
656,342,9.34451219512195,9.47368421052632,998,9.38877755511022
650,347,9.33538461538462,9.47550432276657,997,9.38415245737212
652,347,9.33742331288344,9.4956772334294,999,9.39239239239239
653,345,9.35528330781011,9.48695652173913,998,9.40080160320641
655,343,9.35419847328244,9.48979591836735,998,9.40080160320641
656,341,9.35670731707317,9.51612903225806,997,9.41123370110331
661,338,9.38124054462935,9.51775147928994,999,9.42742742742743
654,344,9.3822629969419,9.50290697674419,998,9.42384769539078
655,343,9.37709923664122,9.52186588921283,998,9.42685370741483
649,349,9.38058551617874,9.55873925501433,998,9.44288577154309
646,353,9.39318885448916,9.56090651558074,999,9.45245245245245
643,356,9.38258164852255,9.55056179775281,999,9.44244244244244
647,351,9.37557959814529,9.54985754985755,998,9.43687374749499
659,340,9.3535660091047,9.54705882352941,999,9.41941941941942
659,340,9.350531107739,9.55294117647059,999,9.41941941941942
666,333,9.37387387387387,9.54654654654655,999,9.43143143143143
664,335,9.37048192771084,9.55820895522388,999,9.43343343343343
664,335,9.38403614457831,9.54626865671642,999,9.43843843843844
668,330,9.37724550898204,9.55151515151515,998,9.43486973947896
668,331,9.37275449101796,9.5619335347432,999,9.43543543543544
660,339,9.38030303030303,9.55752212389381,999,9.44044044044044
661,337,9.39939485627837,9.5727002967359,998,9.45791583166333
670,329,9.38358208955224,9.57142857142857,999,9.44544544544545
668,331,9.39520958083832,9.61027190332326,999,9.46646646646647
671,327,9.41430700447094,9.6177370030581,998,9.4809619238477
667,332,9.40779610194902,9.60542168674699,999,9.47347347347347
673,325,9.42496285289747,9.6,998,9.48196392785571
674,325,9.41839762611276,9.59384615384615,999,9.47547547547548
679,319,9.42415316642121,9.59247648902821,998,9.47795591182365
674,324,9.41988130563798,9.58333333333333,998,9.47294589178357
676,323,9.42899408284024,9.56656346749226,999,9.47347347347347
666,333,9.43543543543544,9.58258258258258,999,9.48448448448448
665,334,9.44360902255639,9.57185628742515,999,9.48648648648649
657,341,9.44901065449011,9.56598240469208,998,9.48897795591182
661,338,9.44629349470499,9.55621301775148,999,9.48348348348348
652,346,9.41871165644172,9.54335260115607,998,9.46192384769539
657,340,9.43226788432268,9.56176470588235,997,9.47642928786359
652,346,9.44478527607362,9.57803468208093,998,9.49098196392786
656,341,9.45121951219512,9.55425219941349,997,9.4864593781344
659,340,9.4309559939302,9.56176470588235,999,9.47547547547548
659,340,9.4339908952959,9.54411764705882,999,9.47147147147147
663,336,9.42533936651584,9.53273809523809,999,9.46146146146146
658,340,9.42857142857143,9.52352941176471,998,9.46092184368737
649,350,9.42681047765794,9.52285714285714,999,9.46046046046046
643,356,9.42612752721617,9.50842696629213,999,9.45545545545546
640,359,9.40625,9.48189415041783,999,9.43343343343343
648,351,9.42901234567901,9.4957264957265,999,9.45245245245245
647,352,9.42194744976816,9.47727272727273,999,9.44144144144144
650,349,9.41846153846154,9.46418338108882,999,9.43443443443443
648,350,9.44444444444444,9.46571428571429,998,9.45190380761523
650,349,9.43538461538462,9.45272206303725,999,9.44144144144144
648,348,9.41975308641975,9.43965517241379,996,9.42670682730924
640,358,9.4390625,9.42458100558659,998,9.43386773547094
637,360,9.44113029827315,9.44166666666667,997,9.44132397191575
637,361,9.4552590266876,9.46537396121884,998,9.45891783567134
638,357,9.47335423197492,9.47899159663866,995,9.47537688442211
635,363,9.48031496062992,9.47933884297521,998,9.47995991983968
629,370,9.48012718600954,9.47837837837838,999,9.47947947947948
631,367,9.4770206022187,9.47411444141689,998,9.47595190380762
627,372,9.47049441786284,9.46505376344086,999,9.46846846846847
630,368,9.47301587301587,9.46467391304348,998,9.46993987975952
630,369,9.49047619047619,9.46883468834688,999,9.48248248248248
630,368,9.5015873015873,9.47554347826087,998,9.49198396793587
629,369,9.49602543720191,9.46341463414634,998,9.48396793587174
634,363,9.51104100946372,9.45730027548209,997,9.49147442326981
639,357,9.50234741784038,9.48179271708683,996,9.49497991967871
639,360,9.52112676056338,9.48055555555556,999,9.50650650650651
640,359,9.5328125,9.48467966573816,999,9.51551551551552
633,365,9.52132701421801,9.47671232876712,998,9.50501002004008
640,359,9.5171875,9.48189415041783,999,9.5045045045045
629,368,9.51669316375199,9.48641304347826,997,9.50551654964895
633,366,9.53554502369668,9.45901639344262,999,9.50750750750751
631,367,9.54358161648178,9.45776566757493,998,9.51202404809619
636,363,9.55188679245283,9.47382920110193,999,9.52352352352352
637,362,9.54945054945055,9.46408839779006,999,9.51851851851852
639,358,9.53834115805947,9.47486033519553,997,9.51554663991976
645,353,9.53643410852713,9.46742209631728,998,9.51202404809619
640,359,9.5484375,9.47632311977716,999,9.52252252252252
630,366,9.54126984126984,9.46448087431694,996,9.51305220883534
639,360,9.55399061032864,9.46944444444444,999,9.52352352352352
636,363,9.55974842767296,9.47107438016529,999,9.52752752752753
629,370,9.56438791732909,9.45675675675676,999,9.52452452452452
630,367,9.56984126984127,9.46866485013624,997,9.53259779338014
624,374,9.57051282051282,9.46524064171123,998,9.5310621242485
619,380,9.59127625201939,9.47368421052632,999,9.54654654654655
612,384,9.59803921568627,9.48177083333333,996,9.55321285140562
613,386,9.60848287112561,9.49222797927461,999,9.56356356356356
617,381,9.62398703403566,9.52755905511811,998,9.5871743486974
618,380,9.63430420711974,9.54473684210526,998,9.6002004008016
620,379,9.62903225806452,9.55145118733509,999,9.5995995995996
628,371,9.62261146496815,9.54716981132075,999,9.59459459459459
634,365,9.63722397476341,9.52602739726027,999,9.5965965965966
640,356,9.6390625,9.53651685393258,996,9.60240963855422
648,350,9.64351851851852,9.55714285714286,998,9.61322645290581
650,349,9.66461538461538,9.54154727793696,999,9.62162162162162
651,348,9.67281105990783,9.54310344827586,999,9.62762762762763
642,357,9.66978193146417,9.5266106442577,999,9.61861861861862
636,363,9.66981132075472,9.53994490358127,999,9.62262262262262
644,354,9.66614906832298,9.54237288135593,998,9.62224448897796
644,355,9.67236024844721,9.55211267605634,999,9.62962962962963
648,351,9.67283950617284,9.53561253561254,999,9.62462462462462
644,354,9.67080745341615,9.5225988700565,998,9.61823647294589
644,354,9.67080745341615,9.52824858757062,998,9.62024048096192
641,357,9.69422776911076,9.52380952380952,998,9.63326653306613
641,358,9.68954758190328,9.51675977653631,999,9.62762762762763
639,360,9.68388106416275,9.53611111111111,999,9.63063063063063
635,364,9.68818897637795,9.54945054945055,999,9.63763763763764
629,369,9.67090620031797,9.54471544715447,998,9.62424849699399
623,376,9.67415730337079,9.54787234042553,999,9.62662662662663
620,379,9.66612903225806,9.54089709762533,999,9.61861861861862
622,376,9.66398713826367,9.54521276595745,998,9.61923847695391
619,380,9.65751211631664,9.56578947368421,999,9.62262262262262
622,376,9.67041800643087,9.53989361702128,998,9.62124248496994
621,378,9.67471819645733,9.54232804232804,999,9.62462462462462
623,375,9.6645264847512,9.53066666666667,998,9.61422845691383
620,376,9.66935483870968,9.52925531914894,996,9.61646586345381
613,386,9.67047308319739,9.55699481865285,999,9.62662662662663
623,376,9.68860353130016,9.57712765957447,999,9.64664664664665
622,377,9.68167202572347,9.58090185676393,999,9.64364364364364
611,388,9.68085106382979,9.56185567010309,999,9.63463463463463
613,386,9.66231647634584,9.59067357512953,999,9.63463463463463
611,387,9.65630114566285,9.5891472868217,998,9.63026052104208
607,392,9.65238879736409,9.59183673469388,999,9.62862862862863
601,397,9.65723793677205,9.5919395465995,998,9.6312625250501
597,401,9.65326633165829,9.59850374064838,998,9.6312625250501
588,410,9.66156462585034,9.59756097560976,998,9.63527054108216
593,404,9.65935919055649,9.60891089108911,997,9.63891675025075
594,403,9.66161616161616,9.62779156327543,997,9.64794383149448
588,410,9.66326530612245,9.63170731707317,998,9.6503006012024
587,410,9.66439522998296,9.63170731707317,997,9.65095285857573
580,419,9.6551724137931,9.62768496420048,999,9.64364364364364
577,422,9.64644714038128,9.64454976303318,999,9.64564564564565
570,428,9.63859649122807,9.65654205607477,998,9.64629258517034
566,433,9.63074204946996,9.67898383371825,999,9.65165165165165
559,440,9.65295169946333,9.68409090909091,999,9.66666666666667
557,442,9.64811490125673,9.67647058823529,999,9.66066066066066
558,441,9.63978494623656,9.68480725623583,999,9.65965965965966
556,442,9.64748201438849,9.69230769230769,998,9.66733466933868
552,446,9.65036231884058,9.71748878923767,998,9.68036072144289
545,452,9.6348623853211,9.7212389380531,997,9.6740220661986
543,455,9.65193370165746,9.74725274725275,998,9.69539078156313
540,459,9.65185185185185,9.760348583878,999,9.7017017017017
544,453,9.65441176470588,9.75275938189846,997,9.69909729187563
538,459,9.65985130111524,9.75816993464052,997,9.70511534603811
537,461,9.67039106145251,9.74403470715835,998,9.70440881763527
542,455,9.6789667896679,9.74725274725275,997,9.71013039117352
543,456,9.67587476979742,9.73245614035088,999,9.7017017017017
547,451,9.68555758683729,9.73392461197339,998,9.70741482965932
545,451,9.7045871559633,9.73835920177384,996,9.71987951807229
541,456,9.69685767097967,9.74122807017544,997,9.71715145436309
538,461,9.70446096654275,9.75054229934924,999,9.72572572572573
535,464,9.69345794392523,9.76293103448276,999,9.72572572572573
536,463,9.70149253731343,9.77753779697624,999,9.73673673673674
529,470,9.69943289224953,9.78085106382979,999,9.73773773773774
525,474,9.7047619047619,9.77637130801688,999,9.73873873873874
513,484,9.71734892787524,9.78512396694215,997,9.75025075225677
515,483,9.71456310679612,9.78260869565217,998,9.74749498997996
508,487,9.71653543307087,9.79260780287474,995,9.75376884422111
520,478,9.70192307692308,9.80753138075314,998,9.75250501002004
508,491,9.71456692913386,9.80855397148676,999,9.76076076076076
513,486,9.7056530214425,9.80041152263374,999,9.75175175175175
519,480,9.69556840077071,9.80208333333333,999,9.74674674674675
515,484,9.70679611650485,9.80165289256198,999,9.75275275275275
525,471,9.71619047619048,9.80891719745223,996,9.76004016064257
530,469,9.70188679245283,9.81876332622601,999,9.75675675675676
536,462,9.7089552238806,9.81601731601732,998,9.75851703406814
532,467,9.71240601503759,9.81156316916488,999,9.75875875875876
539,460,9.70315398886827,9.81086956521739,999,9.75275275275275
539,460,9.69758812615956,9.80869565217391,999,9.74874874874875
538,461,9.67657992565056,9.81344902386117,999,9.73973973973974
537,460,9.65549348230912,9.81739130434783,997,9.73019057171514
543,456,9.65377532228361,9.82456140350877,999,9.73173173173173
540,457,9.66851851851852,9.82494529540481,997,9.74022066198596
536,461,9.64365671641791,9.81995661605206,997,9.72517552657974
529,469,9.66162570888469,9.82942430703625,998,9.74048096192385
537,462,9.65549348230912,9.82683982683983,999,9.73473473473473
530,468,9.66603773584906,9.84188034188034,998,9.74849699398798
532,466,9.67293233082707,9.83476394849785,998,9.74849699398798
530,468,9.68490566037736,9.8482905982906,998,9.76152304609218
533,465,9.68480300187617,9.84086021505376,998,9.75751503006012
531,468,9.67984934086629,9.83119658119658,999,9.75075075075075
535,464,9.68224299065421,9.82974137931035,999,9.75075075075075
540,458,9.67592592592593,9.82314410480349,998,9.7434869739479
534,465,9.67977528089888,9.81505376344086,999,9.74274274274274
545,453,9.70091743119266,9.81456953642384,998,9.75250501002004
543,454,9.71270718232044,9.80837004405286,997,9.75626880641926
540,459,9.71481481481482,9.80392156862745,999,9.75575575575576
541,457,9.72088724584104,9.79868708971554,998,9.7565130260521
530,469,9.71698113207547,9.78678038379531,999,9.74974974974975
536,462,9.71641791044776,9.78354978354978,998,9.74749498997996
550,449,9.72545454545454,9.78173719376392,999,9.75075075075075
543,455,9.73112338858195,9.77582417582418,998,9.75150300601202
543,456,9.73112338858195,9.77631578947368,999,9.75175175175175
549,449,9.72677595628415,9.76837416481069,998,9.74549098196393
548,451,9.72080291970803,9.77383592017738,999,9.74474474474474
544,454,9.73897058823529,9.76651982378855,998,9.75150300601202
545,454,9.7394495412844,9.76872246696035,999,9.75275275275275
544,455,9.73713235294118,9.76923076923077,999,9.75175175175175
548,451,9.73722627737226,9.76940133037694,999,9.75175175175175
545,453,9.75045871559633,9.76600441501104,998,9.75751503006012
544,455,9.77022058823529,9.77362637362637,999,9.77177177177177
551,448,9.74954627949183,9.75669642857143,999,9.75275275275275
550,446,9.75636363636364,9.76457399103139,996,9.76004016064257
541,458,9.75970425138632,9.77729257641921,999,9.76776776776777
541,458,9.7449168207024,9.78602620087336,999,9.76376376376376
546,452,9.75274725274725,9.78761061946903,998,9.7685370741483
545,454,9.74678899082569,9.78854625550661,999,9.76576576576577
540,458,9.74074074074074,9.80131004366812,998,9.7685370741483
544,454,9.74448529411765,9.79735682819383,998,9.7685370741483
542,457,9.76937269372694,9.80087527352298,999,9.78378378378378
553,446,9.76491862567812,9.80493273542601,999,9.78278278278278
545,453,9.75779816513761,9.81015452538631,998,9.78156312625251
556,442,9.76438848920863,9.81221719457014,998,9.78557114228457
559,440,9.76207513416816,9.81363636363636,999,9.78478478478478
555,443,9.76576576576577,9.82392776523702,998,9.79158316633267
553,446,9.77576853526221,9.83408071748879,999,9.8018018018018
550,448,9.78727272727273,9.83928571428571,998,9.81062124248497
545,454,9.80183486238532,9.84361233480176,999,9.82082082082082
544,454,9.80330882352941,9.83920704845815,998,9.81963927855711
535,464,9.80934579439252,9.8426724137931,999,9.82482482482482
542,457,9.81549815498155,9.84026258205689,999,9.82682682682683
543,454,9.80478821362799,9.82599118942731,997,9.81444332998997
540,457,9.80925925925926,9.83369803063457,997,9.82046138415246
543,455,9.81031307550645,9.82637362637363,998,9.81763527054108
532,467,9.80827067669173,9.83083511777302,999,9.81881881881882
548,450,9.82116788321168,9.84444444444444,998,9.83166332665331
551,448,9.82032667876588,9.82589285714286,999,9.82282282282282
556,442,9.8363309352518,9.82579185520362,998,9.83166332665331
558,441,9.83333333333333,9.8390022675737,999,9.83583583583584
555,443,9.83243243243243,9.83747178329571,998,9.83466933867735
548,451,9.82299270072993,9.84035476718404,999,9.83083083083083
548,450,9.83759124087591,9.83111111111111,998,9.83466933867735
537,462,9.83426443202979,9.82467532467532,999,9.82982982982983
534,465,9.82958801498127,9.81935483870968,999,9.82482482482482
535,464,9.82429906542056,9.82758620689655,999,9.82582582582583
541,457,9.81700554528651,9.82932166301969,998,9.82264529058116
546,452,9.81318681318681,9.8141592920354,998,9.81362725450902
539,458,9.81818181818182,9.82969432314411,997,9.8234704112337
545,454,9.81284403669725,9.83480176211454,999,9.82282282282282
541,457,9.80221811460259,9.83807439824945,998,9.8186372745491
541,458,9.80776340110906,9.85152838427948,999,9.82782782782783
547,452,9.79707495429616,9.83849557522124,999,9.81581581581582
543,455,9.80478821362799,9.83956043956044,998,9.82064128256513
542,457,9.82287822878229,9.84463894967177,999,9.83283283283283
539,460,9.81818181818182,9.83913043478261,999,9.82782782782783
525,472,9.81714285714286,9.83686440677966,997,9.82647943831494
522,474,9.81800766283525,9.82700421940928,996,9.82228915662651
522,473,9.82950191570881,9.82875264270613,995,9.82914572864322
518,481,9.81660231660232,9.83367983367983,999,9.82482482482482
513,485,9.83625730994152,9.83711340206186,998,9.83667334669339
518,481,9.82818532818533,9.84199584199584,999,9.83483483483483
526,471,9.8384030418251,9.83014861995754,997,9.8345035105316
523,476,9.82600382409178,9.81932773109244,999,9.82282282282282
531,467,9.82297551789077,9.80942184154176,998,9.81663326653307
539,460,9.83858998144713,9.8,999,9.82082082082082
536,462,9.83022388059701,9.8030303030303,998,9.81763527054108
536,460,9.83022388059701,9.80434782608696,996,9.81827309236948
535,464,9.83177570093458,9.80172413793103,999,9.81781781781782
530,468,9.8377358490566,9.81410256410256,998,9.82665330661323
534,465,9.83707865168539,9.81505376344086,999,9.82682682682683
537,462,9.84171322160149,9.82034632034632,999,9.83183183183183
541,458,9.83733826247689,9.81659388646288,999,9.82782782782783
544,454,9.84007352941176,9.80616740088106,998,9.82464929859719
538,460,9.85315985130111,9.82608695652174,998,9.84068136272545
537,460,9.84916201117318,9.83913043478261,997,9.84453360080241
535,464,9.85420560747663,9.84913793103448,999,9.85185185185185
535,464,9.85794392523364,9.86206896551724,999,9.85985985985986
532,467,9.85526315789474,9.86295503211992,999,9.85885885885886
532,466,9.85714285714286,9.86051502145923,998,9.85871743486974
533,466,9.85741088180113,9.86266094420601,999,9.85985985985986
536,463,9.85074626865672,9.85745140388769,999,9.85385385385385
540,458,9.8462962962963,9.84934497816594,998,9.84769539078156
550,448,9.84909090909091,9.84151785714286,998,9.84569138276553
544,455,9.85294117647059,9.83516483516484,999,9.84484484484484
549,449,9.83788706739526,9.84855233853007,998,9.84268537074148
557,442,9.84739676840215,9.84162895927602,999,9.84484484484484
553,445,9.8625678119349,9.84269662921348,998,9.85370741482966
560,439,9.85178571428571,9.84510250569476,999,9.84884884884885
563,436,9.85790408525755,9.85550458715596,999,9.85685685685686
561,437,9.8698752228164,9.85812356979405,998,9.86472945891784
562,437,9.87366548042705,9.8604118993135,999,9.86786786786787
561,436,9.8680926916221,9.85321100917431,997,9.86158475426279
562,436,9.86654804270463,9.84633027522936,998,9.85771543086172
568,431,9.86267605633803,9.84686774941995,999,9.85585585585586
556,443,9.86690647482014,9.86681715575621,999,9.86686686686687
556,443,9.85251798561151,9.86455981941309,999,9.85785785785786
558,440,9.85125448028674,9.875,998,9.86172344689379
558,440,9.84767025089606,9.88409090909091,998,9.86372745490982
545,453,9.84036697247706,9.88962472406181,998,9.8627254509018
548,450,9.83394160583942,9.89333333333333,998,9.86072144288577
550,448,9.82727272727273,9.89955357142857,998,9.85971943887776
545,453,9.84220183486238,9.90949227373068,998,9.87274549098196
535,464,9.83177570093458,9.90948275862069,999,9.86786786786787
535,463,9.84485981308411,9.91144708423326,998,9.87575150300601
532,465,9.84774436090226,9.91397849462366,997,9.87863590772317
539,459,9.84786641929499,9.90196078431373,998,9.87274549098196
551,448,9.84573502722323,9.90401785714286,999,9.87187187187187
558,441,9.84229390681004,9.91383219954649,999,9.87387387387387
557,442,9.85098743267504,9.91628959276018,999,9.87987987987988
557,440,9.84560143626571,9.925,997,9.88064192577733
560,438,9.84821428571429,9.92465753424658,998,9.88176352705411
557,441,9.85098743267504,9.92290249433107,998,9.88276553106212
560,439,9.85357142857143,9.92255125284738,999,9.88388388388388
565,433,9.85132743362832,9.9284064665127,998,9.88476953907816
564,435,9.85460992907801,9.91494252873563,999,9.88088088088088
562,436,9.8576512455516,9.9105504587156,998,9.88076152304609
556,442,9.85791366906475,9.90497737556561,998,9.87875751503006
554,444,9.86642599277978,9.90765765765766,998,9.88476953907816
569,427,9.86643233743409,9.90632318501171,996,9.88353413654619
573,425,9.87434554973822,9.90823529411765,998,9.88877755511022
566,433,9.87102473498233,9.90762124711316,999,9.88688688688689
560,439,9.86428571428571,9.91116173120729,999,9.88488488488488
554,445,9.86642599277978,9.90561797752809,999,9.88388388388388
547,452,9.86837294332724,9.89823008849558,999,9.88188188188188
546,452,9.86080586080586,9.89823008849558,998,9.87775551102204
541,456,9.86876155268022,9.9078947368421,997,9.88665997993982
546,453,9.87912087912088,9.91169977924945,999,9.89389389389389
542,456,9.87084870848708,9.91447368421053,998,9.89078156312625
541,457,9.87800369685767,9.91684901531729,998,9.89579158316633
533,465,9.8874296435272,9.91827956989247,998,9.90180360721443
533,466,9.89118198874296,9.9206008583691,999,9.9049049049049
526,472,9.88973384030418,9.91313559322034,998,9.90080160320641
525,474,9.8952380952381,9.91350210970464,999,9.9039039039039
526,473,9.90684410646388,9.91120507399577,999,9.90890890890891
516,482,9.89922480620155,9.90871369294606,998,9.90380761523046
515,482,9.90097087378641,9.91286307053942,997,9.90672016048144
523,475,9.90630975143404,9.92,998,9.9128256513026
531,467,9.90772128060264,9.91220556745182,998,9.90981963927856
533,465,9.91369606003752,9.91397849462366,998,9.91382765531062
532,467,9.91353383458647,9.90364025695932,999,9.90890890890891
535,464,9.9177570093458,9.90301724137931,999,9.91091091091091
529,469,9.91304347826087,9.91257995735608,998,9.9128256513026
518,479,9.91891891891892,9.90814196242171,997,9.91374122367101
530,469,9.91698113207547,9.90831556503198,999,9.91291291291291
533,465,9.91744840525328,9.92903225806452,998,9.92284569138276
537,462,9.92551210428305,9.94155844155844,999,9.93293293293293
532,465,9.92669172932331,9.94193548387097,997,9.93380140421264
524,475,9.9236641221374,9.94526315789474,999,9.93393393393393
526,472,9.92205323193916,9.94279661016949,998,9.93186372745491
521,478,9.91746641074856,9.94351464435147,999,9.92992992992993
523,474,9.91204588910134,9.94514767932489,997,9.92778335005015
515,484,9.90873786407767,9.94421487603306,999,9.92592592592593
521,477,9.90978886756238,9.94968553459119,998,9.92885771543086
522,477,9.91570881226054,9.94758909853249,999,9.93093093093093
527,472,9.91650853889943,9.95550847457627,999,9.93493493493493
534,464,9.91947565543071,9.95474137931035,998,9.93587174348697
533,465,9.9155722326454,9.94838709677419,998,9.93086172344689
533,466,9.9155722326454,9.94849785407725,999,9.93093093093093
532,465,9.91353383458647,9.94408602150538,997,9.92778335005015
531,467,9.91148775894539,9.94432548179872,998,9.92685370741483
527,471,9.92220113851992,9.94055201698514,998,9.93086172344689
522,477,9.92337164750958,9.94549266247379,999,9.93393393393393
518,480,9.91891891891892,9.94583333333333,998,9.93186372745491
521,478,9.91746641074856,9.93933054393306,999,9.92792792792793
526,473,9.91634980988593,9.93868921775899,999,9.92692692692693
530,469,9.91132075471698,9.9317697228145,999,9.92092092092092
536,461,9.90485074626866,9.93926247288503,997,9.92076228686058
532,467,9.90413533834587,9.94218415417559,999,9.92192192192192
532,467,9.89661654135338,9.94646680942184,999,9.91991991991992
528,471,9.89962121212121,9.93842887473461,999,9.91791791791792
521,477,9.9021113243762,9.93501048218029,998,9.91783567134268
529,469,9.90170132325142,9.94669509594883,998,9.92284569138276
521,476,9.90978886756238,9.93697478991597,997,9.92276830491474
521,477,9.90786948176583,9.94339622641509,998,9.9248496993988
514,485,9.90661478599222,9.94432989690722,999,9.92492492492492
512,487,9.91015625,9.94866529774127,999,9.92892892892893
509,490,9.91944990176817,9.9530612244898,999,9.93593593593594
513,485,9.91812865497076,9.95051546391753,998,9.93386773547094
512,485,9.921875,9.95051546391753,997,9.9358074222668
514,484,9.93190661478599,9.94834710743802,998,9.93987975951904
510,488,9.93333333333333,9.94672131147541,998,9.93987975951904
513,486,9.93372319688109,9.94650205761317,999,9.93993993993994
517,482,9.9458413926499,9.95228215767635,999,9.94894894894895
517,482,9.95744680851064,9.95435684647303,999,9.95595595595596
523,473,9.95793499043977,9.95348837209302,996,9.95582329317269
504,495,9.96230158730159,9.95555555555556,999,9.95895895895896
511,486,9.96086105675147,9.95267489711934,997,9.95687061183551
503,495,9.96421471172962,9.95151515151515,998,9.95791583166333
501,498,9.96606786427146,9.94979919678715,999,9.95795795795796
497,501,9.96177062374245,9.9500998003992,998,9.95591182364729
498,501,9.95582329317269,9.95209580838323,999,9.95395395395395
496,503,9.95967741935484,9.95228628230616,999,9.95595595595596
494,504,9.95951417004049,9.95436507936508,998,9.95691382765531
485,513,9.96288659793814,9.9551656920078,998,9.95891783567134
482,517,9.96473029045643,9.95551257253385,999,9.95995995995996
478,520,9.96443514644352,9.95769230769231,998,9.96092184368737
482,517,9.96680497925311,9.95744680851064,999,9.96196196196196
485,511,9.96288659793814,9.95694716242661,996,9.95983935742972
482,517,9.96265560165975,9.95744680851064,999,9.95995995995996
478,519,9.96652719665272,9.95761078998073,997,9.96188565697091
474,524,9.96413502109705,9.95610687022901,998,9.95991983967936
471,527,9.95966029723992,9.95635673624288,998,9.95791583166333
476,521,9.95798319327731,9.95009596928983,997,9.95386158475426
480,518,9.95833333333333,9.94980694980695,998,9.95390781563126
471,527,9.95329087048832,9.94686907020873,998,9.9498997995992
468,531,9.95299145299145,9.94726930320151,999,9.94994994994995
462,537,9.95670995670996,9.94785847299814,999,9.95195195195195
468,530,9.9551282051282,9.94339622641509,998,9.94889779559118
454,544,9.95374449339207,9.94485294117647,998,9.94889779559118
460,539,9.95869565217391,9.93877551020408,999,9.94794794794795
456,543,9.95394736842105,9.94106813996317,999,9.94694694694695
452,545,9.95796460176991,9.93761467889908,997,9.94684052156469
448,551,9.95535714285714,9.93647912885662,999,9.94494494494494
444,555,9.9527027027027,9.93873873873874,999,9.94494494494494
439,560,9.95216400911162,9.93928571428571,999,9.94494494494494
450,549,9.95333333333333,9.93806921675774,999,9.94494494494494
448,551,9.95089285714286,9.93284936479129,999,9.94094094094094
451,547,9.9490022172949,9.93053016453382,998,9.93887775551102
448,548,9.94196428571429,9.92883211678832,996,9.93473895582329
449,550,9.94877505567929,9.93090909090909,999,9.93893893893894
452,545,9.94690265486726,9.92660550458716,997,9.9358074222668
446,553,9.94394618834081,9.92766726943942,999,9.93493493493493
446,553,9.94394618834081,9.92947558770344,999,9.93593593593594
444,555,9.94594594594595,9.93513513513514,999,9.93993993993994
442,556,9.94570135746606,9.93705035971223,998,9.94088176352705
444,554,9.93918918918919,9.92960288808664,998,9.93386773547094
439,558,9.93849658314351,9.92831541218638,997,9.93279839518556
434,561,9.94239631336406,9.93226381461676,995,9.93668341708543
432,567,9.9375,9.93298059964727,999,9.93493493493493
433,566,9.94688221709007,9.93286219081272,999,9.93893893893894
423,576,9.94326241134752,9.9375,999,9.93993993993994
427,572,9.93911007025761,9.94230769230769,999,9.94094094094094
418,577,9.94497607655502,9.94107452339688,995,9.9427135678392
426,572,9.94131455399061,9.94405594405594,998,9.94288577154309
423,576,9.94326241134752,9.93923611111111,999,9.94094094094094
423,576,9.93853427895981,9.94444444444444,999,9.94194194194194
413,584,9.94915254237288,9.94178082191781,997,9.94483450351053
422,576,9.94549763033175,9.94270833333333,998,9.9438877755511
429,570,9.94405594405594,9.9421052631579,999,9.94294294294294
426,571,9.94131455399061,9.94045534150613,997,9.94082246740221
428,570,9.9392523364486,9.9421052631579,998,9.94088176352705
436,563,9.94036697247706,9.93960923623446,999,9.93993993993994
438,559,9.93150684931507,9.93738819320215,997,9.93480441323972
448,551,9.92857142857143,9.93466424682396,999,9.93193193193193
447,551,9.92393736017897,9.94192377495463,998,9.93386773547094
444,555,9.92567567567568,9.94594594594595,999,9.93693693693694
440,559,9.92954545454545,9.94633273703041,999,9.93893893893894
446,553,9.9304932735426,9.94755877034358,999,9.93993993993994
439,560,9.92938496583144,9.94821428571429,999,9.93993993993994
451,546,9.93348115299335,9.94871794871795,997,9.94182547642929
442,557,9.94117647058824,9.94973070017953,999,9.94594594594595
443,556,9.93905191873589,9.94244604316547,999,9.94094094094094
445,554,9.94157303370786,9.94765342960289,999,9.94494494494494
444,555,9.93468468468468,9.94234234234234,999,9.93893893893894
441,557,9.9297052154195,9.94793536804309,998,9.93987975951904
438,561,9.93607305936073,9.94830659536542,999,9.94294294294294
443,556,9.93227990970655,9.94424460431655,999,9.93893893893894
442,556,9.93665158371041,9.94604316546763,998,9.94188376753507
450,548,9.94222222222222,9.9507299270073,998,9.94689378757515
450,549,9.94666666666667,9.94899817850638,999,9.94794794794795
452,546,9.94469026548673,9.95238095238095,998,9.94889779559118
453,546,9.94701986754967,9.95054945054945,999,9.94894894894895
453,545,9.95364238410596,9.94678899082569,998,9.9498997995992
450,549,9.94666666666667,9.94899817850638,999,9.94794794794795
453,545,9.9514348785872,9.94678899082569,998,9.94889779559118
439,560,9.94305239179954,9.94821428571429,999,9.94594594594595
450,549,9.94888888888889,9.95446265938069,999,9.95195195195195
451,547,9.94678492239468,9.95429616087751,998,9.95090180360721
455,544,9.94285714285714,9.95772058823529,999,9.95095095095095
446,552,9.94394618834081,9.95833333333333,998,9.95190380761523
451,548,9.93791574279379,9.95802919708029,999,9.94894894894895
447,550,9.93736017897092,9.95636363636364,997,9.94784353059178
450,548,9.92888888888889,9.95802919708029,998,9.94488977955912
458,540,9.93013100436681,9.96481481481482,998,9.94889779559118
454,544,9.93171806167401,9.95588235294118,998,9.94488977955912
458,541,9.93231441048035,9.95748613678373,999,9.94594594594595
453,545,9.93156732891832,9.95596330275229,998,9.94488977955912
456,542,9.92763157894737,9.95940959409594,998,9.94488977955912
450,549,9.93333333333333,9.95810564663024,999,9.94694694694695
453,545,9.93818984547461,9.95596330275229,998,9.94789579158317
455,544,9.94065934065934,9.95588235294118,999,9.94894894894895
452,545,9.94247787610619,9.95963302752294,997,9.9518555667001
443,555,9.93905191873589,9.96216216216216,998,9.95190380761523
438,560,9.94063926940639,9.95714285714286,998,9.9498997995992
442,557,9.94343891402715,9.95870736086176,999,9.95195195195195
444,555,9.94144144144144,9.96216216216216,999,9.95295295295295
444,554,9.93693693693694,9.95848375451263,998,9.94889779559118
441,557,9.93424036281179,9.95870736086176,998,9.94789579158317
442,556,9.93665158371041,9.9568345323741,998,9.94789579158317
449,550,9.93541202672606,9.95454545454546,999,9.94594594594595
441,557,9.93877551020408,9.95332136445242,998,9.94689378757515
440,559,9.93636363636364,9.95527728085868,999,9.94694694694695
437,562,9.94279176201373,9.95729537366548,999,9.95095095095095
435,564,9.94252873563218,9.95212765957447,999,9.94794794794795
439,559,9.94305239179954,9.95527728085868,998,9.9498997995992
438,561,9.93835616438356,9.95365418894831,999,9.94694694694695
430,569,9.93953488372093,9.95782073813708,999,9.94994994994995
434,564,9.94700460829493,9.95744680851064,998,9.95290581162325
432,567,9.94444444444444,9.95943562610229,999,9.95295295295295
440,558,9.94772727272727,9.96057347670251,998,9.95490981963928
440,559,9.95227272727273,9.96243291592129,999,9.95795795795796
440,558,9.95454545454546,9.97311827956989,998,9.96492985971944
444,555,9.95945945945946,9.97117117117117,999,9.96596596596597
442,554,9.95475113122172,9.97111913357401,996,9.96385542168675
446,552,9.95739910313901,9.97101449275362,998,9.96492985971944
447,550,9.95525727069351,9.97454545454545,997,9.96589769307924
455,543,9.95384615384615,9.97421731123389,998,9.96492985971944
445,554,9.95280898876404,9.97292418772563,999,9.96396396396396
447,552,9.95078299776286,9.97101449275362,999,9.96196196196196
439,559,9.95671981776765,9.9695885509839,998,9.96392785571142
436,563,9.95412844036697,9.96980461811723,999,9.96296296296296
436,562,9.95642201834862,9.97330960854092,998,9.96593186372746
443,556,9.95936794582393,9.96942446043166,999,9.96496496496496
440,556,9.96590909090909,9.96762589928058,996,9.96686746987952
441,558,9.96371882086168,9.96415770609319,999,9.96396396396396
441,556,9.97052154195011,9.96223021582734,997,9.96589769307924
440,558,9.96818181818182,9.95878136200717,998,9.96292585170341
436,562,9.96559633027523,9.95373665480427,998,9.95891783567134
438,561,9.9634703196347,9.9572192513369,999,9.95995995995996
439,560,9.96127562642369,9.95714285714286,999,9.95895895895896
431,568,9.96055684454756,9.95950704225352,999,9.95995995995996
432,567,9.96296296296296,9.95414462081129,999,9.95795795795796
428,569,9.96028037383178,9.95430579964851,997,9.95687061183551
431,568,9.96287703016241,9.95422535211268,999,9.95795795795796
423,576,9.95981087470449,9.95833333333333,999,9.95895895895896
420,579,9.95714285714286,9.96027633851468,999,9.95895895895896
414,585,9.95893719806763,9.96068376068376,999,9.95995995995996
405,593,9.95802469135803,9.964586846543,998,9.96192384769539
409,590,9.95843520782396,9.96101694915254,999,9.95995995995996
410,589,9.95853658536585,9.95925297113752,999,9.95895895895896
406,593,9.96059113300493,9.96121416526138,999,9.96096096096096
400,599,9.9625,9.95826377295493,999,9.95995995995996
401,598,9.96009975062344,9.95819397993311,999,9.95895895895896
405,594,9.96049382716049,9.95959595959596,999,9.95995995995996
400,597,9.9625,9.96147403685092,997,9.96188565697091
390,607,9.96410256410256,9.96375617792422,997,9.96389167502508
391,608,9.9616368286445,9.96546052631579,999,9.96396396396396
385,614,9.96623376623377,9.96416938110749,999,9.96496496496496
390,609,9.96666666666667,9.96223316912972,999,9.96396396396396
383,616,9.97127937336815,9.96753246753247,999,9.96896896896897
386,613,9.9740932642487,9.9673735725938,999,9.96996996996997
380,618,9.97105263157895,9.96440129449838,998,9.96693386773547
377,622,9.97612732095491,9.96623794212219,999,9.96996996996997
376,623,9.97340425531915,9.96629213483146,999,9.96896896896897
385,613,9.97922077922078,9.96574225122349,998,9.97094188376754
391,608,9.98721227621483,9.9671052631579,999,9.97497497497497
380,619,9.98684210526316,9.96607431340872,999,9.97397397397397
391,608,9.9846547314578,9.96381578947368,999,9.97197197197197
385,614,9.98441558441558,9.96742671009772,999,9.97397397397397
388,610,9.99226804123711,9.9672131147541,998,9.97695390781563
385,612,9.99220779220779,9.9656862745098,997,9.97592778335005
380,617,9.99473684210526,9.96596434359805,997,9.97693079237713
366,629,9.99453551912568,9.96502384737679,995,9.97587939698492
367,632,9.99182561307902,9.96835443037975,999,9.97697697697698
367,630,9.99182561307902,9.97301587301587,997,9.97993981945837
365,633,9.98904109589041,9.97472353870458,998,9.97995991983968
360,639,9.98888888888889,9.97652582159624,999,9.98098098098098
359,639,9.98607242339833,9.97652582159624,998,9.97995991983968
365,631,9.98904109589041,9.97781299524564,996,9.98192771084337
363,636,9.98898071625344,9.9748427672956,999,9.97997997997998
362,636,9.98618784530387,9.97327044025157,998,9.97795591182365
362,636,9.98618784530387,9.97641509433962,998,9.97995991983968
352,646,9.98295454545454,9.97523219814241,998,9.97795591182365
354,645,9.98587570621469,9.97829457364341,999,9.98098098098098
355,643,9.98591549295775,9.97667185069984,998,9.97995991983968
359,640,9.98607242339833,9.975,999,9.97897897897898
359,639,9.98885793871866,9.97652582159624,998,9.9809619238477
357,642,9.98879551820728,9.97196261682243,999,9.97797797797798
352,647,9.98863636363636,9.97217928902628,999,9.97797797797798
355,644,9.9887323943662,9.97204968944099,999,9.97797797797798
350,648,9.98857142857143,9.96913580246914,998,9.97595190380762
351,648,9.98860398860399,9.96913580246914,999,9.97597597597598
353,645,9.99150141643059,9.96899224806202,998,9.97695390781563
348,651,9.99137931034483,9.96927803379416,999,9.97697697697698
354,644,9.98870056497175,9.96739130434783,998,9.9749498997996
350,648,9.99142857142857,9.96913580246914,998,9.97695390781563
352,647,9.99147727272727,9.96908809891808,999,9.97697697697698
348,651,9.98563218390805,9.97235023041475,999,9.97697697697698
352,643,9.98579545454546,9.97667185069984,995,9.97989949748744
346,653,9.98554913294798,9.98009188361409,999,9.98198198198198
344,653,9.98546511627907,9.98009188361409,997,9.98194583751254
335,662,9.98208955223881,9.9833836858006,997,9.98294884653962
335,662,9.98208955223881,9.9833836858006,997,9.98294884653962
342,657,9.98245614035088,9.98021308980213,999,9.98098098098098
340,659,9.97941176470588,9.98179059180577,999,9.98098098098098
346,653,9.97976878612717,9.98315467075038,999,9.98198198198198
337,661,9.97626112759644,9.98184568835098,998,9.97995991983968
332,667,9.9789156626506,9.98200899550225,999,9.98098098098098
336,663,9.98214285714286,9.98190045248869,999,9.98198198198198
332,667,9.98795180722892,9.98200899550225,999,9.98398398398398
330,669,9.98787878787879,9.97757847533632,999,9.98098098098098
331,668,9.98791540785498,9.98203592814371,999,9.98398398398398
340,659,9.98823529411765,9.98330804248862,999,9.98498498498498
341,658,9.98826979472141,9.98024316109423,999,9.98298298298298
344,654,9.98837209302326,9.98012232415902,998,9.98296593186373
349,650,9.98853868194842,9.97846153846154,999,9.98198198198198
344,654,9.98837209302326,9.97859327217125,998,9.98196392785571
340,657,9.98529411764706,9.97716894977169,997,9.97993981945837
327,672,9.98776758409786,9.97619047619048,999,9.97997997997998
327,672,9.98776758409786,9.97767857142857,999,9.98098098098098
326,671,9.98466257668712,9.97615499254844,997,9.97893681043129
328,670,9.98475609756098,9.97313432835821,998,9.97695390781563
332,667,9.98493975903614,9.97301349325337,999,9.97697697697698
330,668,9.98181818181818,9.97155688622754,998,9.9749498997996
332,665,9.98493975903614,9.97142857142857,997,9.97592778335005
325,674,9.97846153846154,9.97626112759644,999,9.97697697697698
315,683,9.97777777777778,9.97510980966325,998,9.97595190380762
314,685,9.97452229299363,9.97518248175182,999,9.97497497497497
323,675,9.97523219814241,9.9762962962963,998,9.97595190380762
321,677,9.97819314641745,9.97341211225997,998,9.9749498997996
327,671,9.97247706422018,9.97615499254844,998,9.9749498997996
330,669,9.97878787878788,9.97309417040359,999,9.97497497497497
330,669,9.97272727272727,9.97608370702541,999,9.97497497497497
321,678,9.97507788161994,9.97492625368732,999,9.97497497497497
325,674,9.97538461538462,9.97477744807122,999,9.97497497497497
336,662,9.97321428571429,9.97280966767372,998,9.97294589178357
335,664,9.97313432835821,9.97289156626506,999,9.97297297297297
339,658,9.97050147492625,9.96960486322188,997,9.96990972918756
330,669,9.97575757575758,9.97010463378176,999,9.97197197197197
323,676,9.97523219814241,9.9689349112426,999,9.97097097097097
327,671,9.97553516819572,9.96870342771982,998,9.97094188376754
334,664,9.97604790419162,9.96686746987952,998,9.96993987975952
346,651,9.97687861271676,9.96620583717358,997,9.96990972918756
344,654,9.97383720930233,9.97094801223242,998,9.97194388777555
355,643,9.98309859154929,9.9751166407465,998,9.97795591182365
350,646,9.98285714285714,9.97523219814241,996,9.97791164658635
349,650,9.98280802292264,9.97692307692308,999,9.97897897897898
345,653,9.98260869565217,9.9739663093415,998,9.97695390781563
344,655,9.98546511627907,9.97709923664122,999,9.97997997997998
342,655,9.98538011695906,9.97709923664122,997,9.97993981945837
347,652,9.98847262247839,9.97852760736196,999,9.98198198198198
339,660,9.98525073746313,9.97575757575758,999,9.97897897897898
346,653,9.98843930635838,9.97702909647779,999,9.98098098098098
338,661,9.98816568047337,9.97579425113464,999,9.97997997997998
344,655,9.98255813953488,9.97557251908397,999,9.97797797797798
336,663,9.98214285714286,9.97435897435897,999,9.97697697697698
348,650,9.97988505747126,9.97384615384615,998,9.97595190380762
347,652,9.97982708933718,9.97085889570552,999,9.97397397397397
348,650,9.97701149425287,9.97230769230769,998,9.97394789579158
347,652,9.98270893371758,9.97085889570552,999,9.97497497497497
350,649,9.98571428571429,9.97380585516179,999,9.97797797797798
342,656,9.98245614035088,9.97408536585366,998,9.97695390781563
346,653,9.98554913294798,9.97549770290965,999,9.97897897897898
343,656,9.98542274052478,9.97560975609756,999,9.97897897897898
345,653,9.98550724637681,9.97549770290965,998,9.97895791583166
346,653,9.98265895953757,9.97549770290965,999,9.97797797797798
351,648,9.98290598290598,9.97530864197531,999,9.97797797797798
346,652,9.98265895953757,9.9739263803681,998,9.97695390781563
351,647,9.98290598290598,9.97527047913447,998,9.97795591182365
347,650,9.98270893371758,9.97538461538462,997,9.97793380140421
353,646,9.98583569405099,9.97213622291022,999,9.97697697697698
351,647,9.98575498575499,9.97217928902628,998,9.97695390781563
351,648,9.98575498575499,9.96913580246914,999,9.97497497497497
345,653,9.98840579710145,9.96937212863706,998,9.97595190380762
344,654,9.99127906976744,9.96788990825688,998,9.97595190380762
351,648,9.99145299145299,9.96759259259259,999,9.97597597597598
350,648,9.99428571428571,9.96296296296296,998,9.97394789579158
346,652,9.99421965317919,9.96165644171779,998,9.97294589178357
338,659,9.99408284023669,9.96054628224583,997,9.97191574724173
334,664,9.9940119760479,9.96084337349398,998,9.97194388777555
338,659,9.99408284023669,9.96206373292868,997,9.97291875626881
347,652,9.99423631123919,9.95705521472393,999,9.96996996996997
349,649,9.99426934097421,9.95685670261942,998,9.96993987975952
345,654,9.99130434782609,9.95718654434251,999,9.96896896896897
350,647,9.99142857142857,9.95826893353941,997,9.96990972918756
353,646,9.98866855524079,9.96130030959752,999,9.97097097097097
359,640,9.991643454039,9.9609375,999,9.97197197197197
358,640,9.99441340782123,9.9625,998,9.97394789579158
367,632,9.99455040871935,9.96360759493671,999,9.97497497497497
363,636,9.99173553719008,9.9622641509434,999,9.97297297297297
358,641,9.99441340782123,9.96411856474259,999,9.97497497497497
356,640,9.99719101123596,9.9625,996,9.97489959839357
365,633,10.0,9.96208530805687,998,9.97595190380762
362,637,10.0,9.96389324960754,999,9.97697697697698
359,639,10.0,9.96400625978091,998,9.97695390781563
359,639,10.0,9.96400625978091,998,9.97695390781563
363,635,10.0,9.96062992125984,998,9.9749498997996
368,631,10.0,9.96038034865293,999,9.97497497497497
380,616,10.0,9.96103896103896,996,9.97590361445783
374,624,10.0,9.96153846153846,998,9.97595190380762
383,616,10.0,9.96428571428571,999,9.97797797797798
379,619,10.0,9.96607431340872,998,9.97895791583166
371,628,10.0,9.96496815286624,999,9.97797797797798
365,634,10.0,9.96529968454259,999,9.97797797797798
370,629,10.0,9.96502384737679,999,9.97797797797798
373,624,10.0,9.96314102564103,997,9.97693079237713
380,618,10.0,9.96116504854369,998,9.97595190380762
381,618,10.0,9.96116504854369,999,9.97597597597598
394,605,10.0,9.96198347107438,999,9.97697697697698
387,612,10.0,9.9640522875817,999,9.97797797797798
382,617,10.0,9.96272285251216,999,9.97697697697698
381,616,10.0,9.96590909090909,997,9.97893681043129
380,619,10.0,9.96284329563813,999,9.97697697697698
378,619,10.0,9.96768982229402,997,9.97993981945837
374,624,10.0,9.96634615384615,998,9.97895791583166
381,618,10.0,9.96440129449838,999,9.97797797797798
381,618,10.0,9.97087378640777,999,9.98198198198198
389,609,10.0,9.96715927750411,998,9.97995991983968
387,611,10.0,9.96890343698854,998,9.9809619238477
388,610,10.0,9.9655737704918,998,9.97895791583166
383,616,10.0,9.96428571428571,999,9.97797797797798
383,616,10.0,9.96590909090909,999,9.97897897897898
380,617,10.0,9.96596434359805,997,9.97893681043129
372,626,10.0,9.96485623003195,998,9.97795591182365
376,622,10.0,9.96463022508039,998,9.97795591182365
371,627,10.0,9.97288676236045,998,9.98296593186373
369,629,10.0,9.96820349761526,998,9.97995991983968
370,628,10.0,9.96974522292994,998,9.9809619238477
373,625,10.0,9.9664,998,9.97895791583166
371,628,10.0,9.97133757961783,999,9.98198198198198
378,621,10.0,9.96940418679549,999,9.98098098098098
381,617,10.0,9.9740680713128,998,9.98396793587174
386,611,10.0,9.97545008183306,997,9.98495486459378
393,606,10.0,9.97524752475248,999,9.98498498498498
397,601,10.0,9.97670549084859,998,9.98597194388778
395,604,10.0,9.97516556291391,999,9.98498498498498
404,594,10.0,9.97643097643098,998,9.98597194388778
404,595,10.0,9.9781512605042,999,9.98698698698699
402,597,10.0,9.97654941373534,999,9.98598598598599
405,593,10.0,9.97807757166948,998,9.98697394789579
410,587,10.0,9.97274275979557,997,9.9839518555667
406,592,10.0,9.97804054054054,998,9.98697394789579
411,586,10.0,9.97952218430034,997,9.98796389167503
406,593,10.0,9.98482293423272,999,9.99099099099099
405,592,10.0,9.98141891891892,997,9.98896690070211
403,595,10.0,9.97983193277311,998,9.98797595190381
406,592,10.0,9.97635135135135,998,9.98597194388778
409,588,10.0,9.97448979591837,997,9.98495486459378
411,588,10.0,9.97278911564626,999,9.98398398398398
409,589,10.0,9.97283531409168,998,9.98396793587174
417,581,10.0,9.96901893287435,998,9.98196392785571
415,584,10.0,9.96917808219178,999,9.98198198198198
406,593,10.0,9.96627318718381,999,9.97997997997998
407,592,10.0,9.96452702702703,999,9.97897897897898
401,597,10.0,9.96649916247906,998,9.97995991983968
400,598,10.0,9.96488294314381,998,9.97895791583166
402,596,10.0,9.96140939597315,998,9.97695390781563
395,604,10.0,9.96026490066225,999,9.97597597597598
388,611,10.0,9.95908346972177,999,9.97497497497497
387,612,10.0,9.95915032679738,999,9.97497497497497
380,617,10.0,9.96434359805511,997,9.97793380140421
382,615,10.0,9.96260162601626,997,9.97693079237713
376,623,10.0,9.95987158908507,999,9.97497497497497
373,625,10.0,9.9616,998,9.97595190380762
373,626,10.0,9.96006389776358,999,9.97497497497497
369,630,10.0,9.96190476190476,999,9.97597597597598
369,628,10.0,9.96496815286624,997,9.97793380140421
373,625,10.0,9.9632,998,9.97695390781563
370,628,10.0,9.95859872611465,998,9.97394789579158
375,623,10.0,9.95666131621188,998,9.97294589178357
369,628,10.0,9.96178343949045,997,9.97592778335005
378,621,10.0,9.9597423510467,999,9.97497497497497
380,615,10.0,9.95772357723577,995,9.97386934673367
384,613,10.0,9.95269168026101,997,9.97091273821464
385,614,10.0,9.94951140065147,999,9.96896896896897
378,620,10.0,9.94838709677419,998,9.96793587174349
376,623,10.0,9.95024077046549,999,9.96896896896897
379,619,10.0,9.94830371567044,998,9.96793587174349
378,621,10.0,9.95008051529791,999,9.96896896896897
375,621,10.0,9.95330112721417,996,9.97088353413655
367,632,10.0,9.96044303797468,999,9.97497497497497
372,626,10.0,9.95846645367412,998,9.97394789579158
375,623,10.0,9.95987158908507,998,9.9749498997996
378,619,10.0,9.95961227786753,997,9.97492477432297
388,610,10.0,9.96065573770492,998,9.97595190380762
384,615,10.0,9.9609756097561,999,9.97597597597598
390,608,10.0,9.96546052631579,998,9.97895791583166
393,605,10.0,9.96694214876033,998,9.97995991983968
395,603,10.0,9.96849087893864,998,9.9809619238477
395,604,10.0,9.96688741721854,999,9.97997997997998
400,599,10.0,9.96327212020033,999,9.97797797797798
397,602,10.0,9.96179401993355,999,9.97697697697698
397,602,10.0,9.96511627906977,999,9.97897897897898
394,603,10.0,9.96517412935323,997,9.97893681043129
387,612,10.0,9.96241830065359,999,9.97697697697698
386,612,10.0,9.96241830065359,998,9.97695390781563
372,627,10.0,9.96491228070176,999,9.97797797797798
376,622,10.0,9.95980707395498,998,9.9749498997996
376,621,10.0,9.96457326892109,997,9.97793380140421
375,622,10.0,9.95819935691318,997,9.97392176529589
374,624,10.0,9.95352564102564,998,9.97094188376754
370,628,10.0,9.95382165605096,998,9.97094188376754
370,629,10.0,9.95071542130366,999,9.96896896896897
366,633,10.0,9.95576619273302,999,9.97197197197197
364,634,10.0,9.94952681388013,998,9.96793587174349
368,631,10.0,9.94928684627575,999,9.96796796796797
365,634,10.0,9.94321766561514,999,9.96396396396396
369,629,10.0,9.94753577106518,998,9.96693386773547
363,633,10.0,9.95102685624013,996,9.96887550200803
353,644,10.0,9.9472049689441,997,9.96589769307924
364,635,10.0,9.94645669291339,999,9.96596596596597
362,637,10.0,9.94348508634223,999,9.96396396396396
366,632,10.0,9.95253164556962,998,9.96993987975952
366,633,10.0,9.94944707740916,999,9.96796796796797
372,627,10.0,9.95215311004785,999,9.96996996996997
368,630,10.0,9.95238095238095,998,9.96993987975952
372,626,10.0,9.95367412140575,998,9.97094188376754
383,614,10.0,9.94951140065147,997,9.96890672016048
392,607,10.0,9.94892915980231,999,9.96896896896897
405,594,10.0,9.95959595959596,999,9.97597597597598
410,588,10.0,9.95748299319728,998,9.9749498997996
405,593,10.0,9.95615514333895,998,9.97394789579158
393,605,10.0,9.95371900826446,998,9.97194388777555
397,601,10.0,9.96006655574043,998,9.97595190380762
398,601,10.0,9.96339434276206,999,9.97797797797798
397,599,10.0,9.96160267111853,996,9.97690763052209
403,594,10.0,9.96464646464647,997,9.97893681043129
401,598,10.0,9.96321070234114,999,9.97797797797798
403,595,10.0,9.96470588235294,998,9.97895791583166
401,597,10.0,9.96984924623116,998,9.98196392785571
408,591,10.0,9.9746192893401,999,9.98498498498498
400,597,10.0,9.9715242881072,997,9.98294884653962
395,604,10.0,9.97185430463576,999,9.98298298298298
390,608,10.0,9.9703947368421,998,9.98196392785571
