forward_num,reverse_num,forward_rate,reverse_rate,organism_num,organism_rate
500,500,5.5,5.5,1000,5.5
496,495,5.50403225806452,5.52323232323232,991,5.51362260343088
493,492,5.50507099391481,5.51829268292683,985,5.51167512690355
549,449,5.54098360655738,5.46102449888641,998,5.50501002004008
582,416,5.67182130584192,5.40625,998,5.56112224448898
618,381,5.66019417475728,5.34645669291339,999,5.54054054054054
655,344,5.61374045801527,5.41860465116279,999,5.54654654654655
672,326,5.62202380952381,5.4079754601227,998,5.55210420841683
696,303,5.59770114942529,5.38613861386139,999,5.53353353353353
711,287,5.62025316455696,5.39721254355401,998,5.5561122244489
682,316,5.62316715542522,4.96518987341772,998,5.41482965931864
703,296,5.55049786628734,5.01351351351351,999,5.39139139139139
712,285,5.66292134831461,4.94736842105263,997,5.45837512537613
686,311,5.63119533527697,4.90353697749196,997,5.40421263791374
683,315,5.53879941434846,5.00952380952381,998,5.37174348697395
681,318,5.61380323054332,5.12264150943396,999,5.45745745745746
690,307,5.56811594202899,5.10749185667752,997,5.42627883650953
697,300,5.54088952654232,5.12,997,5.41424272818455
676,323,5.65236686390533,5.13622291021672,999,5.48548548548549
682,317,5.70821114369501,5.21766561514196,999,5.55255255255255
717,279,5.70013947001395,5.2258064516129,996,5.56726907630522
742,256,5.7345013477089,5.2109375,998,5.6002004008016
705,293,5.72340425531915,5.09556313993174,998,5.53907815631263
715,282,5.78881118881119,5.09929078014184,997,5.5937813440321
727,271,5.75103163686382,5.04059040590406,998,5.55811623246493
706,290,5.75779036827196,5.15172413793103,996,5.58132530120482
725,273,5.68689655172414,5.10989010989011,998,5.52905811623246
727,271,5.75653370013755,5.16605166051661,998,5.59619238476954
733,266,5.79263301500682,5.16917293233083,999,5.62662662662663
725,273,5.72827586206897,5.17582417582418,998,5.57715430861723
737,262,5.69063772048847,5.23282442748092,999,5.57057057057057
735,263,5.64625850340136,5.26996197718631,998,5.54709418837675
720,277,5.68472222222222,5.25270758122744,997,5.56469408224674
721,277,5.66851595006935,5.22021660649819,998,5.54408817635271
728,271,5.68543956043956,5.25461254612546,999,5.56856856856857
740,259,5.7,5.26640926640927,999,5.58758758758759
734,264,5.71525885558583,5.21969696969697,998,5.58416833667335
741,258,5.75168690958165,5.13565891472868,999,5.59259259259259
746,252,5.77479892761394,5.09126984126984,998,5.60220440881764
750,248,5.83333333333333,5.14516129032258,998,5.6623246492986
753,244,5.79946879150066,5.23770491803279,997,5.66198595787362
760,238,5.69736842105263,5.26050420168067,998,5.59318637274549
774,225,5.69767441860465,5.24444444444444,999,5.5955955955956
771,228,5.73151750972763,5.18859649122807,999,5.60760760760761
766,233,5.72062663185379,5.17167381974249,999,5.59259259259259
760,236,5.74342105263158,5.08898305084746,996,5.58835341365462
761,236,5.77398160315374,5.19067796610169,997,5.63590772316951
763,236,5.77981651376147,5.22457627118644,999,5.64864864864865
757,240,5.83223249669749,5.30416666666667,997,5.70511534603811
765,234,5.81307189542484,5.23931623931624,999,5.67867867867868
758,241,5.81002638522427,5.3402489626556,999,5.6966966966967
749,250,5.84245660881175,5.28,999,5.7017017017017
760,238,5.76710526315789,5.39075630252101,998,5.67735470941884
769,230,5.76592977893368,5.40869565217391,999,5.68368368368368
770,229,5.78831168831169,5.45414847161572,999,5.71171171171171
768,230,5.734375,5.5,998,5.68036072144289
774,225,5.72222222222222,5.40888888888889,999,5.65165165165165
770,229,5.79090909090909,5.4410480349345,999,5.71071071071071
767,232,5.84485006518905,5.29310344827586,999,5.71671671671672
764,235,5.84816753926702,5.34893617021277,999,5.73073073073073
764,235,5.8520942408377,5.28936170212766,999,5.71971971971972
768,231,5.92317708333333,5.45454545454545,999,5.81481481481481
772,225,5.94948186528497,5.35111111111111,997,5.81444332998997
778,221,5.9318766066838,5.42986425339367,999,5.82082082082082
773,225,5.98188874514877,5.36,998,5.84168336673347
779,220,5.9602053915276,5.45454545454545,999,5.84884884884885
781,216,5.93982074263764,5.37037037037037,997,5.81644934804413
782,214,5.96035805626599,5.48130841121495,996,5.8574297188755
787,211,5.90216010165184,5.47867298578199,998,5.812625250501
784,212,5.85331632653061,5.41981132075472,996,5.76104417670683
783,216,5.82886334610473,5.40277777777778,999,5.73673673673674
779,218,5.8395378690629,5.48623853211009,997,5.76228686058174
772,227,5.77849740932642,5.48898678414097,999,5.71271271271271
772,226,5.71373056994819,5.49115044247788,998,5.66332665330661
776,223,5.72938144329897,5.46636771300448,999,5.67067067067067
782,216,5.74424552429667,5.5,998,5.69138276553106
781,217,5.7067861715749,5.55299539170507,998,5.67334669338677
772,227,5.66709844559585,5.49339207048458,999,5.62762762762763
775,223,5.64258064516129,5.47085201793722,998,5.60420841683367
778,221,5.6452442159383,5.45701357466063,999,5.6036036036036
774,225,5.66020671834625,5.41333333333333,999,5.6046046046046
778,220,5.68766066838046,5.48636363636364,998,5.64328657314629
782,217,5.66624040920716,5.46543778801843,999,5.62262262262262
788,211,5.69162436548223,5.43127962085308,999,5.63663663663664
781,218,5.71830985915493,5.44036697247706,999,5.65765765765766
776,223,5.71134020618557,5.44843049327354,999,5.65265265265265
777,222,5.6962676962677,5.46396396396396,999,5.64464464464464
770,229,5.69090909090909,5.5589519650655,999,5.66066066066066
772,227,5.64378238341969,5.52422907488987,999,5.61661661661662
769,230,5.63459037711313,5.43478260869565,999,5.58858858858859
773,226,5.65588615782665,5.44247787610619,999,5.60760760760761
776,222,5.64046391752577,5.41441441441441,998,5.59018036072144
772,225,5.66839378238342,5.40444444444444,997,5.60882647943832
770,228,5.66363636363636,5.39912280701754,998,5.60320641282565
771,228,5.6420233463035,5.37719298245614,999,5.58158158158158
764,234,5.62303664921466,5.34615384615385,998,5.55811623246493
769,229,5.6592977893368,5.29694323144105,998,5.57615230460922
775,223,5.65161290322581,5.31838565022422,998,5.57715430861723
778,220,5.64910025706941,5.33181818181818,998,5.57915831663327
781,216,5.67605633802817,5.26388888888889,997,5.58676028084253
778,221,5.68508997429306,5.33031674208145,999,5.60660660660661
769,229,5.67880364109233,5.35371179039301,998,5.60420841683367
763,235,5.6867627785059,5.28936170212766,998,5.59318637274549
765,233,5.7281045751634,5.3175965665236,998,5.63226452905812
767,230,5.71577574967406,5.3695652173913,997,5.63590772316951
758,240,5.66490765171504,5.32083333333333,998,5.58216432865731
761,238,5.65308804204993,5.26050420168067,999,5.55955955955956
764,235,5.69764397905759,5.28510638297872,999,5.6006006006006
754,245,5.6710875331565,5.3265306122449,999,5.58658658658659
754,245,5.57692307692308,5.37959183673469,999,5.52852852852853
747,250,5.54618473895582,5.284,997,5.48044132397192
747,252,5.5756358768407,5.20634920634921,999,5.48248248248248
751,247,5.53395472703063,5.34008097165992,998,5.48597194388778
759,240,5.58102766798419,5.29583333333333,999,5.51251251251251
753,246,5.65338645418327,5.25609756097561,999,5.55555555555556
762,237,5.6259842519685,5.18565400843882,999,5.52152152152152
760,235,5.64078947368421,5.2936170212766,995,5.55879396984925
754,243,5.6657824933687,5.26748971193416,997,5.56870611835507
755,244,5.67814569536424,5.27459016393443,999,5.57957957957958
762,236,5.66666666666667,5.28389830508475,998,5.57615230460922
762,236,5.63648293963255,5.26271186440678,998,5.54809619238477
753,245,5.63213811420983,5.29387755102041,998,5.54909819639279
752,247,5.60904255319149,5.30769230769231,999,5.53453453453453
745,254,5.59194630872483,5.40551181102362,999,5.54454454454454
755,244,5.53509933774834,5.45491803278689,999,5.51551551551552
740,258,5.54864864864865,5.44961240310078,998,5.52304609218437
741,257,5.53306342780027,5.49805447470817,998,5.52404809619238
735,263,5.48843537414966,5.46007604562738,998,5.48096192384769
726,272,5.51928374655647,5.50735294117647,998,5.51603206412826
728,268,5.48901098901099,5.58955223880597,996,5.51606425702811
733,265,5.5225102319236,5.53207547169811,998,5.5250501002004
734,265,5.51362397820164,5.49811320754717,999,5.50950950950951
735,264,5.54285714285714,5.52651515151515,999,5.53853853853854
727,272,5.60110041265475,5.52205882352941,999,5.57957957957958
735,263,5.61496598639456,5.46007604562738,998,5.57414829659319
741,257,5.65856950067476,5.4863813229572,998,5.61422845691383
750,249,5.68533333333333,5.37751004016064,999,5.60860860860861
738,261,5.69647696476965,5.44827586206897,999,5.63163163163163
735,264,5.78095238095238,5.55681818181818,999,5.72172172172172
743,256,5.79004037685061,5.52734375,999,5.72272272272272
741,258,5.7638326585695,5.50387596899225,999,5.6966966966967
742,256,5.7088948787062,5.44921875,998,5.64228456913828
738,259,5.67750677506775,5.50965250965251,997,5.63390170511535
737,261,5.59972862957938,5.44444444444444,998,5.55911823647295
739,257,5.51962110960758,5.43190661478599,996,5.49698795180723
750,249,5.51466666666667,5.34136546184739,999,5.47147147147147
746,252,5.5254691689008,5.40873015873016,998,5.49599198396794
746,253,5.47855227882038,5.43873517786561,999,5.46846846846847
744,254,5.51881720430108,5.46850393700787,998,5.5060120240481
756,243,5.48015873015873,5.45267489711934,999,5.47347347347347
754,244,5.52785145888594,5.54098360655738,998,5.5310621242485
757,241,5.54557463672391,5.5643153526971,998,5.5501002004008
755,242,5.57748344370861,5.52066115702479,997,5.56369107321966
747,252,5.57295850066934,5.47619047619048,999,5.54854854854855
744,255,5.57123655913978,5.41176470588235,999,5.53053053053053
747,252,5.5756358768407,5.32539682539683,999,5.51251251251251
754,244,5.54111405835544,5.3155737704918,998,5.48597194388778
753,246,5.52456839309429,5.39024390243902,999,5.49149149149149
752,247,5.53324468085106,5.4331983805668,999,5.50850850850851
757,242,5.52972258916777,5.32231404958678,999,5.47947947947948
761,238,5.55453350854139,5.45798319327731,999,5.53153153153153
764,235,5.52094240837696,5.31489361702128,999,5.47247247247247
766,232,5.51827676240209,5.43965517241379,998,5.5
766,232,5.58355091383812,5.45258620689655,998,5.55310621242485
760,239,5.57894736842105,5.49372384937239,999,5.55855855855856
760,239,5.57763157894737,5.55230125523013,999,5.57157157157157
763,236,5.58453473132372,5.50847457627119,999,5.56656656656657
768,230,5.56119791666667,5.59565217391304,998,5.56913827655311
757,242,5.54689564068692,5.6198347107438,999,5.56456456456456
771,227,5.46952010376135,5.62114537444934,998,5.50400801603206
773,225,5.49417852522639,5.52888888888889,998,5.50200400801603
762,236,5.53412073490814,5.58474576271186,998,5.54609218436874
767,232,5.62842242503259,5.62931034482759,999,5.62862862862863
766,232,5.61227154046997,5.55603448275862,998,5.59919839679359
767,230,5.59713168187744,5.47826086956522,997,5.56970912738215
765,234,5.56339869281046,5.53418803418803,999,5.55655655655656
765,230,5.56993464052288,5.60434782608696,995,5.57788944723618
769,227,5.58907672301691,5.60352422907489,996,5.59236947791165
768,231,5.56380208333333,5.60606060606061,999,5.57357357357357
765,232,5.52549019607843,5.60344827586207,997,5.54363089267803
762,237,5.52755905511811,5.65400843881857,999,5.55755755755756
767,231,5.57366362451108,5.75324675324675,998,5.61523046092184
766,233,5.5509138381201,5.69098712446352,999,5.58358358358358
761,238,5.52431011826544,5.88235294117647,999,5.60960960960961
763,235,5.50327653997379,5.71914893617021,998,5.55410821643287
765,234,5.48366013071895,5.65811965811966,999,5.52452452452452
761,237,5.53219448094612,5.69620253164557,998,5.57114228456914
762,236,5.52099737532808,5.76271186440678,998,5.57815631262525
765,234,5.51503267973856,5.80769230769231,999,5.58358358358358
766,233,5.50130548302872,5.78111587982833,999,5.56656656656657
776,223,5.45618556701031,5.7085201793722,999,5.51251251251251
775,224,5.5058064516129,5.72767857142857,999,5.55555555555556
769,229,5.50715214564369,5.68122270742358,998,5.54709418837675
760,238,5.49605263157895,5.77731092436975,998,5.56312625250501
764,234,5.55497382198953,5.7991452991453,998,5.6122244488978
766,233,5.52088772845953,5.84549356223176,999,5.5965965965966
767,232,5.54237288135593,5.82327586206897,999,5.60760760760761
776,223,5.57603092783505,5.78923766816143,999,5.62362362362362
772,227,5.54015544041451,5.70044052863436,999,5.57657657657658
774,225,5.59043927648579,5.76,999,5.62862862862863
774,223,5.67441860465116,5.69506726457399,997,5.679037111334
766,232,5.68015665796345,5.75862068965517,998,5.69839679358717
770,227,5.63506493506493,5.75330396475771,997,5.66198595787362
777,222,5.6023166023166,5.76576576576577,999,5.63863863863864
771,228,5.64332036316472,5.78070175438596,999,5.67467467467467
779,220,5.64826700898588,5.87272727272727,999,5.6976976976977
780,219,5.67435897435897,5.98630136986301,999,5.74274274274274
791,207,5.69532237673831,5.98550724637681,998,5.75551102204409
796,202,5.71984924623116,5.94059405940594,998,5.76452905811623
794,204,5.71410579345088,6.0,998,5.77254509018036
785,213,5.67006369426752,5.94366197183099,998,5.72845691382765
789,210,5.62357414448669,5.93809523809524,999,5.68968968968969
780,219,5.65897435897436,5.82191780821918,999,5.69469469469469
778,221,5.67866323907455,5.80090497737557,999,5.70570570570571
773,225,5.65976714100906,5.76444444444444,998,5.68336673346693
765,234,5.65882352941177,5.71794871794872,999,5.67267267267267
763,236,5.70642201834862,5.73305084745763,999,5.71271271271271
759,240,5.67325428194993,5.82916666666667,999,5.71071071071071
763,236,5.64744429882045,5.75,999,5.67167167167167
759,239,5.64426877470356,5.75732217573222,998,5.67134268537074
767,232,5.61277705345502,5.73706896551724,999,5.64164164164164
772,227,5.58290155440415,5.70925110132159,999,5.61161161161161
768,228,5.57942708333333,5.66666666666667,996,5.59939759036145
770,228,5.54805194805195,5.70175438596491,998,5.58316633266533
774,224,5.53617571059432,5.75892857142857,998,5.58617234468938
772,226,5.55829015544041,5.76106194690265,998,5.60420841683367
764,235,5.52486910994764,5.7531914893617,999,5.57857857857858
771,228,5.56679636835279,5.73245614035088,999,5.6046046046046
772,226,5.55829015544041,5.73893805309735,998,5.59919839679359
763,236,5.56880733944954,5.72457627118644,999,5.60560560560561
761,238,5.51642575558476,5.74789915966387,999,5.57157157157157
759,238,5.54808959156785,5.81932773109244,997,5.61283851554664
770,228,5.61688311688312,5.89035087719298,998,5.67935871743487
774,225,5.58268733850129,5.87111111111111,999,5.64764764764765
762,237,5.60367454068242,5.79746835443038,999,5.64964964964965
770,229,5.54805194805195,5.85152838427948,999,5.61761761761762
769,229,5.53055916775032,5.73362445414847,998,5.57715430861723
767,232,5.50456323337679,5.77155172413793,999,5.56656656656657
761,237,5.45860709592641,5.77215189873418,998,5.53306613226453
757,241,5.4782034346103,5.81327800829875,998,5.55911823647295
765,234,5.45751633986928,5.72649572649573,999,5.52052052052052
761,238,5.50722733245729,5.82773109243697,999,5.58358358358358
758,240,5.48812664907652,5.72083333333333,998,5.54408817635271
758,241,5.54881266490765,5.67219917012448,999,5.57857857857858
755,243,5.56158940397351,5.72839506172839,998,5.60220440881764
748,247,5.5307486631016,5.67611336032389,995,5.56683417085427
754,245,5.57029177718833,5.74285714285714,999,5.61261261261261
753,246,5.59096945551129,5.82520325203252,999,5.64864864864865
740,259,5.6027027027027,5.76833976833977,999,5.64564564564565
740,258,5.58108108108108,5.84883720930233,998,5.6503006012024
743,256,5.54777927321669,5.82421875,999,5.61861861861862
739,259,5.60757780784844,5.84555984555985,998,5.66933867735471
740,259,5.5527027027027,5.77220077220077,999,5.60960960960961
733,266,5.62073669849932,5.69924812030075,999,5.64164164164164
741,256,5.61268556005398,5.65234375,997,5.62286860581745
745,254,5.60671140939597,5.79133858267717,999,5.65365365365365
743,255,5.63391655450875,5.8,998,5.67635270541082
753,246,5.64807436918991,5.88617886178862,999,5.70670670670671
750,249,5.63066666666667,5.88755020080321,999,5.69469469469469
757,242,5.58520475561427,5.76859504132231,999,5.62962962962963
755,242,5.53907284768212,5.82644628099174,997,5.60882647943832
755,244,5.54834437086093,5.90573770491803,999,5.63563563563564
756,243,5.55820105820106,5.91358024691358,999,5.64464464464464
754,245,5.57161803713528,5.88979591836735,999,5.64964964964965
749,250,5.59412550066756,5.888,999,5.66766766766767
750,249,5.54533333333333,5.95983935742972,999,5.64864864864865
745,250,5.54228187919463,6.0,995,5.6572864321608
740,259,5.50405405405405,5.93050193050193,999,5.61461461461461
735,263,5.51836734693878,5.93155893536122,998,5.62725450901804
740,259,5.47837837837838,5.83783783783784,999,5.57157157157157
732,265,5.47540983606557,5.92075471698113,997,5.5937813440321
741,254,5.41565452091768,5.95669291338583,995,5.55376884422111
748,250,5.45454545454545,5.944,998,5.57715430861723
742,256,5.49056603773585,5.9375,998,5.60521042084168
748,251,5.5,6.00796812749004,999,5.62762762762763
745,252,5.51946308724832,6.09920634920635,997,5.66599799398195
746,251,5.50938337801609,6.04382470119522,997,5.64393179538616
753,245,5.50996015936255,6.11020408163265,998,5.65731462925852
748,250,5.45320855614973,6.012,998,5.59318637274549
750,249,5.516,5.91967871485944,999,5.61661661661662
750,248,5.48133333333333,5.80241935483871,998,5.56112224448898
763,236,5.49803407601573,5.75423728813559,999,5.55855855855856
754,245,5.49602122015915,5.74285714285714,999,5.55655655655656
755,244,5.45298013245033,5.75,999,5.52552552552553
753,245,5.40637450199203,5.68163265306122,998,5.47394789579158
762,236,5.40157480314961,5.67796610169492,998,5.46693386773547
758,240,5.40765171503958,5.65,998,5.46593186372746
761,238,5.4796320630749,5.65126050420168,999,5.52052052052052
768,231,5.43359375,5.72727272727273,999,5.5015015015015
765,234,5.40392156862745,5.79487179487179,999,5.4954954954955
761,237,5.45597897503285,5.82278481012658,998,5.54308617234469
766,233,5.37206266318538,5.87124463519313,999,5.48848848848849
773,226,5.43337645536869,5.9070796460177,999,5.54054054054054
768,231,5.43359375,5.74458874458874,999,5.50550550550551
771,227,5.47081712062257,5.82819383259912,998,5.55210420841683
778,220,5.49100257069409,5.90909090909091,998,5.58316633266533
777,221,5.51222651222651,5.99547511312217,998,5.61923847695391
786,212,5.49872773536896,6.0188679245283,998,5.60921843687375
789,210,5.50570342205323,6.11428571428571,999,5.63363363363363
788,211,5.47335025380711,6.06635071090047,999,5.5985985985986
788,211,5.4505076142132,6.14218009478673,999,5.5965965965966
795,201,5.4314465408805,6.12935323383085,996,5.57228915662651
795,203,5.43018867924528,6.12807881773399,998,5.57214428857715
802,197,5.40149625935162,6.0253807106599,999,5.52452452452452
793,206,5.44010088272383,6.0631067961165,999,5.56856856856857
790,208,5.44177215189873,6.02884615384615,998,5.56412825651303
789,209,5.45120405576679,5.85167464114833,998,5.53507014028056
780,217,5.43717948717949,5.80645161290323,997,5.51755265797392
781,218,5.45070422535211,5.75229357798165,999,5.51651651651652
780,216,5.3974358974359,5.80092592592593,996,5.48493975903614
777,222,5.42857142857143,5.84234234234234,999,5.52052052052052
772,224,5.50777202072539,5.83482142857143,996,5.58132530120482
759,237,5.49143610013175,5.91983122362869,996,5.5933734939759
768,231,5.47005208333333,5.93073593073593,999,5.57657657657658
764,234,5.43455497382199,5.9017094017094,998,5.54408817635271
759,240,5.44137022397892,5.8,999,5.52752752752753
767,232,5.45110821382008,5.7801724137931,999,5.52752752752753
757,241,5.48216644649934,5.65560165975104,998,5.52404809619238
764,233,5.53403141361257,5.82832618025751,997,5.60280842527583
757,241,5.54953764861295,5.72614107883817,998,5.59218436873747
759,240,5.57180500658762,5.72083333333333,999,5.60760760760761
761,237,5.57030223390276,5.78481012658228,998,5.62124248496994
764,233,5.57591623036649,5.72103004291846,997,5.6098294884654
765,233,5.54117647058824,5.72961373390558,998,5.58517034068136
767,232,5.54758800521512,5.68103448275862,999,5.57857857857858
765,233,5.49803921568627,5.62660944206009,998,5.52805611222445
765,234,5.49281045751634,5.65811965811966,999,5.53153153153153
762,236,5.56692913385827,5.58898305084746,998,5.57214428857715
760,239,5.54078947368421,5.61506276150628,999,5.55855855855856
762,237,5.52362204724409,5.65822784810127,999,5.55555555555556
762,235,5.57874015748031,5.62127659574468,997,5.58876629889669
766,231,5.54830287206266,5.6017316017316,997,5.56068204613842
762,236,5.54068241469816,5.71186440677966,998,5.5811623246493
754,242,5.657824933687,5.7603305785124,996,5.68273092369478
748,249,5.65508021390374,5.77911646586345,997,5.68605817452357
759,240,5.59947299077734,5.74583333333333,999,5.63463463463463
759,238,5.59815546772069,5.65126050420168,997,5.61083249749248
762,237,5.63123359580053,5.64556962025316,999,5.63463463463463
764,235,5.58376963350785,5.56595744680851,999,5.57957957957958
758,239,5.62664907651715,5.62761506276151,997,5.62688064192578
767,232,5.60495436766623,5.60344827586207,999,5.6046046046046
759,239,5.57971014492754,5.52301255230125,998,5.56613226452906
760,238,5.54078947368421,5.5,998,5.5310621242485
752,246,5.58909574468085,5.44715447154472,998,5.55410821643287
755,239,5.59072847682119,5.48117154811716,994,5.56438631790745
767,232,5.63624511082138,5.44396551724138,999,5.59159159159159
765,234,5.62352941176471,5.46153846153846,999,5.58558558558559
766,232,5.65274151436031,5.38793103448276,998,5.59118236472946
766,233,5.61227154046997,5.25751072961373,999,5.52952952952953
759,239,5.66139657444005,5.27615062761506,998,5.56913827655311
771,228,5.68482490272374,5.32017543859649,999,5.6016016016016
769,229,5.71001300390117,5.41484716157205,998,5.64228456913828
777,221,5.72329472329472,5.42533936651584,998,5.65731462925852
775,224,5.69935483870968,5.47767857142857,999,5.64964964964965
773,223,5.72315653298836,5.50224215246637,996,5.67369477911647
772,226,5.69948186528497,5.51769911504425,998,5.65831663326653
771,227,5.70038910505837,5.52863436123348,998,5.66132264529058
773,226,5.62095730918499,5.3716814159292,999,5.56456456456456
777,222,5.65765765765766,5.31081081081081,999,5.58058058058058
772,225,5.66709844559585,5.38666666666667,997,5.60381143430291
780,219,5.65,5.37899543378995,999,5.59059059059059
773,225,5.66623544631307,5.35111111111111,998,5.59519038076152
775,223,5.67483870967742,5.34080717488789,998,5.6002004008016
783,216,5.70114942528736,5.37037037037037,999,5.62962962962963
783,216,5.65006385696041,5.43981481481481,999,5.6046046046046
797,201,5.633626097867,5.54228855721393,998,5.61523046092184
787,212,5.63659466327827,5.49528301886792,999,5.60660660660661
785,214,5.61019108280255,5.55607476635514,999,5.5985985985986
782,216,5.58951406649616,5.5462962962963,998,5.58016032064128
779,219,5.5982028241335,5.48401826484018,998,5.57314629258517
772,226,5.64119170984456,5.54867256637168,998,5.62024048096192
776,222,5.64819587628866,5.40540540540541,998,5.59418837675351
776,221,5.65077319587629,5.35746606334842,997,5.58575727181545
774,225,5.60206718346253,5.32,999,5.53853853853854
776,223,5.63917525773196,5.35874439461883,999,5.57657657657658
766,232,5.65013054830287,5.49137931034483,998,5.61322645290581
772,225,5.65155440414508,5.33333333333333,997,5.57973921765296
772,227,5.63082901554404,5.56387665198238,999,5.61561561561562
778,220,5.61311053984576,5.52727272727273,998,5.59418837675351
784,213,5.63647959183673,5.5868544600939,997,5.6258776328987
790,208,5.61772151898734,5.57211538461539,998,5.60821643286573
792,207,5.62247474747475,5.56521739130435,999,5.61061061061061
795,204,5.59748427672956,5.53921568627451,999,5.58558558558559
800,199,5.605,5.46733668341709,999,5.57757757757758
805,194,5.56273291925466,5.35051546391753,999,5.52152152152152
796,203,5.61306532663317,5.28571428571429,999,5.54654654654655
792,207,5.57575757575758,5.20772946859903,999,5.4994994994995
791,207,5.59039190897598,5.16908212560386,998,5.50300601202405
789,210,5.57794676806084,5.23809523809524,999,5.50650650650651
795,203,5.55723270440252,5.30541871921182,998,5.5060120240481
786,210,5.48346055979644,5.2952380952381,996,5.44377510040161
791,207,5.51959544879899,5.33816425120773,998,5.48196392785571
786,211,5.56615776081425,5.37440758293839,997,5.52557673019057
786,212,5.56488549618321,5.39150943396226,998,5.52805611222445
794,205,5.50503778337531,5.37073170731707,999,5.47747747747748
803,195,5.46948941469489,5.3948717948718,998,5.45490981963928
802,197,5.46134663341646,5.31979695431472,999,5.43343343343343
800,198,5.4775,5.23737373737374,998,5.42985971943888
799,199,5.53566958698373,5.20603015075377,998,5.46993987975952
795,204,5.53081761006289,5.24509803921569,999,5.47247247247247
797,202,5.51191969887077,5.23762376237624,999,5.45645645645646
797,200,5.54705144291092,5.365,997,5.51053159478435
797,202,5.58469259723965,5.32178217821782,999,5.53153153153153
798,199,5.58771929824561,5.33668341708543,997,5.53761283851555
804,195,5.59701492537313,5.27692307692308,999,5.53453453453453
803,195,5.60647571606476,5.21538461538462,998,5.53006012024048
804,193,5.63308457711443,5.24352331606218,997,5.55767301905717
802,197,5.66708229426434,5.22335025380711,999,5.57957957957958
805,194,5.66708074534161,5.19587628865979,999,5.57557557557558
817,180,5.64137086903305,5.18333333333333,997,5.55867602808425
814,184,5.61793611793612,5.23369565217391,998,5.54709418837675
807,191,5.55638166047088,5.18848167539267,998,5.48597194388778
809,189,5.51421508034611,5.17460317460317,998,5.4498997995992
805,194,5.45217391304348,5.11855670103093,999,5.38738738738739
800,199,5.44,5.31658291457286,999,5.41541541541542
809,190,5.40420271940668,5.45789473684211,999,5.41441441441441
812,186,5.40886699507389,5.4247311827957,998,5.41182364729459
822,176,5.40389294403893,5.50568181818182,998,5.42184368737475
824,175,5.31917475728155,5.50857142857143,999,5.35235235235235
822,177,5.27980535279805,5.57627118644068,999,5.33233233233233
817,181,5.26438188494492,5.55801104972376,998,5.31763527054108
823,176,5.28797083839611,5.60227272727273,999,5.34334334334334
825,174,5.28484848484849,5.70114942528736,999,5.35735735735736
830,169,5.28915662650602,5.72781065088757,999,5.36336336336336
832,167,5.32331730769231,5.67065868263473,999,5.38138138138138
840,157,5.31190476190476,5.64968152866242,997,5.36509528585757
837,160,5.32138590203106,5.59375,997,5.36509528585757
842,156,5.36579572446556,5.51923076923077,998,5.38977955911824
844,155,5.35071090047393,5.59354838709677,999,5.38838838838839
846,153,5.41252955082742,5.6078431372549,999,5.44244244244244
850,149,5.37294117647059,5.46308724832215,999,5.38638638638639
849,148,5.3510011778563,5.35810810810811,997,5.35205616850552
847,150,5.30224321133412,5.42,997,5.31995987963892
849,150,5.2414605418139,5.42,999,5.26826826826827
850,147,5.25529411764706,5.40816326530612,997,5.2778335005015
854,144,5.24004683840749,5.47222222222222,998,5.27354709418838
854,145,5.22599531615925,5.55862068965517,999,5.27427427427427
850,149,5.23058823529412,5.35570469798658,999,5.24924924924925
861,138,5.26364692218351,5.33333333333333,999,5.27327327327327
864,135,5.29282407407407,5.31851851851852,999,5.2962962962963
866,133,5.25173210161663,5.41353383458647,999,5.27327327327327
854,145,5.31498829039813,5.46206896551724,999,5.33633633633634
850,149,5.30941176470588,5.42953020134228,999,5.32732732732733
849,150,5.3133097762073,5.46666666666667,999,5.33633633633634
854,145,5.33723653395785,5.42068965517241,999,5.34934934934935
847,151,5.31641086186541,5.45695364238411,998,5.3376753507014
847,151,5.27508854781582,5.34437086092715,998,5.28557114228457
850,148,5.25058823529412,5.33108108108108,998,5.2625250501002
842,157,5.23990498812352,5.46496815286624,999,5.27527527527528
834,165,5.20983213429257,5.53939393939394,999,5.26426426426426
836,163,5.24521531100478,5.54601226993865,999,5.29429429429429
848,151,5.27830188679245,5.60927152317881,999,5.32832832832833
844,155,5.22748815165877,5.68387096774194,999,5.2982982982983
845,154,5.22603550295858,5.72727272727273,999,5.3033033033033
846,152,5.17139479905437,5.84210526315789,998,5.27354709418838
847,152,5.15938606847698,5.80263157894737,999,5.25725725725726
849,150,5.22497055359246,5.82666666666667,999,5.31531531531532
843,153,5.20996441281139,5.75816993464052,996,5.29417670682731
849,150,5.22614840989399,5.79333333333333,999,5.31131131131131
844,154,5.19431279620853,5.64935064935065,998,5.26452905811623
846,153,5.20330969267139,5.58823529411765,999,5.26226226226226
847,151,5.22195985832349,5.54966887417219,998,5.27154308617235
843,153,5.23606168446026,5.60130718954248,996,5.29216867469879
839,159,5.30989272943981,5.70440251572327,998,5.37274549098196
837,162,5.30704898446834,5.72222222222222,999,5.37437437437437
850,149,5.29294117647059,5.63087248322148,999,5.34334334334334
846,151,5.33096926713948,5.58278145695364,997,5.3691073219659
849,148,5.31095406360424,5.5472972972973,997,5.34603811434303
845,152,5.39644970414201,5.46710526315789,997,5.40722166499499
848,150,5.39622641509434,5.48,998,5.40881763527054
845,154,5.35621301775148,5.3961038961039,999,5.36236236236236
839,160,5.3849821215733,5.46875,999,5.3983983983984
843,154,5.41874258600237,5.43506493506494,997,5.42126379137412
842,156,5.45011876484561,5.6474358974359,998,5.48096192384769
837,161,5.4205495818399,5.69565217391304,998,5.46492985971944
836,163,5.38875598086124,5.56441717791411,999,5.41741741741742
836,163,5.36483253588517,5.47239263803681,999,5.38238238238238
836,162,5.36602870813397,5.42592592592593,998,5.37575150300601
830,168,5.36987951807229,5.36904761904762,998,5.36973947895792
825,174,5.37212121212121,5.33908045977012,999,5.36636636636637
828,171,5.33212560386473,5.4093567251462,999,5.34534534534535
835,164,5.27904191616766,5.46341463414634,999,5.30930930930931
845,153,5.26863905325444,5.32679738562091,998,5.27755511022044
840,158,5.29047619047619,5.35443037974684,998,5.30060120240481
841,156,5.29607609988109,5.36538461538461,997,5.30692076228686
842,157,5.24465558194774,5.15286624203822,999,5.23023023023023
837,161,5.25686977299881,5.3416149068323,998,5.27054108216433
839,160,5.25268176400477,5.41875,999,5.27927927927928
842,157,5.27197149643705,5.46496815286624,999,5.3023023023023
849,149,5.30035335689046,5.58389261744966,998,5.34268537074148
843,155,5.26215895610913,5.72258064516129,998,5.33366733466934
847,152,5.24203069657615,5.67105263157895,999,5.30730730730731
845,150,5.24378698224852,5.70666666666667,995,5.31356783919598
844,155,5.24289099526066,5.73548387096774,999,5.31931931931932
838,159,5.2255369928401,5.76100628930818,997,5.31093279839519
842,157,5.20902612826603,5.77707006369427,999,5.2982982982983
852,147,5.24413145539906,5.6530612244898,999,5.3043043043043
849,150,5.19670200235571,5.54666666666667,999,5.24924924924925
850,149,5.21176470588235,5.51677852348993,999,5.25725725725726
846,151,5.23286052009456,5.45033112582781,997,5.26579739217653
847,152,5.26092089728453,5.375,999,5.27827827827828
852,147,5.27582159624413,5.29251700680272,999,5.27827827827828
852,147,5.30633802816901,5.27210884353742,999,5.3013013013013
854,144,5.30679156908665,5.35416666666667,998,5.31362725450902
842,156,5.3729216152019,5.42948717948718,998,5.38176352705411
847,151,5.34120425029516,5.47682119205298,998,5.36172344689379
846,153,5.3983451536643,5.51633986928105,999,5.41641641641642
837,162,5.38829151732378,5.50617283950617,999,5.40740740740741
825,174,5.40121212121212,5.55172413793103,999,5.42742742742743
827,171,5.40507859733978,5.65497076023392,998,5.44789579158317
826,172,5.45399515738499,5.53488372093023,998,5.46793587174349
819,178,5.50915750915751,5.46629213483146,997,5.50150451354062
819,179,5.4981684981685,5.37430167597765,998,5.47595190380762
817,181,5.44920440636475,5.32044198895028,998,5.42585170340681
811,187,5.49815043156597,5.3048128342246,998,5.46192384769539
822,177,5.46715328467153,5.42937853107345,999,5.46046046046046
818,181,5.48166259168704,5.34806629834254,999,5.45745745745746
831,168,5.44645006016847,5.35714285714286,999,5.43143143143143
822,177,5.43795620437956,5.3954802259887,999,5.43043043043043
819,180,5.3980463980464,5.43333333333333,999,5.4044044044044
820,178,5.40731707317073,5.3876404494382,998,5.40380761523046
818,181,5.38508557457213,5.4475138121547,999,5.3963963963964
809,187,5.34734239802225,5.53475935828877,996,5.38253012048193
814,185,5.34766584766585,5.57837837837838,999,5.39039039039039
812,186,5.37931034482759,5.56989247311828,998,5.41482965931864
815,183,5.32269938650307,5.61748633879781,998,5.37675350701403
816,182,5.2843137254902,5.6043956043956,998,5.34268537074148
816,183,5.27696078431373,5.66120218579235,999,5.34734734734735
815,184,5.3361963190184,5.58695652173913,999,5.38238238238238
813,186,5.37392373923739,5.50537634408602,999,5.3983983983984
819,180,5.39438339438339,5.41111111111111,999,5.3973973973974
809,189,5.3955500618047,5.49206349206349,998,5.41382765531062
811,185,5.43526510480888,5.53513513513514,996,5.45381526104418
820,179,5.43292682926829,5.5195530726257,999,5.44844844844845
814,181,5.42014742014742,5.70165745856354,995,5.4713567839196
818,181,5.43031784841076,5.67403314917127,999,5.47447447447447
814,183,5.42997542997543,5.72131147540984,997,5.48345035105316
819,180,5.48229548229548,5.60555555555556,999,5.5045045045045
821,177,5.52618757612667,5.59887005649717,998,5.53907815631263
824,174,5.5376213592233,5.54597701149425,998,5.53907815631263
823,175,5.49210206561361,5.48,998,5.48997995991984
833,163,5.48379351740696,5.51533742331288,996,5.48895582329317
837,162,5.46953405017921,5.46913580246914,999,5.46946946946947
834,163,5.45803357314149,5.38036809815951,997,5.44533600802407
839,160,5.43027413587604,5.35,999,5.41741741741742
837,162,5.39068100358423,5.40740740740741,999,5.39339339339339
840,157,5.37142857142857,5.38216560509554,997,5.37311935807422
838,160,5.38066825775656,5.41875,998,5.38677354709419
844,155,5.32938388625592,5.4258064516129,999,5.34434434434434
847,150,5.32703659976387,5.38,997,5.33500501504514
841,158,5.33650416171225,5.39240506329114,999,5.34534534534535
844,155,5.34004739336493,5.40645161290323,999,5.35035035035035
845,154,5.30769230769231,5.31818181818182,999,5.30930930930931
845,154,5.33846153846154,5.40909090909091,999,5.34934934934935
842,157,5.32422802850356,5.4140127388535,999,5.33833833833834
838,160,5.35560859188544,5.51875,998,5.38176352705411
845,153,5.32899408284024,5.54901960784314,998,5.3627254509018
845,154,5.38698224852071,5.64285714285714,999,5.42642642642643
834,165,5.41846522781775,5.70909090909091,999,5.46646646646647
837,162,5.40979689366786,5.77777777777778,999,5.46946946946947
842,157,5.37054631828979,5.84713375796178,999,5.44544544544545
839,160,5.33849821215733,5.89375,999,5.42742742742743
835,162,5.41077844311377,5.87654320987654,997,5.4864593781344
838,161,5.40334128878282,5.73913043478261,999,5.45745745745746
843,156,5.36892052194543,5.67948717948718,999,5.41741741741742
835,164,5.37724550898204,5.67682926829268,999,5.42642642642643
839,160,5.37663885578069,5.7375,999,5.43443443443443
843,156,5.37366548042705,5.75,999,5.43243243243243
840,158,5.38571428571429,5.65189873417722,998,5.42785571142285
839,160,5.40762812872467,5.60625,999,5.43943943943944
834,165,5.35131894484412,5.70909090909091,999,5.41041041041041
838,161,5.29713603818616,5.77018633540373,999,5.37337337337337
839,159,5.30274135876043,5.77358490566038,998,5.37775551102204
840,158,5.26666666666667,5.77215189873418,998,5.34669338677355
842,157,5.2790973871734,5.7515923566879,999,5.35335335335335
846,152,5.25768321513002,5.61842105263158,998,5.312625250501
856,143,5.30373831775701,5.59440559440559,999,5.34534534534535
850,149,5.32941176470588,5.58389261744966,999,5.36736736736737
850,146,5.31411764705882,5.56164383561644,996,5.3504016064257
851,147,5.31257344300823,5.68707482993197,998,5.36773547094188
846,152,5.28486997635934,5.70394736842105,998,5.34869739478958
844,155,5.32464454976303,5.75483870967742,999,5.39139139139139
841,156,5.33769322235434,5.69871794871795,997,5.39418254764293
840,158,5.32261904761905,5.74050632911392,998,5.38877755511022
842,156,5.31947743467934,5.78205128205128,998,5.39178356713427
838,161,5.31861575178998,5.6583850931677,999,5.37337337337337
845,152,5.36568047337278,5.71710526315789,997,5.41925777331996
846,152,5.3758865248227,5.73026315789474,998,5.42985971943888
840,159,5.37380952380952,5.62264150943396,999,5.41341341341341
831,168,5.3453670276775,5.60119047619048,999,5.38838838838839
826,172,5.30508474576271,5.61627906976744,998,5.35871743486974
823,174,5.29161603888214,5.60344827586207,997,5.34603811434303
816,181,5.23897058823529,5.40331491712707,997,5.26880641925777
816,183,5.29656862745098,5.50819672131148,999,5.33533533533534
820,178,5.32439024390244,5.18539325842697,998,5.29959919839679
814,184,5.35257985257985,5.28804347826087,998,5.34068136272545
815,184,5.40981595092025,5.31521739130435,999,5.39239239239239
808,187,5.39727722772277,5.33689839572193,995,5.38592964824121
805,194,5.38260869565217,5.35051546391753,999,5.37637637637638
802,195,5.3216957605985,5.32307692307692,997,5.32196589769308
803,195,5.30261519302615,5.47179487179487,998,5.33567134268537
812,185,5.28817733990148,5.47027027027027,997,5.32196589769308
810,187,5.32222222222222,5.3903743315508,997,5.33500501504514
812,184,5.35591133004926,5.3695652173913,996,5.35843373493976
815,183,5.34601226993865,5.37704918032787,998,5.35170340681363
819,180,5.33699633699634,5.42777777777778,999,5.35335335335335
813,186,5.42558425584256,5.43010752688172,999,5.42642642642643
812,186,5.40270935960591,5.39784946236559,998,5.40180360721443
810,189,5.43333333333333,5.43915343915344,999,5.43443443443443
807,191,5.40396530359356,5.42931937172775,998,5.40881763527054
812,187,5.42980295566502,5.55080213903743,999,5.45245245245245
805,194,5.44844720496894,5.45876288659794,999,5.45045045045045
805,192,5.44596273291925,5.359375,997,5.42928786359077
805,193,5.47950310559006,5.3160621761658,998,5.44789579158317
803,195,5.47820672478207,5.0974358974359,998,5.40380761523046
808,191,5.4740099009901,5.21989528795812,999,5.42542542542543
804,195,5.44402985074627,5.1025641025641,999,5.37737737737738
807,192,5.47087980173482,5.24479166666667,999,5.42742742742743
805,194,5.4695652173913,5.2319587628866,999,5.42342342342342
814,185,5.47297297297297,5.26486486486487,999,5.43443443443443
817,182,5.40514075887393,5.31868131868132,999,5.38938938938939
817,181,5.45042839657283,5.29834254143646,998,5.42284569138277
814,183,5.39434889434889,5.19125683060109,997,5.35707121364092
813,185,5.40959409594096,5.28648648648649,998,5.38677354709419
816,182,5.33578431372549,5.37362637362637,998,5.34268537074148
822,176,5.37347931873479,5.44318181818182,998,5.38577154308617
823,175,5.39732685297691,5.39428571428571,998,5.39679358717435
821,176,5.41291108404385,5.44886363636364,997,5.41925777331996
820,179,5.45853658536585,5.37988826815642,999,5.44444444444444
820,179,5.42073170731707,5.35754189944134,999,5.40940940940941
829,170,5.46079613992762,5.27647058823529,999,5.42942942942943
819,180,5.5006105006105,5.41111111111111,999,5.48448448448448
822,176,5.51824817518248,5.34659090909091,998,5.48797595190381
822,176,5.55961070559611,5.46022727272727,998,5.54208416833667
812,187,5.60098522167488,5.51336898395722,999,5.58458458458458
802,196,5.56359102244389,5.50510204081633,998,5.55210420841683
803,195,5.54545454545455,5.4,998,5.51703406813627
798,200,5.55388471177945,5.365,998,5.51603206412826
801,197,5.56304619225968,5.41624365482233,998,5.53406813627254
803,196,5.6027397260274,5.60714285714286,999,5.6036036036036
812,187,5.56773399014778,5.7379679144385,999,5.5995995995996
816,183,5.61397058823529,5.74863387978142,999,5.63863863863864
809,188,5.610630407911,5.84042553191489,997,5.65396188565697
802,195,5.5785536159601,5.73846153846154,997,5.6098294884654
801,195,5.54931335830212,5.59487179487179,996,5.55823293172691
797,202,5.5909661229611,5.45544554455446,999,5.56356356356356
800,199,5.5875,5.4321608040201,999,5.55655655655656
802,193,5.52743142144638,5.47150259067358,995,5.51658291457286
798,201,5.55012531328321,5.44278606965174,999,5.52852852852853
797,202,5.48180677540778,5.47524752475248,999,5.48048048048048
807,192,5.50185873605948,5.49479166666667,999,5.5005005005005
815,184,5.4478527607362,5.44565217391304,999,5.44744744744745
807,191,5.42874845105328,5.42408376963351,998,5.42785571142285
802,195,5.43516209476309,5.3948717948718,997,5.42728184553661
806,192,5.43052109181141,5.29166666666667,998,5.40380761523046
811,187,5.44143033292232,5.25668449197861,998,5.40681362725451
814,184,5.44594594594595,5.23913043478261,998,5.40781563126253
815,184,5.38773006134969,5.30434782608696,999,5.37237237237237
811,187,5.38224414303329,5.25668449197861,998,5.35871743486974
822,175,5.44403892944039,5.28,997,5.41524573721163
826,173,5.45883777239709,5.34682080924855,999,5.43943943943944
827,171,5.47400241837969,5.35672514619883,998,5.45390781563126
830,167,5.53132530120482,5.23952095808383,997,5.48244734202608
829,169,5.55367913148372,5.27218934911243,998,5.5060120240481
828,171,5.57004830917874,5.28654970760234,999,5.52152152152152
830,168,5.53734939759036,5.34523809523809,998,5.50501002004008
832,167,5.52644230769231,5.33532934131737,999,5.49449449449449
832,166,5.546875,5.37349397590361,998,5.51803607214429
833,165,5.60504201680672,5.4,998,5.57114228456914
835,163,5.58443113772455,5.40490797546012,998,5.55511022044088
837,162,5.55197132616487,5.39506172839506,999,5.52652652652653
836,163,5.54545454545455,5.40490797546012,999,5.52252252252252
835,163,5.57604790419162,5.40490797546012,998,5.54809619238477
839,160,5.56019070321812,5.5,999,5.55055055055055
840,159,5.60357142857143,5.55974842767296,999,5.5965965965966
843,156,5.59905100830368,5.55769230769231,999,5.59259259259259
845,154,5.60118343195266,5.48051948051948,999,5.58258258258258
840,159,5.57619047619048,5.36477987421384,999,5.54254254254254
843,154,5.59193357058126,5.26623376623377,997,5.54162487462387
839,158,5.56615017878427,5.18354430379747,997,5.50551654964895
839,159,5.58045292014303,5.22641509433962,998,5.52404809619238
843,156,5.53973902728351,5.17307692307692,999,5.48248248248248
841,156,5.62901307966706,5.17948717948718,997,5.55867602808425
840,157,5.6702380952381,4.98726114649681,997,5.56268806419258
839,160,5.71275327771156,5.09375,999,5.61361361361361
832,165,5.69951923076923,5.08484848484848,997,5.59779338014042
835,164,5.65868263473054,5.17073170731707,999,5.57857857857858
835,164,5.60359281437126,5.17073170731707,999,5.53253253253253
845,154,5.62366863905325,5.17532467532468,999,5.55455455455455
847,151,5.65997638724911,5.13907284768212,998,5.5811623246493
850,149,5.69764705882353,5.25503355704698,999,5.63163163163163
855,143,5.72514619883041,5.27272727272727,998,5.66032064128257
857,142,5.7561260210035,5.2112676056338,999,5.67867867867868
864,135,5.74305555555556,5.03703703703704,999,5.64764764764765
862,136,5.70881670533643,5.25,998,5.64629258517034
859,139,5.71827706635623,5.35971223021583,998,5.66833667334669
864,134,5.69097222222222,5.37313432835821,998,5.64829659318637
873,125,5.72737686139748,5.512,998,5.70040080160321
875,120,5.73714285714286,5.36666666666667,995,5.69246231155779
875,124,5.77028571428571,5.34677419354839,999,5.71771771771772
876,123,5.74543378995434,5.43089430894309,999,5.70670670670671
874,121,5.72768878718535,5.35537190082645,995,5.68241206030151
876,123,5.65753424657534,5.43089430894309,999,5.62962962962963
873,125,5.66666666666667,5.392,998,5.63226452905812
870,129,5.66436781609195,5.44186046511628,999,5.63563563563564
869,130,5.70655926352129,5.50769230769231,999,5.68068068068068
877,122,5.78791334093501,5.4016393442623,999,5.74074074074074
877,122,5.73204104903079,5.40983606557377,999,5.69269269269269
878,119,5.7380410022779,5.45378151260504,997,5.70411233701103
885,113,5.71751412429379,5.44247787610619,998,5.68637274549098
886,113,5.75395033860045,5.46017699115044,999,5.72072072072072
878,120,5.78132118451025,5.51666666666667,998,5.74949899799599
887,112,5.73844419391206,5.54464285714286,999,5.71671671671672
875,123,5.69371428571429,5.54471544715447,998,5.67535070140281
869,130,5.67779056386651,5.56923076923077,999,5.66366366366366
876,123,5.68835616438356,5.29268292682927,999,5.63963963963964
871,123,5.64179104477612,5.36585365853659,994,5.60764587525151
876,121,5.64840182648402,5.27272727272727,997,5.60280842527583
868,128,5.64746543778802,5.4375,996,5.62048192771084
875,122,5.64457142857143,5.4672131147541,997,5.62286860581745
874,125,5.60640732265446,5.608,999,5.60660660660661
880,119,5.57840909090909,5.56302521008403,999,5.57657657657658
874,125,5.60526315789474,5.44,999,5.58458458458458
875,123,5.59542857142857,5.48780487804878,998,5.58216432865731
875,121,5.60457142857143,5.53719008264463,996,5.59638554216868
872,127,5.6204128440367,5.54330708661417,999,5.61061061061061
873,126,5.60595647193585,5.49206349206349,999,5.59159159159159
876,121,5.64269406392694,5.5702479338843,997,5.63390170511535
882,117,5.62698412698413,5.66666666666667,999,5.63163163163163
881,117,5.6311010215664,5.57264957264957,998,5.62424849699399
886,113,5.66252821670429,5.55752212389381,999,5.65065065065065
887,112,5.7260428410372,5.55357142857143,999,5.70670670670671
883,115,5.7281993204983,5.44347826086956,998,5.69539078156313
887,112,5.74746335963923,5.57142857142857,999,5.72772772772773
888,111,5.73085585585586,5.48648648648649,999,5.7037037037037
887,112,5.76662908680947,5.40178571428571,999,5.72572572572573
882,116,5.79365079365079,5.31896551724138,998,5.73847695390782
887,112,5.76550169109357,5.24107142857143,999,5.70670670670671
886,113,5.69864559819413,5.31858407079646,999,5.65565565565566
887,111,5.68207440811725,5.27027027027027,998,5.63627254509018
886,113,5.64446952595937,5.35398230088496,999,5.61161161161161
879,120,5.62002275312856,5.3,999,5.58158158158158
875,122,5.63085714285714,5.18852459016393,997,5.57673019057172
882,115,5.60657596371882,5.20869565217391,997,5.56068204613842
889,109,5.57705286839145,5.22935779816514,998,5.53907815631263
887,112,5.58624577226607,5.3125,999,5.55555555555556
891,108,5.55443322109989,5.34259259259259,999,5.53153153153153
889,110,5.57255343082115,5.36363636363636,999,5.54954954954955
885,114,5.58418079096045,5.2719298245614,999,5.54854854854855
889,110,5.5793025871766,5.4,999,5.55955955955956
889,110,5.48706411698538,5.5,999,5.48848848848849
891,108,5.47250280583614,5.55555555555556,999,5.48148148148148
893,105,5.39305711086226,5.51428571428571,998,5.40581162324649
890,109,5.42696629213483,5.68807339449541,999,5.45545545545546
889,109,5.39032620922385,5.68807339449541,998,5.42284569138277
890,109,5.46292134831461,5.62385321100917,999,5.48048048048048
885,111,5.50847457627119,5.64864864864865,996,5.52409638554217
881,118,5.47219069239501,5.60169491525424,999,5.48748748748749
884,115,5.45814479638009,5.61739130434783,999,5.47647647647648
886,112,5.47516930022573,5.63392857142857,998,5.49298597194389
888,111,5.46171171171171,5.63063063063063,999,5.48048048048048
888,111,5.45045045045045,5.67567567567568,999,5.47547547547548
889,107,5.44319460067492,5.64485981308411,996,5.464859437751
891,107,5.45230078563412,5.72897196261682,998,5.48196392785571
897,102,5.44704570791527,5.55882352941176,999,5.45845845845846
898,100,5.48552338530067,5.64,998,5.50100200400802
895,104,5.47374301675978,5.64423076923077,999,5.49149149149149
886,113,5.44808126410835,5.76991150442478,999,5.48448448448448
884,115,5.48755656108597,5.85217391304348,999,5.52952952952953
886,110,5.49435665914221,5.86363636363636,996,5.535140562249
892,107,5.40807174887892,5.83177570093458,999,5.45345345345345
892,107,5.40358744394619,5.8411214953271,999,5.45045045045045
897,102,5.45819397993311,5.86274509803922,999,5.4994994994995
894,105,5.50559284116331,5.82857142857143,999,5.53953953953954
897,102,5.52954292084727,5.82352941176471,999,5.55955955955956
895,104,5.54972067039106,5.72115384615385,999,5.56756756756757
890,109,5.55056179775281,5.6605504587156,999,5.56256256256256
895,102,5.55754189944134,5.65686274509804,997,5.56770310932798
897,101,5.55741360089186,5.71287128712871,998,5.57314629258517
897,102,5.55183946488294,5.76470588235294,999,5.57357357357357
899,99,5.55728587319244,5.71717171717172,998,5.57314629258517
902,97,5.50110864745011,5.82474226804124,999,5.53253253253253
903,95,5.49501661129568,5.83157894736842,998,5.52705410821643
901,97,5.54273029966704,5.71134020618557,998,5.55911823647295
901,98,5.58601553829079,5.63265306122449,999,5.59059059059059
897,102,5.61872909698997,5.67647058823529,999,5.62462462462462
899,99,5.67185761957731,5.83838383838384,998,5.68837675350701
896,103,5.67299107142857,5.77669902912621,999,5.68368368368368
888,107,5.66216216216216,5.83177570093458,995,5.68040201005025
890,108,5.66067415730337,5.75925925925926,998,5.67134268537074
885,111,5.67570621468927,5.75675675675676,996,5.68473895582329
885,113,5.68813559322034,5.72566371681416,998,5.69238476953908
884,112,5.64932126696833,5.66071428571429,996,5.65060240963855
890,108,5.60898876404494,5.65740740740741,998,5.61422845691383
891,107,5.53872053872054,5.70093457943925,998,5.5561122244489
890,108,5.57977528089888,5.81481481481481,998,5.60521042084168
887,112,5.59075535512965,5.84821428571429,999,5.61961961961962
885,112,5.61129943502825,5.83928571428571,997,5.63691073219659
891,108,5.64758698092031,5.75925925925926,999,5.65965965965966
883,114,5.72366930917327,5.78947368421053,997,5.73119358074223
881,117,5.67196367763905,5.86324786324786,998,5.69438877755511
887,111,5.63359639233371,5.94594594594595,998,5.66833667334669
883,115,5.64439411098528,6.08695652173913,998,5.69539078156313
875,123,5.67771428571429,5.92682926829268,998,5.70841683366733
874,125,5.65789473684211,5.856,999,5.68268268268268
868,128,5.67511520737327,5.9140625,996,5.70582329317269
868,130,5.66359447004608,5.95384615384615,998,5.70140280561122
877,121,5.66476624857469,5.85123966942149,998,5.687374749499
872,127,5.63302752293578,5.59842519685039,999,5.62862862862863
876,122,5.65182648401827,5.5655737704918,998,5.64128256513026
879,120,5.60864618885097,5.5,999,5.5955955955956
878,121,5.64009111617312,5.43801652892562,999,5.61561561561562
881,118,5.61520998864926,5.41525423728814,999,5.59159159159159
877,120,5.58722919042189,5.45,997,5.57071213640923
885,114,5.57062146892655,5.45614035087719,999,5.55755755755756
883,115,5.58550396375991,5.42608695652174,998,5.56713426853707
884,115,5.53733031674208,5.35652173913043,999,5.51651651651652
888,110,5.50225225225225,5.27272727272727,998,5.47695390781563
885,114,5.53559322033898,5.45614035087719,999,5.52652652652653
884,114,5.57013574660633,5.54385964912281,998,5.56713426853707
889,110,5.55905511811024,5.64545454545455,999,5.56856856856857
884,115,5.57579185520362,5.60869565217391,999,5.57957957957958
881,115,5.60045402951192,5.54782608695652,996,5.59437751004016
883,115,5.63420158550396,5.66086956521739,998,5.6372745490982
884,115,5.57579185520362,5.79130434782609,999,5.6006006006006
877,122,5.56328392246294,5.91803278688525,999,5.60660660660661
875,121,5.54742857142857,6.02479338842975,996,5.60542168674699
875,124,5.57142857142857,6.04032258064516,999,5.62962962962963
873,126,5.63573883161512,6.07936507936508,999,5.69169169169169
879,119,5.60523321956769,5.92436974789916,998,5.64328657314629
877,121,5.59749144811859,5.70247933884298,998,5.61022044088176
880,119,5.54090909090909,5.60504201680672,999,5.54854854854855
880,119,5.55113636363636,5.71428571428571,999,5.57057057057057
882,117,5.56802721088435,5.58974358974359,999,5.57057057057057
883,116,5.51868629671574,5.66379310344828,999,5.53553553553554
881,118,5.54370034052213,5.50847457627119,999,5.53953953953954
880,117,5.54090909090909,5.44444444444444,997,5.5295887662989
875,123,5.53828571428571,5.33333333333333,998,5.51302605210421
879,120,5.53242320819113,5.225,999,5.4954954954955
875,123,5.49714285714286,5.34959349593496,998,5.47895791583166
874,124,5.45194508009153,5.33064516129032,998,5.43687374749499
880,119,5.40909090909091,5.3109243697479,999,5.3973973973974
884,114,5.49434389140271,5.47368421052632,998,5.49198396793587
882,115,5.51587301587302,5.32173913043478,997,5.49348044132397
886,111,5.51805869074492,5.28828828828829,997,5.49247743229689
883,116,5.51302378255946,5.18965517241379,999,5.47547547547548
882,117,5.52154195011338,5.20512820512821,999,5.48448448448448
880,118,5.56363636363636,5.20338983050847,998,5.52104208416834
888,111,5.58445945945946,5.3963963963964,999,5.56356356356356
887,112,5.58624577226607,5.58928571428571,999,5.58658658658659
884,113,5.58031674208145,5.46902654867257,997,5.56770310932798
885,112,5.55593220338983,5.33035714285714,997,5.53059177532598
887,111,5.61104847801578,5.26126126126126,998,5.57214428857715
888,110,5.57995495495495,5.3,998,5.54909819639279
890,109,5.62921348314607,5.29357798165138,999,5.59259259259259
887,110,5.6358511837655,5.38181818181818,997,5.60782347041123
892,106,5.65022421524664,5.38679245283019,998,5.62224448897796
883,115,5.62627406568516,5.35652173913043,998,5.59519038076152
886,111,5.59142212189616,5.38738738738739,997,5.56870611835507
891,108,5.55443322109989,5.38888888888889,999,5.53653653653654
883,113,5.54813137032843,5.42477876106195,996,5.53413654618474
890,109,5.56966292134831,5.5045871559633,999,5.56256256256256
882,114,5.51360544217687,5.60526315789474,996,5.52409638554217
885,113,5.55141242937853,5.47787610619469,998,5.54308617234469
891,108,5.52188552188552,5.53703703703704,999,5.52352352352352
896,102,5.57700892857143,5.51960784313725,998,5.57114228456914
899,98,5.55172413793103,5.42857142857143,997,5.53961885656971
902,96,5.56208425720621,5.44791666666667,998,5.55110220440882
910,89,5.54835164835165,5.51685393258427,999,5.54554554554555
903,96,5.49390919158361,5.58333333333333,999,5.5025025025025
910,89,5.49230769230769,5.62921348314607,999,5.5045045045045
908,91,5.50220264317181,5.78021978021978,999,5.52752752752753
909,90,5.44994499449945,5.72222222222222,999,5.47447447447447
907,91,5.46857772877618,5.8021978021978,998,5.49899799599198
903,95,5.48172757475083,5.70526315789474,998,5.50300601202405
903,93,5.4296788482835,5.68817204301075,996,5.45381526104418
906,93,5.42494481236203,5.7741935483871,999,5.45745745745746
911,88,5.45444566410538,5.69318181818182,999,5.47547547547548
911,85,5.45115257958288,5.87058823529412,996,5.48694779116466
908,90,5.45374449339207,5.77777777777778,998,5.48296593186373
908,91,5.44052863436123,5.76923076923077,999,5.47047047047047
906,93,5.42163355408389,5.59139784946237,999,5.43743743743744
907,92,5.40022050716648,5.60869565217391,999,5.41941941941942
903,95,5.37541528239203,5.66315789473684,998,5.40280561122244
908,91,5.3568281938326,5.76923076923077,999,5.39439439439439
907,91,5.35722160970232,5.67032967032967,998,5.38577154308617
907,92,5.29437706725469,5.67391304347826,999,5.32932932932933
910,88,5.2956043956044,5.64772727272727,998,5.32665330661323
913,86,5.29244249726177,5.55813953488372,999,5.31531531531532
908,89,5.31057268722467,5.44943820224719,997,5.32296890672016
914,85,5.31619256017505,5.43529411764706,999,5.32632632632633
912,86,5.30921052631579,5.34883720930233,998,5.312625250501
908,90,5.31387665198238,5.34444444444444,998,5.31663326653307
905,94,5.32486187845304,5.40425531914894,999,5.33233233233233
903,92,5.29678848283499,5.40217391304348,995,5.30653266331658
903,96,5.3233665559247,5.59375,999,5.34934934934935
902,96,5.33370288248337,5.5625,998,5.35571142284569
902,97,5.35254988913525,5.47422680412371,999,5.36436436436436
898,101,5.28396436525613,5.5049504950495,999,5.30630630630631
895,102,5.27932960893855,5.57843137254902,997,5.3099297893681
902,95,5.30820399113082,5.56842105263158,997,5.33299899699097
900,98,5.32222222222222,5.8265306122449,998,5.37174348697395
900,99,5.37444444444444,5.84848484848485,999,5.42142142142142
899,99,5.35706340378198,5.7979797979798,998,5.40080160320641
893,106,5.38073908174692,5.68867924528302,999,5.41341341341341
896,103,5.40625,5.60194174757282,999,5.42642642642643
894,105,5.41834451901566,5.55238095238095,999,5.43243243243243
886,113,5.41534988713318,5.61946902654867,999,5.43843843843844
887,112,5.47350620067644,5.71428571428571,999,5.5005005005005
892,105,5.49887892376682,5.84761904761905,997,5.53560682046138
893,106,5.52743561030235,5.66037735849057,999,5.54154154154154
895,104,5.50391061452514,5.60576923076923,999,5.51451451451451
894,101,5.54474272930649,5.65346534653465,995,5.55577889447236
898,100,5.52783964365256,5.67,998,5.54208416833667
902,96,5.490022172949,5.75,998,5.51503006012024
897,101,5.54069119286511,5.83168316831683,998,5.57014028056112
894,103,5.52013422818792,5.76699029126214,997,5.5456369107322
899,100,5.51056729699666,5.97,999,5.55655655655656
893,105,5.501679731243,5.91428571428571,998,5.54509018036072
891,105,5.43771043771044,5.91428571428571,996,5.48795180722892
894,103,5.40939597315436,5.87378640776699,997,5.45737211634905
885,114,5.45649717514124,5.93859649122807,999,5.51151151151151
882,117,5.47278911564626,5.84615384615385,999,5.51651651651652
891,108,5.51178451178451,5.78703703703704,999,5.54154154154154
889,109,5.52980877390326,5.8256880733945,998,5.56212424849699
886,113,5.51805869074492,5.79646017699115,999,5.54954954954955
890,107,5.51011235955056,5.71028037383178,997,5.53159478435306
897,101,5.52842809364549,5.68316831683168,998,5.54408817635271
897,102,5.47603121516165,5.51960784313725,999,5.48048048048048
898,100,5.45768374164811,5.6,998,5.47194388777555
905,92,5.42099447513812,5.52173913043478,997,5.43029087261785
906,93,5.38852097130243,5.45161290322581,999,5.39439439439439
909,89,5.44774477447745,5.52808988764045,998,5.45490981963928
917,81,5.42311886586696,5.4320987654321,998,5.42384769539078
917,82,5.45692475463468,5.47560975609756,999,5.45845845845846
914,84,5.40481400437637,5.48809523809524,998,5.41182364729459
914,85,5.43654266958425,5.44705882352941,999,5.43743743743744
917,82,5.46128680479826,5.4390243902439,999,5.45945945945946
911,88,5.44017563117453,5.38636363636364,999,5.43543543543544
914,85,5.47592997811816,5.28235294117647,999,5.45945945945946
912,84,5.50767543859649,5.38095238095238,996,5.49698795180723
916,82,5.46724890829694,5.51219512195122,998,5.47094188376754
908,89,5.40308370044053,5.51685393258427,997,5.41323971915747
909,89,5.42794279427943,5.37078651685393,998,5.42284569138277
913,86,5.44249726177437,5.31395348837209,999,5.43143143143143
914,84,5.42231947483589,5.30952380952381,998,5.41282565130261
918,81,5.43137254901961,5.25925925925926,999,5.41741741741742
913,84,5.42935377875137,5.29761904761905,997,5.41825476429288
910,87,5.41758241758242,5.29885057471264,997,5.40722166499499
913,86,5.47973713033954,5.22093023255814,999,5.45745745745746
912,86,5.48793859649123,5.19767441860465,998,5.46292585170341
917,82,5.51581243184297,5.26829268292683,999,5.4954954954955
913,83,5.53669222343921,5.31325301204819,996,5.51807228915663
916,82,5.51528384279476,5.28048780487805,998,5.49599198396794
915,84,5.46994535519126,5.39285714285714,999,5.46346346346346
920,77,5.48478260869565,5.24675324675325,997,5.46639919759278
918,81,5.49237472766885,5.20987654320988,999,5.46946946946947
921,78,5.49837133550489,5.02564102564103,999,5.46146146146146
919,79,5.45048966267682,5.16455696202532,998,5.42785571142285
919,79,5.39173014145811,5.29113924050633,998,5.38376753507014
923,76,5.38786565547129,5.42105263157895,999,5.39039039039039
923,76,5.38786565547129,5.52631578947368,999,5.3983983983984
924,75,5.40367965367965,5.62666666666667,999,5.42042042042042
920,79,5.39782608695652,5.62025316455696,999,5.41541541541542
924,75,5.39718614718615,5.54666666666667,999,5.40840840840841
922,76,5.42190889370933,5.52631578947368,998,5.42985971943888
923,74,5.42145178764897,5.40540540540541,997,5.42026078234704
926,73,5.44492440604752,5.45205479452055,999,5.44544544544545
926,73,5.40280777537797,5.38356164383562,999,5.4014014014014
924,75,5.45021645021645,5.42666666666667,999,5.44844844844845
921,77,5.41259500542888,5.25974025974026,998,5.40080160320641
924,75,5.43506493506494,5.52,999,5.44144144144144
927,72,5.41100323624595,5.375,999,5.40840840840841
929,69,5.41550053821313,5.43478260869565,998,5.41683366733467
929,70,5.41442411194833,5.41428571428571,999,5.41441441441441
936,63,5.40384615384615,5.55555555555556,999,5.41341341341341
934,65,5.44432548179871,5.36923076923077,999,5.43943943943944
935,63,5.43636363636364,5.31746031746032,998,5.42885771543086
936,63,5.40811965811966,5.17460317460317,999,5.39339339339339
933,65,5.35262593783494,5.30769230769231,998,5.3496993987976
935,63,5.39679144385027,5.12698412698413,998,5.37975951903808
933,66,5.35155412647374,5.18181818181818,999,5.34034034034034
932,67,5.35407725321888,5.47761194029851,999,5.36236236236236
930,67,5.38064516129032,5.29850746268657,997,5.37512537612839
936,61,5.42307692307692,5.21311475409836,997,5.41023069207623
936,62,5.32799145299145,5.17741935483871,998,5.3186372745491
939,60,5.27795527156549,4.98333333333333,999,5.26026026026026
939,60,5.27476038338658,4.95,999,5.25525525525526
937,61,5.27427961579509,4.95081967213115,998,5.25450901803607
938,60,5.31236673773987,4.93333333333333,998,5.28957915831663
933,61,5.31939978563773,4.98360655737705,994,5.29879275653924
938,61,5.28891257995736,4.91803278688525,999,5.26626626626627
939,58,5.27582534611289,5.0,997,5.25977933801404
942,56,5.24309978768578,4.82142857142857,998,5.21943887775551
948,51,5.23523206751055,5.0,999,5.22322322322322
950,49,5.20947368421053,5.18367346938776,999,5.20820820820821
950,49,5.27473684210526,5.16326530612245,999,5.26926926926927
948,51,5.2542194092827,5.23529411764706,999,5.25325325325325
950,49,5.24526315789474,5.12244897959184,999,5.23923923923924
952,46,5.20378151260504,5.1304347826087,998,5.20040080160321
949,49,5.20969441517387,5.0,998,5.19939879759519
