forward_num,reverse_num,forward_rate,reverse_rate,organism_num,organism_rate
50,50,5.5,5.5,100,5.5
65,64,5.81538461538462,5.90625,129,5.86046511627907
74,78,5.91891891891892,5.97435897435897,152,5.94736842105263
92,96,6.18478260869565,6.1875,188,6.18617021276596
116,117,6.39655172413793,6.4017094017094,233,6.39914163090129
145,142,6.6,6.55633802816901,287,6.57839721254355
183,184,6.80874316939891,6.72282608695652,367,6.76566757493188
219,228,6.93607305936073,6.82456140350877,447,6.87919463087248
291,290,7.07560137457045,6.92758620689655,581,7.00172117039587
376,364,7.14095744680851,7.01373626373626,740,7.07837837837838
475,462,7.26736842105263,7.08008658008658,937,7.17502668089648
513,484,7.26510721247563,7.19628099173554,997,7.23169508525577
514,483,7.17509727626459,7.16977225672878,997,7.17251755265797
519,479,7.21001926782274,7.13152400835073,998,7.17234468937876
525,474,7.19428571428571,7.16666666666667,999,7.18118118118118
525,474,7.16761904761905,7.18143459915612,999,7.17417417417417
524,474,7.13549618320611,7.20675105485232,998,7.16933867735471
514,483,7.17898832684825,7.19668737060041,997,7.18756268806419
519,479,7.20616570327553,7.21920668058455,998,7.2124248496994
521,477,7.22456813819578,7.23480083857442,998,7.22945891783567
532,467,7.24624060150376,7.23340471092077,999,7.24024024024024
530,469,7.28490566037736,7.23240938166311,999,7.26026026026026
528,470,7.22916666666667,7.20851063829787,998,7.21943887775551
528,469,7.21969696969697,7.15778251599147,997,7.19057171514544
533,466,7.19699812382739,7.22317596566524,999,7.20920920920921
542,453,7.17712177121771,7.20529801324503,995,7.18994974874372
530,469,7.23018867924528,7.23240938166311,999,7.23123123123123
531,467,7.26930320150659,7.25910064239829,998,7.26452905811623
528,471,7.27651515151515,7.25477707006369,999,7.26626626626627
526,472,7.28136882129278,7.27966101694915,998,7.28056112224449
529,470,7.28733459357278,7.28510638297872,999,7.28628628628629
528,471,7.21212121212121,7.28025477707006,999,7.24424424424424
524,475,7.18511450381679,7.29473684210526,999,7.23723723723724
525,474,7.20571428571429,7.29113924050633,999,7.24624624624625
511,488,7.24070450097847,7.27049180327869,999,7.25525525525526
520,479,7.21923076923077,7.24634655532359,999,7.23223223223223
529,470,7.20604914933837,7.23829787234043,999,7.22122122122122
517,480,7.21663442940039,7.25833333333333,997,7.23671013039117
523,476,7.18546845124283,7.26260504201681,999,7.22222222222222
525,474,7.22095238095238,7.29957805907173,999,7.25825825825826
531,467,7.28248587570621,7.3169164882227,998,7.29859719438878
541,457,7.2550831792976,7.34135667396061,998,7.29458917835671
542,457,7.23985239852399,7.31291028446389,999,7.27327327327327
551,446,7.24500907441016,7.23094170403587,997,7.23871614844534
556,442,7.2589928057554,7.20361990950226,998,7.23446893787575
563,436,7.21847246891652,7.22477064220184,999,7.22122122122122
565,434,7.28318584070797,7.25576036866359,999,7.27127127127127
559,438,7.28085867620751,7.28995433789954,997,7.28485456369107
565,434,7.29026548672566,7.26958525345622,999,7.28128128128128
560,436,7.2875,7.26376146788991,996,7.27710843373494
545,453,7.27522935779816,7.25386313465784,998,7.26553106212425
550,449,7.26727272727273,7.24721603563474,999,7.25825825825826
552,446,7.28079710144928,7.25784753363229,998,7.27054108216433
555,444,7.24504504504505,7.24324324324324,999,7.24424424424424
559,440,7.16100178890877,7.20681818181818,999,7.18118118118118
554,443,7.19494584837545,7.21670428893905,997,7.20461384152457
550,449,7.14909090909091,7.22271714922049,999,7.18218218218218
550,447,7.18727272727273,7.23042505592841,997,7.20661985957874
557,441,7.19748653500898,7.24716553287982,998,7.21943887775551
556,442,7.15827338129496,7.30769230769231,998,7.22444889779559
574,425,7.21428571428571,7.27058823529412,999,7.23823823823824
577,422,7.157712305026,7.24644549763033,999,7.1951951951952
572,426,7.1993006993007,7.26056338028169,998,7.22545090180361
568,431,7.24119718309859,7.22041763341067,999,7.23223223223223
563,436,7.23268206039076,7.19724770642202,999,7.21721721721722
564,435,7.26241134751773,7.21149425287356,999,7.24024024024024
565,434,7.25663716814159,7.2073732718894,999,7.23523523523524
571,428,7.28721541155867,7.1588785046729,999,7.23223223223223
564,435,7.30496453900709,7.13103448275862,999,7.22922922922923
565,433,7.27787610619469,7.15704387990762,998,7.22545090180361
577,422,7.26343154246101,7.17298578199052,999,7.22522522522523
570,428,7.33684210526316,7.17056074766355,998,7.26553106212425
569,430,7.30579964850615,7.14186046511628,999,7.23523523523524
566,433,7.31802120141343,7.17090069284065,999,7.25425425425425
568,429,7.36971830985915,7.2027972027972,997,7.29789368104313
573,426,7.37696335078534,7.20422535211268,999,7.3033033033033
576,421,7.34895833333333,7.20427553444181,997,7.28786359077232
575,421,7.32695652173913,7.19239904988124,996,7.27008032128514
570,429,7.34561403508772,7.20512820512821,999,7.28528528528529
575,424,7.30434782608696,7.20283018867925,999,7.26126126126126
581,416,7.30808950086058,7.23317307692308,997,7.27683049147442
585,413,7.32478632478632,7.24697336561743,998,7.29258517034068
586,413,7.36860068259386,7.26876513317191,999,7.32732732732733
584,415,7.37671232876712,7.26506024096386,999,7.33033033033033
586,413,7.3617747440273,7.23244552058111,999,7.30830830830831
583,414,7.36020583190395,7.23188405797101,997,7.30692076228686
577,421,7.43847487001733,7.20190023752969,998,7.33867735470942
574,423,7.44425087108014,7.25531914893617,997,7.36409227683049
595,404,7.47563025210084,7.26732673267327,999,7.39139139139139
600,399,7.45,7.31578947368421,999,7.3963963963964
599,396,7.45575959933222,7.33838383838384,995,7.40904522613065
599,398,7.44908180300501,7.37185929648241,997,7.41825476429288
608,391,7.48026315789474,7.37595907928389,999,7.43943943943944
615,383,7.46178861788618,7.36292428198433,998,7.42384769539078
612,385,7.46241830065359,7.36363636363636,997,7.42427281845537
611,387,7.39443535188216,7.34883720930233,998,7.37675350701403
609,390,7.4072249589491,7.37435897435897,999,7.39439439439439
602,394,7.38704318936877,7.40862944162437,996,7.39558232931727
597,402,7.37688442211055,7.42786069651741,999,7.3973973973974
601,397,7.33943427620632,7.43576826196474,998,7.37775551102204
604,393,7.33774834437086,7.4529262086514,997,7.38314944834504
601,397,7.31780366056572,7.44080604534005,998,7.36673346693387
604,395,7.3046357615894,7.49620253164557,999,7.38038038038038
601,398,7.31613976705491,7.44221105527638,999,7.36636636636637
595,404,7.33949579831933,7.37376237623762,999,7.35335335335335
601,398,7.3477537437604,7.4321608040201,999,7.38138138138138
604,395,7.34271523178808,7.52405063291139,999,7.41441441441441
614,385,7.34364820846906,7.56883116883117,999,7.43043043043043
617,382,7.36952998379254,7.56282722513089,999,7.44344344344344
610,389,7.37213114754098,7.61182519280206,999,7.46546546546547
611,385,7.41080196399345,7.63636363636364,996,7.49799196787149
623,376,7.39325842696629,7.52659574468085,999,7.44344344344344
615,383,7.39349593495935,7.53524804177546,998,7.44789579158317
619,379,7.41841680129241,7.49076517150396,998,7.44589178356713
624,375,7.37179487179487,7.45866666666667,999,7.4044044044044
630,368,7.44126984126984,7.46739130434783,998,7.45090180360721
630,369,7.42857142857143,7.4579945799458,999,7.43943943943944
629,369,7.42925278219396,7.40921409214092,998,7.42184368737475
620,379,7.41451612903226,7.37994722955145,999,7.4014014014014
612,385,7.41666666666667,7.38181818181818,997,7.40320962888666
617,381,7.41329011345219,7.43569553805774,998,7.42184368737475
621,377,7.41384863123994,7.39787798408488,998,7.40781563126253
602,395,7.43687707641196,7.45822784810127,997,7.44533600802407
600,399,7.45666666666667,7.37844611528822,999,7.42542542542543
601,396,7.44925124792013,7.39646464646465,997,7.42828485456369
603,395,7.43946932006634,7.41772151898734,998,7.43086172344689
603,396,7.40630182421227,7.44949494949495,999,7.42342342342342
603,395,7.37313432835821,7.47848101265823,998,7.41482965931864
604,395,7.36754966887417,7.44556962025316,999,7.3983983983984
598,400,7.37458193979933,7.415,998,7.39078156312625
596,403,7.38255033557047,7.42183622828784,999,7.3983983983984
600,397,7.4,7.3904282115869,997,7.39618856569709
594,404,7.34511784511785,7.42821782178218,998,7.37875751503006
593,405,7.34064080944351,7.44444444444444,998,7.38276553106212
594,405,7.31481481481481,7.44691358024691,999,7.36836836836837
596,401,7.31375838926174,7.45386533665835,997,7.37011033099298
610,388,7.33770491803279,7.39432989690722,998,7.35971943887776
607,391,7.36408566721582,7.36828644501279,998,7.36573146292585
609,388,7.34975369458128,7.32474226804124,997,7.34002006018054
627,372,7.32535885167464,7.3010752688172,999,7.31631631631632
627,372,7.29984051036683,7.31182795698925,999,7.3043043043043
635,362,7.27244094488189,7.38950276243094,997,7.31494483450351
636,363,7.30660377358491,7.38567493112948,999,7.33533533533534
635,363,7.34173228346457,7.35537190082645,998,7.34669338677355
632,366,7.33544303797468,7.36612021857924,998,7.34669338677355
629,370,7.36248012718601,7.37027027027027,999,7.36536536536537
644,352,7.3695652173913,7.38352272727273,996,7.37449799196787
642,356,7.3785046728972,7.41011235955056,998,7.38977955911824
639,358,7.38341158059468,7.45251396648045,997,7.40822467402207
654,345,7.34862385321101,7.48695652173913,999,7.3963963963964
644,353,7.32142857142857,7.47875354107649,997,7.37713139418255
646,351,7.29876160990712,7.51851851851852,997,7.37612838515547
648,350,7.32716049382716,7.47142857142857,998,7.37775551102204
635,363,7.3259842519685,7.46280991735537,998,7.37575150300601
636,362,7.32547169811321,7.50552486187845,998,7.39078156312625
633,365,7.35545023696682,7.55068493150685,998,7.42685370741483
651,347,7.3594470046083,7.50432276657061,998,7.40981963927856
652,347,7.3558282208589,7.46397694524496,999,7.39339339339339
645,354,7.33643410852713,7.45197740112994,999,7.37737737737738
643,355,7.34214618973561,7.41408450704225,998,7.36773547094188
636,361,7.41194968553459,7.40997229916897,997,7.41123370110331
646,350,7.45510835913313,7.40571428571429,996,7.43775100401606
634,364,7.43690851735016,7.40934065934066,998,7.42685370741483
631,366,7.4405705229794,7.41256830601093,997,7.43029087261785
630,366,7.42857142857143,7.45628415300546,996,7.43875502008032
626,371,7.38338658146965,7.45013477088949,997,7.40822467402207
631,368,7.38668779714738,7.41847826086957,999,7.3983983983984
637,361,7.3563579277865,7.398891966759,998,7.37174348697395
640,358,7.3921875,7.41340782122905,998,7.3997995991984
645,354,7.34573643410853,7.37005649717514,999,7.35435435435435
650,348,7.30769230769231,7.33045977011494,998,7.31563126252505
647,350,7.2967542503864,7.36285714285714,997,7.31995987963892
638,361,7.30094043887147,7.37396121883657,999,7.32732732732733
633,365,7.28751974723539,7.37260273972603,998,7.3186372745491
634,365,7.3217665615142,7.33424657534247,999,7.32632632632633
636,363,7.30503144654088,7.31955922865014,999,7.31031031031031
632,367,7.30537974683544,7.33787465940055,999,7.31731731731732
629,369,7.35453100158982,7.33333333333333,998,7.34669338677355
620,379,7.31129032258065,7.30870712401055,999,7.31031031031031
621,377,7.27536231884058,7.25464190981432,998,7.26753507014028
612,387,7.27614379084967,7.25064599483204,999,7.26626626626627
607,390,7.26523887973641,7.21538461538462,997,7.2457372116349
610,388,7.24426229508197,7.29123711340206,998,7.2625250501002
600,397,7.22166666666667,7.28211586901763,997,7.2457372116349
603,396,7.23548922056385,7.29292929292929,999,7.25825825825826
607,392,7.2339373970346,7.26020408163265,999,7.24424424424424
608,390,7.23519736842105,7.22307692307692,998,7.23046092184369
604,395,7.21854304635762,7.2,999,7.21121121121121
600,398,7.22666666666667,7.17587939698493,998,7.2064128256513
599,397,7.17028380634391,7.18891687657431,996,7.17771084337349
590,408,7.19661016949153,7.15686274509804,998,7.18036072144289
602,396,7.19601328903654,7.18686868686869,998,7.19238476953908
609,390,7.20197044334975,7.23846153846154,999,7.21621621621622
617,382,7.20097244732577,7.2696335078534,999,7.22722722722723
621,378,7.20772946859903,7.3042328042328,999,7.24424424424424
601,398,7.18136439267887,7.28391959798995,999,7.22222222222222
600,399,7.20333333333333,7.26817042606516,999,7.22922922922923
602,396,7.2093023255814,7.32070707070707,998,7.25350701402806
590,409,7.23389830508475,7.31540342298289,999,7.26726726726727
596,402,7.19630872483221,7.33830845771144,998,7.25350701402806
600,396,7.16333333333333,7.31565656565657,996,7.22389558232932
591,408,7.15228426395939,7.31862745098039,999,7.22022022022022
587,410,7.23339011925043,7.39268292682927,997,7.29889669007021
581,418,7.24956970740103,7.41387559808612,999,7.31831831831832
575,420,7.25913043478261,7.42380952380952,995,7.3286432160804
579,420,7.24697754749568,7.43095238095238,999,7.32432432432432
584,415,7.26712328767123,7.4144578313253,999,7.32832832832833
584,415,7.25856164383562,7.51084337349398,999,7.36336336336336
583,416,7.30360205831904,7.48557692307692,999,7.37937937937938
580,419,7.24137931034483,7.47732696897375,999,7.34034034034034
579,419,7.23316062176166,7.48687350835322,998,7.33967935871743
579,420,7.29533678756477,7.52380952380952,999,7.39139139139139
579,420,7.29706390328152,7.48809523809524,999,7.37737737737738
578,421,7.32352941176471,7.46318289786223,999,7.38238238238238
589,410,7.33106960950764,7.50243902439024,999,7.4014014014014
583,416,7.29845626072041,7.48317307692308,999,7.37537537537538
580,419,7.32068965517241,7.42482100238663,999,7.36436436436436
579,418,7.3160621761658,7.4377990430622,997,7.36710130391173
574,424,7.34843205574913,7.47877358490566,998,7.40380761523046
582,417,7.33848797250859,7.44364508393285,999,7.38238238238238
580,419,7.30172413793103,7.39140811455847,999,7.33933933933934
578,421,7.33737024221453,7.45368171021378,999,7.38638638638639
569,429,7.3585237258348,7.48484848484848,998,7.41282565130261
570,429,7.40350877192982,7.4965034965035,999,7.44344344344344
571,428,7.38528896672504,7.44158878504673,999,7.40940940940941
554,444,7.39350180505415,7.48198198198198,998,7.43286573146293
562,437,7.38256227758007,7.4370709382151,999,7.40640640640641
557,442,7.39856373429084,7.49095022624434,999,7.43943943943944
556,443,7.44244604316547,7.46501128668172,999,7.45245245245245
556,443,7.4568345323741,7.44469525959368,999,7.45145145145145
555,443,7.46666666666667,7.48532731376975,998,7.4749498997996
546,452,7.43040293040293,7.51548672566372,998,7.4689378757515
532,467,7.41353383458647,7.51177730192719,999,7.45945945945946
532,467,7.43609022556391,7.54389721627409,999,7.48648648648649
536,462,7.4384328358209,7.54329004329004,998,7.48697394789579
531,467,7.3804143126177,7.52676659528908,998,7.44889779559118
543,456,7.34254143646409,7.55921052631579,999,7.44144144144144
544,453,7.31801470588235,7.54966887417219,997,7.42326980942828
544,455,7.31985294117647,7.56263736263736,999,7.43043043043043
552,447,7.31159420289855,7.60626398210291,999,7.44344344344344
561,438,7.31907308377897,7.59360730593607,999,7.43943943943944
554,444,7.32671480144404,7.56981981981982,998,7.43486973947896
563,436,7.32326820603908,7.58715596330275,999,7.43843843843844
555,444,7.30630630630631,7.54054054054054,999,7.41041041041041
552,447,7.33514492753623,7.51006711409396,999,7.41341341341341
553,446,7.36708860759494,7.4932735426009,999,7.42342342342342
555,443,7.32792792792793,7.46952595936795,998,7.39078156312625
549,450,7.3023679417122,7.48888888888889,999,7.38638638638639
551,448,7.28493647912886,7.42633928571429,999,7.34834834834835
542,457,7.30627306273063,7.47483588621444,999,7.38338338338338
542,457,7.29520295202952,7.42669584245077,999,7.35535535535536
533,466,7.24202626641651,7.4206008583691,999,7.32532532532533
540,459,7.23703703703704,7.41830065359477,999,7.32032032032032
538,460,7.25650557620818,7.37391304347826,998,7.31062124248497
538,459,7.25836431226766,7.40087145969499,997,7.32397191574724
542,456,7.28228782287823,7.39035087719298,998,7.33166332665331
540,458,7.31296296296296,7.40829694323144,998,7.35671342685371
541,457,7.29574861367837,7.43763676148796,998,7.36072144288577
540,459,7.31481481481481,7.40958605664488,999,7.35835835835836
536,463,7.30970149253731,7.37149028077754,999,7.33833833833834
531,467,7.29943502824859,7.42612419700214,998,7.35871743486974
534,464,7.32209737827715,7.48922413793103,998,7.3997995991984
531,468,7.32956685499058,7.52777777777778,999,7.42242242242242
531,466,7.35781544256121,7.55364806866953,997,7.4493480441324
529,470,7.37429111531191,7.55531914893617,999,7.45945945945946
540,459,7.32777777777778,7.55555555555556,999,7.43243243243243
538,459,7.29368029739777,7.51851851851852,997,7.39719157472417
526,472,7.35171102661597,7.46398305084746,998,7.40480961923848
521,478,7.36276391554703,7.47280334728034,999,7.41541541541542
523,476,7.35181644359465,7.52731092436975,999,7.43543543543544
525,474,7.32380952380952,7.51054852320675,999,7.41241241241241
530,468,7.34528301886792,7.44871794871795,998,7.3937875751503
530,465,7.34339622641509,7.39784946236559,995,7.36884422110553
541,457,7.31977818853974,7.41137855579869,998,7.36172344689379
553,446,7.33815551537071,7.39686098654709,999,7.36436436436436
559,440,7.34704830053667,7.36363636363636,999,7.35435435435435
566,430,7.37102473498233,7.32093023255814,996,7.34939759036145
566,433,7.34275618374558,7.2933025404157,999,7.32132132132132
566,432,7.39222614840989,7.25925925925926,998,7.33466933867735
562,436,7.37366548042705,7.23623853211009,998,7.31362725450902
570,429,7.4,7.24475524475525,999,7.33333333333333
580,418,7.43103448275862,7.23444976076555,998,7.34869739478958
583,414,7.45283018867925,7.24154589371981,997,7.36509528585757
583,415,7.43224699828473,7.26987951807229,998,7.36472945891784
588,411,7.45238095238095,7.29440389294404,999,7.38738738738739
591,407,7.47038917089678,7.34152334152334,998,7.41783567134269
590,409,7.47966101694915,7.34229828850856,999,7.42342342342342
586,411,7.48122866894198,7.35766423357664,997,7.43029087261785
587,412,7.51277683134583,7.36650485436893,999,7.45245245245245
583,416,7.56089193825043,7.36298076923077,999,7.47847847847848
585,414,7.55726495726496,7.40579710144928,999,7.49449449449449
588,411,7.53741496598639,7.42092457420925,999,7.48948948948949
585,414,7.50769230769231,7.43961352657005,999,7.47947947947948
578,415,7.51038062283737,7.48192771084337,993,7.49848942598187
586,413,7.46075085324232,7.50847457627119,999,7.48048048048048
587,412,7.48892674616695,7.50242718446602,999,7.49449449449449
583,416,7.48713550600343,7.5,999,7.49249249249249
585,414,7.5025641025641,7.51690821256039,999,7.50850850850851
592,405,7.45439189189189,7.49382716049383,997,7.4704112337011
597,402,7.43886097152429,7.50497512437811,999,7.46546546546547
595,403,7.44201680672269,7.52853598014888,998,7.47695390781563
588,411,7.43707482993197,7.52554744525547,999,7.47347347347347
593,406,7.45025295109612,7.50738916256158,999,7.47347347347347
588,410,7.47619047619048,7.49024390243902,998,7.48196392785571
580,418,7.45344827586207,7.50956937799043,998,7.47695390781563
586,412,7.45051194539249,7.56553398058252,998,7.49799599198397
580,416,7.47586206896552,7.62019230769231,996,7.53614457831325
579,419,7.51986183074266,7.63007159904535,998,7.56613226452906
583,415,7.50257289879931,7.66746987951807,998,7.57114228456914
587,411,7.47870528109029,7.65206812652068,998,7.5501002004008
579,420,7.49050086355786,7.64761904761905,999,7.55655655655656
585,414,7.47521367521368,7.64492753623188,999,7.54554554554555
591,408,7.50592216582064,7.66666666666667,999,7.57157157157157
586,412,7.50511945392492,7.63592233009709,998,7.55911823647295
574,425,7.46689895470383,7.59058823529412,999,7.51951951951952
572,425,7.42307692307692,7.63294117647059,997,7.51253761283852
571,426,7.46234676007005,7.64084507042254,997,7.53861584754263
573,424,7.478184991274,7.57075471698113,997,7.51755265797392
573,425,7.49738219895288,7.56,998,7.52404809619238
572,426,7.50524475524475,7.57746478873239,998,7.53607214428858
569,429,7.49033391915641,7.53613053613054,998,7.51002004008016
565,433,7.53097345132743,7.53579676674365,998,7.53306613226453
567,431,7.50617283950617,7.51508120649652,998,7.51002004008016
572,427,7.53146853146853,7.48711943793911,999,7.51251251251251
578,421,7.52595155709343,7.55106888361045,999,7.53653653653654
566,433,7.53180212014134,7.53579676674365,999,7.53353353353353
568,430,7.54753521126761,7.52093023255814,998,7.53607214428858
565,432,7.48849557522124,7.49768518518519,997,7.49247743229689
573,426,7.43804537521815,7.46948356807512,999,7.45145145145145
568,430,7.44718309859155,7.4906976744186,998,7.46593186372746
569,429,7.44288224956063,7.46620046620047,998,7.45290581162325
574,424,7.44425087108014,7.41509433962264,998,7.43186372745491
573,426,7.40488656195462,7.46244131455399,999,7.42942942942943
588,411,7.42176870748299,7.42335766423358,999,7.42242242242242
582,416,7.42783505154639,7.41105769230769,998,7.42084168336673
584,415,7.41438356164384,7.38072289156626,999,7.4004004004004
584,413,7.45205479452055,7.40677966101695,997,7.4332998996991
597,401,7.43383584589615,7.3715710723192,998,7.40881763527054
592,406,7.45608108108108,7.3448275862069,998,7.41082164328657
583,416,7.46483704974271,7.36538461538461,999,7.42342342342342
582,417,7.49828178694158,7.34772182254197,999,7.43543543543544
577,420,7.53032928942808,7.33333333333333,997,7.44734202607823
590,409,7.49152542372881,7.35696821515892,999,7.43643643643644
582,416,7.49484536082474,7.38942307692308,998,7.45090180360721
585,413,7.49401709401709,7.41888619854722,998,7.46292585170341
586,412,7.46757679180887,7.36650485436893,998,7.42585170340681
578,420,7.46539792387543,7.34523809523809,998,7.41482965931864
573,426,7.43804537521815,7.37793427230047,999,7.41241241241241
572,426,7.44230769230769,7.35680751173709,998,7.40581162324649
573,422,7.38743455497382,7.37677725118483,995,7.38291457286432
574,424,7.41289198606272,7.37735849056604,998,7.39779559118236
577,421,7.42980935875217,7.37767220902613,998,7.40781563126253
583,415,7.3893653516295,7.34457831325301,998,7.37074148296593
585,411,7.3965811965812,7.37712895377129,996,7.38855421686747
577,421,7.41247833622184,7.35391923990499,998,7.3877755511022
586,413,7.41808873720136,7.30750605326877,999,7.37237237237237
583,416,7.40480274442539,7.35336538461539,999,7.38338338338338
584,415,7.42123287671233,7.34698795180723,999,7.39039039039039
578,421,7.42906574394464,7.34916864608076,999,7.3953953953954
583,416,7.42710120068611,7.31730769230769,999,7.38138138138138
575,423,7.43304347826087,7.30496453900709,998,7.37875751503006
564,431,7.38829787234043,7.2830626450116,995,7.3427135678392
569,430,7.39191564147627,7.26976744186047,999,7.33933933933934
562,435,7.35409252669039,7.25977011494253,997,7.31293881644935
569,430,7.35149384885765,7.26976744186047,999,7.31631631631632
574,424,7.36759581881533,7.33254716981132,998,7.35270541082164
572,426,7.34090909090909,7.32863849765258,998,7.33567134268537
565,434,7.33097345132743,7.33410138248848,999,7.33233233233233
571,428,7.33099824868652,7.29906542056075,999,7.31731731731732
560,439,7.34107142857143,7.32118451025057,999,7.33233233233233
573,425,7.39616055846422,7.28470588235294,998,7.34869739478958
576,423,7.34548611111111,7.26004728132388,999,7.30930930930931
577,421,7.35701906412478,7.28266033254157,998,7.32565130260521
590,409,7.34406779661017,7.27383863080685,999,7.31531531531532
583,416,7.35677530017153,7.30769230769231,999,7.33633633633634
579,418,7.35405872193437,7.30143540669856,997,7.33199598796389
587,412,7.31856899488927,7.25485436893204,999,7.29229229229229
588,409,7.35034013605442,7.25916870415648,997,7.31293881644935
584,415,7.38356164383562,7.23373493975904,999,7.32132132132132
590,409,7.38813559322034,7.23960880195599,999,7.32732732732733
587,410,7.36967632027257,7.21219512195122,997,7.3049147442327
595,403,7.34957983193277,7.20347394540943,998,7.29058116232465
599,400,7.34390651085142,7.2075,999,7.28928928928929
615,383,7.3349593495935,7.21409921671018,998,7.28857715430862
610,389,7.33770491803279,7.17994858611825,999,7.27627627627628
613,386,7.32300163132137,7.17875647668394,999,7.26726726726727
613,384,7.29363784665579,7.2109375,997,7.2617853560682
607,392,7.28006589785832,7.21173469387755,999,7.25325325325325
612,387,7.33660130718954,7.1937984496124,999,7.28128128128128
620,378,7.33225806451613,7.14021164021164,998,7.25951903807615
610,387,7.35573770491803,7.19896640826873,997,7.29488465396189
628,371,7.32324840764331,7.21832884097035,999,7.28428428428428
634,364,7.31703470031546,7.20879120879121,998,7.27755511022044
630,368,7.37460317460317,7.20380434782609,998,7.31162324649299
640,357,7.3828125,7.21008403361345,997,7.320962888666
633,365,7.36334913112164,7.20821917808219,998,7.30661322645291
635,364,7.36377952755906,7.18406593406593,999,7.2982982982983
635,363,7.40629921259842,7.15702479338843,998,7.31563126252505
636,361,7.41509433962264,7.21606648199446,997,7.34302908726178
646,353,7.40402476780186,7.20113314447592,999,7.33233233233233
644,353,7.39596273291925,7.21529745042493,997,7.33199598796389
646,352,7.39783281733746,7.17329545454545,998,7.3186372745491
650,349,7.42615384615385,7.16905444126075,999,7.33633633633634
648,349,7.39814814814815,7.21203438395415,997,7.33299899699097
659,340,7.40819423368741,7.21470588235294,999,7.34234234234234
654,344,7.40061162079511,7.25872093023256,998,7.35170340681363
650,348,7.38,7.23563218390805,998,7.32965931863727
658,341,7.41337386018237,7.18768328445748,999,7.33633633633634
660,337,7.42727272727273,7.18991097922849,997,7.34704112337011
665,331,7.38796992481203,7.22960725075529,996,7.33534136546185
664,334,7.35843373493976,7.22754491017964,998,7.31462925851703
661,336,7.35552193645991,7.23511904761905,997,7.31494483450351
665,334,7.3609022556391,7.29041916167665,999,7.33733733733734
666,330,7.37087087087087,7.30909090909091,996,7.3504016064257
664,334,7.38403614457831,7.26347305389222,998,7.3436873747495
664,334,7.41114457831325,7.23652694610778,998,7.35270541082164
662,334,7.44864048338369,7.23353293413174,996,7.37650602409639
655,344,7.45954198473282,7.20058139534884,999,7.37037037037037
661,337,7.48714069591528,7.19584569732938,998,7.38877755511022
662,337,7.45015105740181,7.22848664688427,999,7.37537537537538
661,337,7.45385779122542,7.24629080118694,998,7.38376753507014
663,335,7.46455505279035,7.22985074626866,998,7.38577154308617
667,332,7.44527736131934,7.25,999,7.38038038038038
668,329,7.4565868263473,7.14589665653495,997,7.35406218655968
662,336,7.45015105740181,7.16964285714286,998,7.35571142284569
662,337,7.44108761329305,7.12759643916914,999,7.33533533533534
672,326,7.44494047619048,7.1441717791411,998,7.34669338677355
670,329,7.43880597014925,7.18237082066869,999,7.35435435435435
670,328,7.44029850746269,7.13719512195122,998,7.34068136272545
664,335,7.46084337349398,7.17313432835821,999,7.36436436436436
661,338,7.46293494704992,7.25443786982249,999,7.39239239239239
667,331,7.48575712143928,7.22054380664653,998,7.39779559118236
666,331,7.50900900900901,7.23262839879154,997,7.4172517552658
676,322,7.48076923076923,7.22049689440994,998,7.39679358717435
672,327,7.47916666666667,7.20795107033639,999,7.39039039039039
667,332,7.48725637181409,7.2289156626506,999,7.4014014014014
665,332,7.48270676691729,7.21385542168675,997,7.39317953861585
668,331,7.45209580838323,7.19939577039275,999,7.36836836836837
665,333,7.41804511278195,7.21921921921922,998,7.35170340681363
658,339,7.41185410334347,7.24483775811209,997,7.35506519558676
660,338,7.37424242424242,7.29585798816568,998,7.34769539078156
663,335,7.31523378582202,7.27164179104478,998,7.30060120240481
660,338,7.32272727272727,7.26627218934911,998,7.30360721442886
666,331,7.27777777777778,7.28398791540786,997,7.27983951855567
660,336,7.24090909090909,7.26488095238095,996,7.24899598393574
664,335,7.29819277108434,7.22388059701493,999,7.27327327327327
671,326,7.33830104321908,7.1319018404908,997,7.27081243731194
670,329,7.36268656716418,7.1580547112462,999,7.2952952952953
668,331,7.41017964071856,7.1963746223565,999,7.33933933933934
669,329,7.38266068759342,7.18237082066869,998,7.31663326653307
679,320,7.4020618556701,7.14375,999,7.31931931931932
671,327,7.36661698956781,7.16819571865443,998,7.30160320641283
676,323,7.36538461538461,7.18885448916409,999,7.30830830830831
685,313,7.36350364963504,7.22364217252396,998,7.31963927855711
686,310,7.38629737609329,7.21612903225806,996,7.33333333333333
694,305,7.38760806916426,7.20655737704918,999,7.33233233233233
691,305,7.36903039073806,7.25901639344262,996,7.33534136546185
692,305,7.34826589595376,7.24918032786885,997,7.31795386158475
688,311,7.37645348837209,7.20578778135048,999,7.32332332332332
670,329,7.38507462686567,7.20364741641337,999,7.32532532532533
668,328,7.38622754491018,7.21951219512195,996,7.33132530120482
675,324,7.34814814814815,7.20061728395062,999,7.3003003003003
673,326,7.33729569093611,7.17791411042945,999,7.28528528528529
675,323,7.2962962962963,7.14551083591331,998,7.24749498997996
679,319,7.27245949926362,7.11598746081505,998,7.22244488977956
672,326,7.30357142857143,7.17177914110429,998,7.26052104208417
669,329,7.29446935724963,7.10942249240122,998,7.23346693386774
664,335,7.29819277108434,7.15223880597015,999,7.24924924924925
662,337,7.31268882175227,7.18694362017804,999,7.27027027027027
661,334,7.30862329803328,7.07784431137725,995,7.23115577889447
663,336,7.2790346907994,7.09523809523809,999,7.21721721721722
665,334,7.31428571428571,7.13173652694611,999,7.25325325325325
664,334,7.33283132530121,7.12874251497006,998,7.26452905811623
662,336,7.31268882175227,7.1875,998,7.27054108216433
665,333,7.29172932330827,7.19219219219219,998,7.25851703406814
669,330,7.30493273542601,7.13333333333333,999,7.24824824824825
659,339,7.30197268588771,7.15634218289086,998,7.25250501002004
663,336,7.33031674208145,7.17559523809524,999,7.27827827827828
663,336,7.3393665158371,7.16071428571429,999,7.27927927927928
659,338,7.35660091047041,7.18047337278106,997,7.29689067201605
654,344,7.30886850152905,7.19767441860465,998,7.27054108216433
654,344,7.34250764525994,7.19476744186047,998,7.29158316633267
658,340,7.3161094224924,7.15,998,7.25951903807615
668,330,7.31137724550898,7.18484848484848,998,7.26953907815631
670,329,7.32686567164179,7.19756838905775,999,7.28428428428428
669,330,7.3168908819133,7.2,999,7.27827827827828
672,325,7.32589285714286,7.23384615384615,997,7.29588766298897
661,337,7.35703479576399,7.28189910979228,998,7.33166332665331
664,335,7.375,7.2089552238806,999,7.31931931931932
651,348,7.36251920122888,7.19252873563218,999,7.3033033033033
655,344,7.3587786259542,7.20348837209302,999,7.30530530530531
658,341,7.34954407294833,7.17302052785924,999,7.28928928928929
657,342,7.37138508371385,7.19005847953216,999,7.30930930930931
661,337,7.35249621785174,7.18694362017804,998,7.29659318637275
661,338,7.35552193645991,7.18047337278106,999,7.2962962962963
656,343,7.375,7.18950437317784,999,7.31131131131131
654,344,7.34403669724771,7.13953488372093,998,7.27354709418838
662,337,7.38368580060423,7.11572700296736,999,7.29329329329329
662,337,7.39274924471299,7.18100890207715,999,7.32132132132132
674,324,7.38427299703264,7.18518518518519,998,7.31963927855711
677,321,7.39143279172821,7.13395638629283,998,7.30861723446894
675,323,7.42962962962963,7.15789473684211,998,7.34168336673347
670,328,7.44477611940299,7.15243902439024,998,7.34869739478958
662,337,7.48942598187311,7.18100890207715,999,7.38538538538539
672,327,7.52083333333333,7.19877675840979,999,7.41541541541542
666,329,7.49099099099099,7.2887537993921,995,7.42412060301508
668,328,7.51646706586826,7.32621951219512,996,7.45381526104418
669,330,7.50373692077728,7.33030303030303,999,7.44644644644645
672,325,7.51636904761905,7.35692307692308,997,7.46439317953862
662,336,7.48791540785498,7.34821428571429,998,7.44088176352705
655,344,7.45343511450382,7.32848837209302,999,7.41041041041041
658,340,7.46352583586626,7.34117647058823,998,7.42184368737475
652,347,7.4340490797546,7.32564841498559,999,7.3963963963964
664,335,7.46987951807229,7.28059701492537,999,7.40640640640641
652,346,7.45552147239264,7.21387283236994,998,7.37174348697395
657,342,7.45357686453577,7.25146198830409,999,7.38438438438438
660,336,7.40454545454545,7.26488095238095,996,7.3574297188755
656,341,7.40396341463415,7.29618768328446,997,7.36710130391173
658,341,7.41641337386018,7.24926686217009,999,7.35935935935936
665,333,7.45714285714286,7.28528528528529,998,7.3997995991984
657,342,7.441400304414,7.27485380116959,999,7.38438438438438
661,335,7.46142208774584,7.30746268656716,996,7.40963855421687
667,331,7.49025487256372,7.35347432024169,998,7.44488977955912
664,335,7.49397590361446,7.38805970149254,999,7.45845845845846
661,338,7.4856278366112,7.34615384615385,999,7.43843843843844
656,343,7.48780487804878,7.40816326530612,999,7.46046046046046
667,332,7.47526236881559,7.40361445783132,999,7.45145145145145
661,338,7.45385779122542,7.43491124260355,999,7.44744744744745
666,333,7.5,7.42342342342342,999,7.47447447447447
663,336,7.52036199095023,7.44345238095238,999,7.49449449449449
659,340,7.53110773899848,7.44411764705882,999,7.5015015015015
660,339,7.51969696969697,7.46017699115044,999,7.4994994994995
661,338,7.48260211800303,7.48816568047337,999,7.48448448448448
660,339,7.4969696969697,7.52212389380531,999,7.50550550550551
652,346,7.45245398773006,7.47976878612717,998,7.46192384769539
665,334,7.43458646616541,7.51497005988024,999,7.46146146146146
669,330,7.44992526158445,7.50606060606061,999,7.46846846846847
667,331,7.44527736131934,7.54682779456193,998,7.47895791583166
676,323,7.45710059171598,7.57894736842105,999,7.4964964964965
677,321,7.42245199409158,7.53582554517134,998,7.45891783567134
679,319,7.40353460972018,7.59247648902821,998,7.46392785571142
683,314,7.38360175695461,7.56687898089172,997,7.44132397191575
680,318,7.38823529411765,7.5062893081761,998,7.42585170340681
683,316,7.44363103953148,7.48417721518987,999,7.45645645645646
684,315,7.44590643274854,7.45079365079365,999,7.44744744744745
679,320,7.4300441826215,7.44375,999,7.43443443443443
681,316,7.45668135095448,7.36075949367089,997,7.42627883650953
692,304,7.47543352601156,7.31907894736842,996,7.42771084337349
696,302,7.47126436781609,7.29139072847682,998,7.41683366733467
700,299,7.52,7.29096989966555,999,7.45145145145145
700,298,7.50857142857143,7.36577181208054,998,7.46593186372746
706,293,7.52266288951841,7.35494880546075,999,7.47347347347347
699,300,7.51216022889843,7.35666666666667,999,7.46546546546547
696,303,7.49425287356322,7.33993399339934,999,7.44744744744745
690,308,7.49130434782609,7.35714285714286,998,7.4498997995992
686,313,7.48104956268222,7.35143769968051,999,7.44044044044044
693,305,7.50649350649351,7.29508196721311,998,7.44188376753507
689,310,7.48621190130624,7.30967741935484,999,7.43143143143143
683,313,7.47584187408492,7.35143769968051,996,7.43674698795181
701,298,7.45791726105564,7.31543624161074,999,7.41541541541542
699,300,7.43919885550787,7.33333333333333,999,7.40740740740741
689,310,7.45137880986938,7.33870967741935,999,7.41641641641642
679,318,7.46980854197349,7.36163522012579,997,7.43530591775326
680,316,7.47205882352941,7.31012658227848,996,7.4206827309237
680,318,7.45588235294118,7.30817610062893,998,7.40881763527054
680,317,7.46764705882353,7.34069400630915,997,7.42728184553661
682,316,7.43841642228739,7.32278481012658,998,7.40180360721443
677,321,7.48892171344165,7.32398753894081,998,7.43587174348697
675,323,7.5037037037037,7.40557275541796,998,7.47194388777555
677,322,7.50812407680945,7.37888198757764,999,7.46646646646647
675,323,7.51111111111111,7.35603715170279,998,7.46092184368737
678,319,7.49705014749262,7.35423197492163,997,7.45135406218656
680,318,7.49558823529412,7.32704402515723,998,7.44188376753507
672,327,7.47023809523809,7.31804281345566,999,7.42042042042042
677,322,7.49335302806499,7.38509316770186,999,7.45845845845846
678,320,7.48525073746313,7.346875,998,7.44088176352705
683,316,7.50073206442167,7.32278481012658,999,7.44444444444444
683,314,7.50073206442167,7.30891719745223,997,7.44032096288867
688,310,7.54505813953488,7.26451612903226,998,7.45791583166333
683,316,7.57247437774524,7.25949367088608,999,7.47347347347347
692,307,7.55635838150289,7.33224755700326,999,7.48748748748749
696,303,7.56034482758621,7.34983498349835,999,7.4964964964965
698,300,7.53151862464183,7.3,998,7.46192384769539
700,299,7.54428571428571,7.2943143812709,999,7.46946946946947
708,291,7.5225988700565,7.25085910652921,999,7.44344344344344
714,285,7.52801120448179,7.2,999,7.43443443443443
707,291,7.57142857142857,7.17182130584192,998,7.45490981963928
706,293,7.56090651558074,7.18088737201365,999,7.44944944944945
704,294,7.51704545454545,7.16666666666667,998,7.41382765531062
703,296,7.50213371266003,7.13851351351351,999,7.39439439439439
706,293,7.48441926345609,7.16040955631399,999,7.38938938938939
716,282,7.46787709497207,7.25177304964539,998,7.40681362725451
720,279,7.45833333333333,7.2078853046595,999,7.38838838838839
714,285,7.47619047619048,7.1719298245614,999,7.38938938938939
712,286,7.50842696629214,7.21678321678322,998,7.4248496993988
708,290,7.46186440677966,7.18620689655172,998,7.38176352705411
713,286,7.45021037868163,7.17132867132867,999,7.37037037037037
720,278,7.48055555555556,7.20863309352518,998,7.40480961923848
716,282,7.52374301675978,7.21985815602837,998,7.43787575150301
718,281,7.5125348189415,7.27402135231317,999,7.44544544544545
713,284,7.49789621318373,7.28521126760563,997,7.43731193580742
724,275,7.52486187845304,7.23636363636364,999,7.44544544544545
721,278,7.51872399445215,7.2589928057554,999,7.44644644644645
730,269,7.52054794520548,7.12639405204461,999,7.41441441441441
730,267,7.47945205479452,7.1123595505618,997,7.38114343029087
728,270,7.4793956043956,7.12962962962963,998,7.38476953907816
733,266,7.49386084583902,7.15789473684211,999,7.4044044044044
730,269,7.49178082191781,7.17843866171004,999,7.40740740740741
720,279,7.5,7.17204301075269,999,7.40840840840841
724,273,7.49171270718232,7.21611721611722,997,7.41624874623872
725,274,7.49793103448276,7.25912408759124,999,7.43243243243243
719,278,7.48539638386648,7.23741007194245,997,7.41624874623872
713,285,7.51051893408135,7.16842105263158,998,7.41282565130261
708,291,7.46892655367232,7.09621993127148,999,7.36036036036036
702,297,7.48717948717949,7.15824915824916,999,7.38938938938939
706,293,7.46883852691218,7.19795221843003,999,7.38938938938939
708,289,7.43926553672316,7.22491349480969,997,7.37713139418255
713,286,7.48667601683029,7.26573426573427,999,7.42342342342342
716,279,7.55167597765363,7.3010752688172,995,7.48140703517588
718,280,7.5125348189415,7.25,998,7.43887775551102
715,282,7.4993006993007,7.29078014184397,997,7.44032096288867
718,277,7.52089136490251,7.32129963898917,995,7.46532663316583
721,276,7.51178918169209,7.33695652173913,997,7.46339017051153
725,274,7.50206896551724,7.27737226277372,999,7.44044044044044
727,270,7.52132049518569,7.28888888888889,997,7.45837512537613
725,274,7.53379310344828,7.27372262773723,999,7.46246246246246
733,265,7.51841746248295,7.23018867924528,998,7.44188376753507
731,266,7.52804377564979,7.22556390977444,997,7.44734202607823
727,270,7.52269601100413,7.17777777777778,997,7.42928786359077
732,266,7.4931693989071,7.22556390977444,998,7.42184368737475
744,255,7.51209677419355,7.25490196078431,999,7.44644644644645
742,256,7.49595687331536,7.30859375,998,7.44789579158317
755,244,7.50331125827815,7.30737704918033,999,7.45545545545546
748,247,7.49866310160428,7.44534412955466,995,7.48542713567839
753,246,7.50996015936255,7.42682926829268,999,7.48948948948949
749,250,7.51268357810414,7.424,999,7.49049049049049
754,244,7.52519893899204,7.42213114754098,998,7.5
749,250,7.49666221628838,7.408,999,7.47447447447447
749,248,7.51134846461949,7.40725806451613,997,7.48545636910732
754,245,7.5106100795756,7.35102040816327,999,7.47147147147147
754,244,7.53050397877984,7.44262295081967,998,7.50901803607214
760,238,7.53684210526316,7.44117647058824,998,7.51402805611222
762,236,7.49737532808399,7.44915254237288,998,7.48597194388778
766,230,7.53002610966057,7.45217391304348,996,7.51204819277108
774,225,7.53617571059432,7.40888888888889,999,7.50750750750751
782,216,7.57161125319693,7.47222222222222,998,7.5501002004008
774,224,7.5749354005168,7.37946428571429,998,7.5310621242485
778,219,7.56555269922879,7.46118721461187,997,7.54262788365095
779,220,7.56482670089859,7.44090909090909,999,7.53753753753754
772,226,7.56476683937824,7.41592920353982,998,7.5310621242485
773,226,7.53945666235446,7.42477876106195,999,7.51351351351351
784,215,7.53826530612245,7.53023255813954,999,7.53653653653654
780,218,7.52435897435897,7.4954128440367,998,7.51803607214429
787,211,7.59085133418043,7.4739336492891,998,7.56613226452906
789,209,7.5830164765526,7.47846889952153,998,7.56112224448898
794,204,7.6007556675063,7.51470588235294,998,7.58316633266533
793,206,7.54981084489281,7.53883495145631,999,7.54754754754755
795,203,7.57987421383648,7.59605911330049,998,7.58316633266533
794,205,7.59068010075567,7.67317073170732,999,7.60760760760761
797,199,7.59723964868256,7.61306532663317,996,7.6004016064257
802,196,7.58728179551122,7.58673469387755,998,7.58717434869739
796,202,7.57788944723618,7.60891089108911,998,7.58416833667335
793,206,7.5687263556116,7.58252427184466,999,7.57157157157157
794,204,7.56801007556675,7.56372549019608,998,7.56713426853707
795,204,7.55723270440252,7.62745098039216,999,7.57157157157157
799,199,7.55444305381727,7.5929648241206,998,7.56212424849699
796,202,7.53266331658291,7.52970297029703,998,7.53206412825651
796,203,7.54522613065327,7.48275862068965,999,7.53253253253253
799,199,7.57697121401752,7.51758793969849,998,7.56513026052104
783,216,7.55683269476373,7.56481481481481,999,7.55855855855856
783,216,7.56194125159642,7.55092592592593,999,7.55955955955956
782,217,7.57416879795396,7.52995391705069,999,7.56456456456456
782,217,7.57416879795396,7.57603686635945,999,7.57457457457457
786,213,7.56743002544529,7.63849765258216,999,7.58258258258258
783,216,7.56194125159642,7.72222222222222,999,7.5965965965966
787,211,7.5997458703939,7.71563981042654,998,7.62424849699399
788,210,7.62182741116751,7.72380952380952,998,7.64328657314629
785,212,7.57452229299363,7.71698113207547,997,7.60481444332999
791,206,7.56890012642225,7.67961165048544,997,7.59177532597793
782,217,7.57033248081841,7.71889400921659,999,7.6026026026026
788,210,7.57994923857868,7.70952380952381,998,7.60721442885772
789,210,7.55893536121673,7.65714285714286,999,7.57957957957958
790,209,7.51139240506329,7.65071770334928,999,7.54054054054054
790,208,7.51518987341772,7.72115384615385,998,7.55811623246493
794,205,7.48110831234257,7.7609756097561,999,7.53853853853854
787,212,7.50825921219822,7.75,999,7.55955955955956
781,218,7.5044814340589,7.6697247706422,999,7.54054054054054
785,214,7.48917197452229,7.66355140186916,999,7.52652652652653
780,217,7.49358974358974,7.65437788018433,997,7.52858575727182
775,224,7.46451612903226,7.64732142857143,999,7.50550550550551
779,220,7.46341463414634,7.68636363636364,999,7.51251251251251
782,216,7.46035805626599,7.66666666666667,998,7.50501002004008
780,218,7.44102564102564,7.70183486238532,998,7.49799599198397
786,211,7.4147582697201,7.77251184834123,997,7.49047141424273
796,201,7.44849246231156,7.74129353233831,997,7.50752256770311
791,207,7.43489254108723,7.76811594202899,998,7.50400801603206
800,199,7.46125,7.70854271356784,999,7.51051051051051
794,203,7.47229219143577,7.70443349753695,997,7.51955867602808
800,197,7.52,7.81218274111675,997,7.5777331995988
796,203,7.5213567839196,7.75862068965517,999,7.56956956956957
798,201,7.531328320802,7.74129353233831,999,7.57357357357357
798,201,7.53759398496241,7.76119402985075,999,7.58258258258258
794,205,7.56297229219144,7.69756097560976,999,7.59059059059059
792,207,7.58080808080808,7.67632850241546,999,7.6006006006006
787,211,7.56670902160102,7.68720379146919,998,7.59218436873747
793,204,7.57124842370744,7.70098039215686,997,7.59779338014042
791,206,7.59544879898862,7.76699029126214,997,7.6308926780341
789,209,7.52851711026616,7.80382775119617,998,7.58617234468938
788,209,7.5253807106599,7.80861244019139,997,7.58475426278837
782,216,7.51790281329923,7.80092592592593,998,7.57915831663327
787,212,7.5146124523507,7.76415094339623,999,7.56756756756757
779,220,7.49165596919127,7.82727272727273,999,7.56556556556557
776,223,7.45489690721649,7.71300448430493,999,7.51251251251251
768,231,7.43880208333333,7.73160173160173,999,7.50650650650651
771,228,7.4591439688716,7.71929824561404,999,7.51851851851852
767,232,7.47979139504563,7.73275862068965,999,7.53853853853854
757,240,7.47424042272127,7.725,997,7.5346038114343
754,244,7.48541114058355,7.75,998,7.5501002004008
758,240,7.47361477572559,7.78333333333333,998,7.54809619238477
755,243,7.44635761589404,7.77777777777778,998,7.52705410821643
746,253,7.43699731903485,7.79841897233202,999,7.52852852852853
752,245,7.45079787234043,7.79183673469388,997,7.5346038114343
743,256,7.46702557200538,7.8046875,999,7.55355355355355
743,256,7.49798115746972,7.77734375,999,7.56956956956957
732,266,7.55054644808743,7.83834586466165,998,7.62725450901804
733,266,7.54297407912688,7.80451127819549,999,7.61261261261261
729,268,7.54869684499314,7.76492537313433,997,7.60682046138415
729,270,7.55829903978052,7.78148148148148,999,7.61861861861862
728,271,7.57005494505495,7.74169741697417,999,7.61661661661662
714,284,7.56022408963585,7.64084507042254,998,7.58316633266533
721,278,7.58668515950069,7.65107913669065,999,7.6046046046046
725,274,7.57379310344828,7.66058394160584,999,7.5975975975976
729,268,7.60356652949246,7.67537313432836,997,7.62286860581745
731,268,7.5827633378933,7.58955223880597,999,7.58458458458458
726,272,7.58126721763085,7.61029411764706,998,7.58917835671343
719,280,7.57579972183588,7.59642857142857,999,7.58158158158158
718,279,7.57660167130919,7.59139784946237,997,7.58074222668004
710,288,7.55352112676056,7.59722222222222,998,7.56613226452906
714,284,7.55182072829132,7.58450704225352,998,7.56112224448898
723,275,7.55048409405256,7.62545454545455,998,7.57114228456914
717,281,7.57601115760112,7.6085409252669,998,7.58517034068136
721,276,7.54923717059639,7.61231884057971,997,7.5667001003009
716,281,7.55586592178771,7.63701067615658,997,7.57873620862588
706,293,7.51274787535411,7.62798634812287,999,7.54654654654655
713,285,7.52173913043478,7.61754385964912,998,7.54909819639279
710,288,7.50140845070423,7.57986111111111,998,7.52404809619238
720,278,7.49027777777778,7.55035971223022,998,7.50701402805611
729,268,7.52126200274348,7.60820895522388,997,7.54463390170512
736,262,7.48369565217391,7.62213740458015,998,7.52004008016032
738,260,7.49051490514905,7.60384615384615,998,7.52004008016032
735,263,7.53877551020408,7.59695817490494,998,7.55410821643287
728,270,7.53846153846154,7.57777777777778,998,7.54909819639279
728,271,7.53159340659341,7.60885608856089,999,7.55255255255255
733,265,7.51705320600273,7.6377358490566,998,7.54909819639279
732,267,7.55054644808743,7.62546816479401,999,7.57057057057057
727,271,7.55020632737276,7.61992619926199,998,7.56913827655311
725,272,7.56827586206897,7.66176470588235,997,7.5937813440321
720,277,7.55972222222222,7.69675090252708,997,7.59779338014042
726,273,7.53581267217631,7.63003663003663,999,7.56156156156156
720,278,7.55,7.61870503597122,998,7.56913827655311
723,276,7.56569847856155,7.53260869565217,999,7.55655655655656
724,274,7.59806629834254,7.5036496350365,998,7.57214428857715
727,271,7.59972489683631,7.51660516605166,998,7.57715430861723
727,272,7.59284731774415,7.47794117647059,999,7.56156156156156
728,271,7.5782967032967,7.49446494464945,999,7.55555555555556
725,273,7.56275862068965,7.49450549450549,998,7.54408817635271
732,267,7.56284153005465,7.51310861423221,999,7.54954954954955
729,270,7.55555555555556,7.49259259259259,999,7.53853853853854
724,275,7.53591160220994,7.46181818181818,999,7.51551551551552
720,279,7.53055555555556,7.44802867383513,999,7.50750750750751
722,276,7.50969529085873,7.47463768115942,998,7.5
713,283,7.51612903225806,7.5547703180212,996,7.52710843373494
711,286,7.53305203938115,7.52097902097902,997,7.5295887662989
714,285,7.49859943977591,7.55789473684211,999,7.51551551551552
714,283,7.49159663865546,7.54770318021201,997,7.50752256770311
708,288,7.50423728813559,7.50694444444444,996,7.50502008032128
716,283,7.48743016759777,7.51236749116608,999,7.49449449449449
705,293,7.49078014184397,7.54266211604096,998,7.5060120240481
700,298,7.50857142857143,7.63422818791946,998,7.54609218436874
707,292,7.4992927864215,7.72945205479452,999,7.56656656656657
710,288,7.53380281690141,7.78125,998,7.60521042084168
709,289,7.53314527503526,7.74048442906574,998,7.59318637274549
715,283,7.53426573426573,7.75265017667845,998,7.59619238476954
712,285,7.55758426966292,7.74035087719298,997,7.6098294884654
711,287,7.57665260196906,7.7212543554007,998,7.61823647294589
719,280,7.59527121001391,7.69285714285714,999,7.62262262262262
725,274,7.59448275862069,7.71897810218978,999,7.62862862862863
726,272,7.6129476584022,7.6875,998,7.63326653306613
718,278,7.60306406685237,7.68705035971223,996,7.62650602409639
723,276,7.60165975103734,7.71014492753623,999,7.63163163163163
734,264,7.55177111716621,7.72348484848485,998,7.59719438877756
736,261,7.53940217391304,7.62452107279694,997,7.5616850551655
739,260,7.5128552097429,7.60384615384615,999,7.53653653653654
744,255,7.52284946236559,7.65882352941177,999,7.55755755755756
738,260,7.50677506775068,7.65,998,7.54408817635271
736,262,7.5054347826087,7.61832061068702,998,7.53507014028056
732,267,7.52322404371585,7.59550561797753,999,7.54254254254254
733,264,7.4924965893588,7.60984848484848,997,7.52357071213641
736,260,7.48777173913043,7.63846153846154,996,7.52710843373494
742,255,7.4811320754717,7.61176470588235,997,7.51454363089268
739,259,7.48985115020298,7.54826254826255,998,7.50501002004008
736,262,7.52038043478261,7.51526717557252,998,7.51903807615231
733,264,7.4774897680764,7.51515151515152,997,7.48746238716148
734,265,7.49182561307902,7.52830188679245,999,7.5015015015015
739,260,7.4573748308525,7.58076923076923,999,7.48948948948949
737,260,7.4966078697422,7.53846153846154,997,7.50752256770311
727,272,7.48143053645117,7.53676470588235,999,7.4964964964965
731,268,7.49658002735978,7.56716417910448,999,7.51551551551552
725,273,7.45379310344828,7.58974358974359,998,7.49098196392786
722,277,7.43767313019391,7.56317689530686,999,7.47247247247247
726,273,7.43388429752066,7.53479853479853,999,7.46146146146146
723,276,7.43430152143845,7.48913043478261,999,7.44944944944945
715,284,7.39160839160839,7.4612676056338,999,7.41141141141141
728,271,7.39972527472527,7.49815498154982,999,7.42642642642643
737,261,7.37449118046133,7.4904214559387,998,7.40480961923848
749,249,7.38851802403204,7.48192771084337,998,7.41182364729459
759,240,7.42819499341238,7.4875,999,7.44244244244244
758,241,7.42480211081794,7.52282157676349,999,7.44844844844845
760,238,7.43684210526316,7.57983193277311,998,7.47094188376754
765,234,7.44967320261438,7.55128205128205,999,7.47347347347347
763,236,7.42726081258191,7.55084745762712,999,7.45645645645646
766,232,7.45039164490862,7.55603448275862,998,7.4749498997996
768,230,7.43098958333333,7.55217391304348,998,7.45891783567134
771,227,7.42153047989624,7.51541850220264,998,7.44288577154309
769,230,7.42392717815345,7.55652173913044,999,7.45445445445445
774,224,7.42377260981912,7.50446428571429,998,7.44188376753507
776,220,7.43041237113402,7.45454545454545,996,7.43574297188755
770,226,7.3961038961039,7.50884955752212,996,7.42168674698795
780,218,7.40512820512821,7.5,998,7.42585170340681
785,213,7.40127388535032,7.45539906103286,998,7.41282565130261
785,214,7.4140127388535,7.45794392523364,999,7.42342342342342
781,217,7.39564660691421,7.46543778801843,998,7.41082164328657
771,227,7.3916990920882,7.45814977973568,998,7.40681362725451
772,226,7.38082901554404,7.51327433628319,998,7.41082164328657
775,222,7.35354838709677,7.59009009009009,997,7.4062186559679
775,224,7.35870967741935,7.625,999,7.41841841841842
773,226,7.35316946959897,7.65486725663717,999,7.42142142142142
771,227,7.33981841763943,7.55506607929515,998,7.38877755511022
768,230,7.35546875,7.62173913043478,998,7.41683366733467
769,230,7.33159947984395,7.6695652173913,999,7.40940940940941
775,223,7.31741935483871,7.71300448430493,998,7.40581162324649
775,222,7.33548387096774,7.73423423423423,997,7.42427281845537
772,226,7.36658031088083,7.66371681415929,998,7.43386773547094
775,224,7.38451612903226,7.64732142857143,999,7.44344344344344
783,216,7.38058748403576,7.63888888888889,999,7.43643643643644
782,216,7.43478260869565,7.60185185185185,998,7.47094188376754
792,207,7.43055555555556,7.60869565217391,999,7.46746746746747
793,206,7.41614123581337,7.60679611650485,999,7.45545545545546
789,210,7.38529784537389,7.63333333333333,999,7.43743743743744
798,200,7.37593984962406,7.605,998,7.42184368737475
798,199,7.35714285714286,7.55276381909548,997,7.39618856569709
801,198,7.37827715355805,7.51515151515152,999,7.40540540540541
799,199,7.34793491864831,7.52261306532663,998,7.38276553106212
794,205,7.31738035264484,7.52195121951219,999,7.35935935935936
792,204,7.29924242424242,7.5,996,7.34036144578313
794,205,7.2808564231738,7.47804878048781,999,7.32132132132132
785,214,7.26369426751592,7.46728971962617,999,7.30730730730731
788,209,7.27030456852792,7.50717703349282,997,7.31995987963892
784,215,7.29464285714286,7.52558139534884,999,7.34434434434434
787,212,7.27700127064803,7.47169811320755,999,7.31831831831832
786,213,7.27735368956743,7.47417840375587,999,7.31931931931932
773,225,7.29883570504528,7.48888888888889,998,7.34168336673347
773,224,7.31694695989651,7.48660714285714,997,7.35506519558676
777,220,7.3024453024453,7.46363636363636,997,7.33801404212638
772,226,7.28108808290155,7.44247787610619,998,7.31763527054108
778,221,7.2892030848329,7.38009049773756,999,7.30930930930931
777,222,7.2998712998713,7.36036036036036,999,7.31331331331331
783,216,7.3154533844189,7.41666666666667,999,7.33733733733734
782,216,7.34398976982097,7.37962962962963,998,7.35170340681363
789,209,7.32953105196451,7.33492822966507,998,7.33066132264529
789,207,7.30291508238276,7.36714975845411,996,7.31626506024096
789,210,7.30671736375158,7.37142857142857,999,7.32032032032032
783,216,7.30779054916986,7.34259259259259,999,7.31531531531532
791,208,7.27686472819216,7.37019230769231,999,7.2962962962963
784,215,7.29336734693878,7.33023255813954,999,7.3013013013013
788,210,7.29568527918782,7.3,998,7.29659318637275
795,203,7.26792452830189,7.2807881773399,998,7.27054108216433
794,205,7.30226700251889,7.37073170731707,999,7.31631631631632
791,208,7.28950695322377,7.39423076923077,999,7.31131131131131
786,213,7.30025445292621,7.46478873239437,999,7.33533533533534
787,211,7.27954256670902,7.41232227488152,998,7.30761523046092
792,206,7.27777777777778,7.42233009708738,998,7.30761523046092
779,220,7.29653401797176,7.42272727272727,999,7.32432432432432
783,213,7.30395913154534,7.39906103286385,996,7.32429718875502
784,214,7.31377551020408,7.42056074766355,998,7.33667334669339
783,216,7.31673052362708,7.39351851851852,999,7.33333333333333
777,220,7.33719433719434,7.39090909090909,997,7.34904714142427
782,216,7.34398976982097,7.39351851851852,998,7.35470941883768
790,208,7.32405063291139,7.4375,998,7.34769539078156
793,206,7.34300126103405,7.50970873786408,999,7.37737737737738
795,204,7.35094339622642,7.54901960784314,999,7.39139139139139
792,207,7.34722222222222,7.51690821256039,999,7.38238238238238
790,209,7.36708860759494,7.54545454545455,999,7.4044044044044
789,210,7.34727503168568,7.45238095238095,999,7.36936936936937
801,197,7.3645443196005,7.44670050761421,998,7.38076152304609
803,196,7.359900373599,7.51530612244898,999,7.39039039039039
797,202,7.34755332496863,7.5,999,7.37837837837838
796,202,7.32035175879397,7.46039603960396,998,7.34869739478958
783,216,7.30779054916986,7.47222222222222,999,7.34334334334334
782,216,7.34271099744246,7.49537037037037,998,7.37575150300601
780,217,7.33076923076923,7.4331797235023,997,7.3530591775326
783,216,7.3448275862069,7.47222222222222,999,7.37237237237237
783,213,7.30651340996169,7.49295774647887,996,7.34638554216868
785,214,7.32611464968153,7.52336448598131,999,7.36836836836837
774,222,7.34754521963824,7.55405405405405,996,7.39357429718875
782,217,7.37212276214834,7.58064516129032,999,7.41741741741742
782,216,7.39386189258312,7.56018518518519,998,7.42985971943888
782,215,7.37084398976982,7.55348837209302,997,7.41023069207623
780,219,7.32692307692308,7.53881278538813,999,7.37337337337337
776,223,7.30541237113402,7.57847533632287,999,7.36636636636637
775,223,7.31870967741935,7.53363228699552,998,7.36673346693387
769,228,7.34850455136541,7.66666666666667,997,7.42126379137412
773,225,7.38421733505821,7.71111111111111,998,7.45791583166333
770,228,7.34025974025974,7.68421052631579,998,7.4188376753507
775,224,7.34709677419355,7.71428571428571,999,7.42942942942943
771,227,7.32944228274968,7.69162995594714,998,7.41182364729459
758,240,7.29419525065963,7.65833333333333,998,7.38176352705411
769,230,7.24837451235371,7.58695652173913,999,7.32632632632633
773,226,7.28072445019405,7.60176991150442,999,7.35335335335335
771,228,7.31906614785992,7.52631578947368,999,7.36636636636637
775,222,7.32516129032258,7.5990990990991,997,7.38615847542628
772,226,7.31217616580311,7.57079646017699,998,7.37074148296593
775,224,7.34967741935484,7.625,999,7.41141141141141
771,227,7.39818417639429,7.59471365638767,998,7.44288577154309
769,230,7.37321196358908,7.60434782608696,999,7.42642642642643
770,229,7.36883116883117,7.62882096069869,999,7.42842842842843
767,231,7.35723598435463,7.64502164502164,998,7.42384769539078
780,219,7.37820512820513,7.62100456621005,999,7.43143143143143
774,224,7.4031007751938,7.66517857142857,998,7.46192384769539
769,230,7.41612483745124,7.62173913043478,999,7.46346346346346
765,233,7.4483660130719,7.62660944206009,998,7.48997995991984
770,228,7.4051948051948,7.60964912280702,998,7.45190380761523
771,228,7.43060959792477,7.57456140350877,999,7.46346346346346
766,229,7.43211488250653,7.59825327510917,995,7.47035175879397
768,230,7.42578125,7.51739130434783,998,7.44689378757515
782,216,7.41687979539642,7.56018518518519,998,7.44789579158317
780,219,7.42051282051282,7.52054794520548,999,7.44244244244244
786,211,7.41348600508906,7.56872037914692,997,7.44633901705115
787,212,7.42312579415502,7.59433962264151,999,7.45945945945946
786,211,7.40458015267176,7.59715639810427,997,7.44533600802407
784,215,7.39923469387755,7.6,999,7.44244244244244
790,208,7.40759493670886,7.55288461538461,998,7.43787575150301
793,206,7.3858764186633,7.55339805825243,999,7.42042042042042
789,210,7.38656527249683,7.56190476190476,999,7.42342342342342
802,196,7.35286783042394,7.67857142857143,998,7.41683366733467
797,201,7.37390213299875,7.72139303482587,998,7.4438877755511
795,203,7.35345911949686,7.69458128078818,998,7.42284569138277
791,206,7.34639696586599,7.71844660194175,997,7.42326980942828
793,205,7.35435056746532,7.74634146341463,998,7.43486973947896
795,204,7.38616352201258,7.76470588235294,999,7.46346346346346
791,208,7.41466498103666,7.72596153846154,999,7.47947947947948
784,212,7.4030612244898,7.76415094339623,996,7.47991967871486
789,209,7.35614702154626,7.73205741626794,998,7.43486973947896
790,207,7.32911392405063,7.67632850241546,997,7.4012036108325
798,199,7.34586466165414,7.62311557788945,997,7.4012036108325
792,207,7.31186868686869,7.59903381642512,999,7.37137137137137
799,199,7.33291614518148,7.56281407035176,998,7.37875751503006
795,204,7.32704402515723,7.57352941176471,999,7.37737737737738
787,212,7.32655654383736,7.59905660377358,999,7.38438438438438
782,217,7.35677749360614,7.59447004608295,999,7.40840840840841
782,217,7.3695652173913,7.5852534562212,999,7.41641641641642
780,219,7.38974358974359,7.59360730593607,999,7.43443443443443
777,222,7.38223938223938,7.51801801801802,999,7.41241241241241
779,219,7.3992297817715,7.54794520547945,998,7.43186372745491
773,225,7.39068564036222,7.51555555555556,998,7.4188376753507
772,227,7.40025906735751,7.48898678414097,999,7.42042042042042
774,223,7.42377260981912,7.44394618834081,997,7.42828485456369
770,229,7.41428571428571,7.41048034934498,999,7.41341341341341
777,221,7.40540540540541,7.36651583710407,998,7.39679358717435
780,219,7.40512820512821,7.42009132420091,999,7.40840840840841
777,219,7.41441441441441,7.53424657534247,996,7.44076305220884
774,225,7.42635658914729,7.59111111111111,999,7.46346346346346
784,213,7.39413265306122,7.53521126760563,997,7.42427281845537
780,218,7.43846153846154,7.55504587155963,998,7.46392785571142
774,224,7.45478036175711,7.56696428571429,998,7.47995991983968
771,226,7.43450064850843,7.60619469026549,997,7.47342026078235
776,223,7.43041237113402,7.61434977578475,999,7.47147147147147
778,221,7.40874035989717,7.5972850678733,999,7.45045045045045
777,220,7.39382239382239,7.65,997,7.45035105315948
776,222,7.37628865979381,7.59459459459459,998,7.4248496993988
778,221,7.39074550128535,7.60633484162896,999,7.43843843843844
778,220,7.38431876606684,7.63636363636364,998,7.43987975951904
773,226,7.3777490297542,7.64159292035398,999,7.43743743743744
776,222,7.39948453608247,7.7027027027027,998,7.46693386773547
777,222,7.3989703989704,7.66666666666667,999,7.45845845845846
779,220,7.40693196405648,7.62727272727273,999,7.45545545545546
779,218,7.4403080872914,7.68348623853211,997,7.49348044132397
774,223,7.42894056847545,7.75336322869955,997,7.50150451354062
767,232,7.42112125162973,7.77586206896552,999,7.5035035035035
770,229,7.38961038961039,7.7117903930131,999,7.46346346346346
779,220,7.41976893453145,7.77727272727273,999,7.4984984984985
773,226,7.41526520051746,7.76548672566372,999,7.49449449449449
767,232,7.42372881355932,7.68965517241379,999,7.48548548548549
773,226,7.4346701164295,7.64601769911504,999,7.48248248248248
775,224,7.44774193548387,7.60714285714286,999,7.48348348348348
758,241,7.48548812664908,7.62240663900415,999,7.51851851851852
761,238,7.48357424441524,7.57142857142857,999,7.5045045045045
769,229,7.49934980494148,7.51528384279476,998,7.50300601202405
770,229,7.49480519480519,7.47598253275109,999,7.49049049049049
767,230,7.48761408083442,7.51304347826087,997,7.49348044132397
771,228,7.50583657587549,7.50877192982456,999,7.50650650650651
