forward_num,reverse_num,forward_rate,reverse_rate,organism_num,organism_rate
5,5,5.0,5.0,10,5.0
5,5,5.0,5.0,10,5.0
5,5,5.0,5.0,10,5.0
6,6,5.16666666666667,5.16666666666667,12,5.16666666666667
7,7,5.42857142857143,5.42857142857143,14,5.42857142857143
8,8,5.25,5.5,16,5.375
10,10,5.5,5.5,20,5.5
13,14,5.61538461538461,5.64285714285714,27,5.62962962962963
13,15,5.61538461538461,5.6,28,5.60714285714286
17,19,5.94117647058824,5.78947368421053,36,5.86111111111111
22,23,5.95454545454545,5.95652173913043,45,5.95555555555556
25,25,5.88,5.88,50,5.88
33,36,6.09090909090909,6.13888888888889,69,6.11594202898551
38,41,6.21052631578947,6.14634146341463,79,6.17721518987342
47,48,6.27659574468085,6.08333333333333,95,6.17894736842105
62,64,6.30645161290323,6.453125,126,6.38095238095238
79,77,6.35443037974684,6.36363636363636,156,6.35897435897436
93,94,6.49462365591398,6.57446808510638,187,6.53475935828877
117,120,6.67521367521368,6.60833333333333,237,6.64135021097046
147,150,6.69387755102041,6.73333333333333,297,6.71380471380471
183,192,6.77595628415301,6.88541666666667,375,6.832
236,236,6.8135593220339,6.94915254237288,472,6.88135593220339
291,304,6.89003436426117,7.13486842105263,595,7.01512605042017
377,382,6.97612732095491,7.18062827225131,759,7.07905138339921
479,497,7.02505219206681,7.27766599597586,976,7.15368852459016
503,496,7.09542743538767,7.30443548387097,999,7.1991991991992
499,499,7.07214428857715,7.28657314629258,998,7.17935871743487
498,500,7.11244979919679,7.23,998,7.17134268537074
495,503,7.09292929292929,7.18687872763419,998,7.14028056112224
497,502,7.12474849094567,7.18127490039841,999,7.15315315315315
494,505,7.09109311740891,7.14257425742574,999,7.11711711711712
492,506,7.09756097560976,7.16600790513834,998,7.13226452905812
501,498,7.07385229540918,7.16265060240964,999,7.11811811811812
504,495,7.09126984126984,7.16161616161616,999,7.12612612612613
506,491,7.08102766798419,7.17718940936864,997,7.1283851554664
519,480,7.05780346820809,7.17708333333333,999,7.11511511511512
511,486,7.00587084148728,7.17489711934156,997,7.08826479438315
505,494,7.03564356435644,7.19028340080972,999,7.11211211211211
504,494,7.0734126984127,7.16194331983806,998,7.11723446893788
511,486,7.05479452054795,7.15432098765432,997,7.10330992978937
499,500,7.06613226452906,7.194,999,7.13013013013013
500,499,7.05,7.18036072144289,999,7.11511511511512
508,491,7.05905511811024,7.21588594704684,999,7.13613613613614
513,485,7.04873294346979,7.18762886597938,998,7.11623246492986
507,490,7.02564102564103,7.19183673469388,997,7.10732196589769
506,491,7.06126482213439,7.17311608961303,997,7.11634904714142
509,490,7.06090373280943,7.16734693877551,999,7.11311311311311
513,485,7.07992202729045,7.19175257731959,998,7.13426853707415
520,477,7.07884615384615,7.19916142557652,997,7.13640922768305
523,475,7.10707456978967,7.21684210526316,998,7.15931863727455
522,476,7.09386973180077,7.2563025210084,998,7.17134268537074
521,478,7.10364683301344,7.23430962343096,999,7.16616616616617
516,480,7.11240310077519,7.24166666666667,996,7.17469879518072
518,481,7.07915057915058,7.25571725571726,999,7.16416416416416
524,475,7.10114503816794,7.25263157894737,999,7.17317317317317
529,467,7.10586011342155,7.26980728051392,996,7.18273092369478
535,464,7.09719626168224,7.26939655172414,999,7.17717717717718
540,459,7.07777777777778,7.2723311546841,999,7.16716716716717
532,465,7.03571428571429,7.26451612903226,997,7.14242728184554
538,460,7.03345724907063,7.26304347826087,998,7.13927855711423
543,456,7.04972375690608,7.23684210526316,999,7.13513513513514
539,459,7.06864564007421,7.25708061002179,998,7.15531062124249
530,469,7.07924528301887,7.23240938166311,999,7.15115115115115
542,457,7.03136531365314,7.19037199124726,999,7.1041041041041
545,454,7.02752293577982,7.25550660792952,999,7.13113113113113
545,454,7.03853211009174,7.23127753303965,999,7.12612612612613
550,449,7.00363636363636,7.23162583518931,999,7.10610610610611
543,453,6.99815837937385,7.2075055187638,996,7.0933734939759
539,458,7.01669758812616,7.20087336244541,997,7.10130391173521
532,467,6.9812030075188,7.18201284796574,999,7.07507507507508
530,469,7.04528301886792,7.18976545842217,999,7.11311311311311
524,474,7.04198473282443,7.21097046413502,998,7.12224448897796
519,479,7.03660886319846,7.20250521920668,998,7.11623246492986
533,466,7.04502814258912,7.22532188841202,999,7.12912912912913
530,468,7.04150943396226,7.24786324786325,998,7.13827655310621
534,465,6.97378277153558,7.26021505376344,999,7.10710710710711
533,466,7.0093808630394,7.33047210300429,999,7.15915915915916
547,450,7.0073126142596,7.33555555555556,997,7.15546639919759
548,451,7.02007299270073,7.31042128603104,999,7.15115115115115
555,444,7.03063063063063,7.3018018018018,999,7.15115115115115
561,437,7.03921568627451,7.35011441647597,998,7.17535070140281
568,430,7.0387323943662,7.3906976744186,998,7.19038076152305
568,430,7.09154929577465,7.35581395348837,998,7.20541082164329
578,420,7.09688581314879,7.3547619047619,998,7.20541082164329
582,417,7.09965635738832,7.38369304556355,999,7.21821821821822
579,419,7.04835924006908,7.33890214797136,998,7.17034068136273
576,422,7.046875,7.33175355450237,998,7.16733466933868
575,423,7.02782608695652,7.34042553191489,998,7.16032064128257
579,420,7.02417962003454,7.31428571428571,999,7.14614614614615
566,433,7.04770318021201,7.29792147806005,999,7.15615615615616
561,437,7.05882352941176,7.32951945080092,998,7.17735470941884
562,437,7.04804270462633,7.32494279176201,999,7.16916916916917
561,438,7.08377896613191,7.31506849315068,999,7.18518518518519
556,443,7.11510791366906,7.32731376975169,999,7.20920920920921
548,451,7.14051094890511,7.3370288248337,999,7.22922922922923
547,452,7.13528336380256,7.36283185840708,999,7.23823823823824
551,448,7.17059891107078,7.33258928571429,999,7.24324324324324
552,447,7.14673913043478,7.32662192393736,999,7.22722722722723
552,447,7.15036231884058,7.33780760626398,999,7.23423423423423
553,446,7.14104882459313,7.35201793721973,999,7.23523523523524
560,438,7.14464285714286,7.31506849315068,998,7.21943887775551
555,444,7.16576576576577,7.3536036036036,999,7.24924924924925
560,439,7.18571428571429,7.30296127562642,999,7.23723723723724
557,440,7.19748653500898,7.32727272727273,997,7.25476429287864
556,442,7.19064748201439,7.33257918552036,998,7.25350701402806
555,443,7.1963963963964,7.39503386004515,998,7.28456913827655
553,445,7.18625678119349,7.44269662921348,998,7.30060120240481
557,442,7.21184919210054,7.42986425339367,999,7.30830830830831
540,459,7.20555555555556,7.4161220043573,999,7.3023023023023
545,453,7.19816513761468,7.3598233995585,998,7.27154308617235
554,443,7.21480144404332,7.35440180586907,997,7.27683049147442
548,450,7.2007299270073,7.27777777777778,998,7.23547094188377
526,472,7.23003802281369,7.29025423728814,998,7.25851703406814
528,471,7.20833333333333,7.31422505307856,999,7.25825825825826
529,470,7.18525519848771,7.31914893617021,999,7.24824824824825
522,474,7.20306513409962,7.28481012658228,996,7.24196787148594
528,471,7.17424242424242,7.25053078556263,999,7.21021021021021
533,466,7.17260787992495,7.25321888412017,999,7.21021021021021
541,458,7.18853974121996,7.20524017467249,999,7.1961961961962
539,460,7.19294990723562,7.17826086956522,999,7.18618618618619
532,467,7.21428571428571,7.14561027837259,999,7.18218218218218
537,462,7.25512104283054,7.16450216450216,999,7.21321321321321
535,462,7.28411214953271,7.13852813852814,997,7.21664994984955
533,465,7.28142589118199,7.19784946236559,998,7.24248496993988
525,474,7.33904761904762,7.24050632911392,999,7.29229229229229
512,486,7.259765625,7.23251028806584,998,7.24649298597194
508,491,7.24803149606299,7.23014256619145,999,7.23923923923924
508,491,7.26181102362205,7.23014256619145,999,7.24624624624625
510,489,7.26666666666667,7.23517382413088,999,7.25125125125125
514,485,7.27431906614786,7.23092783505155,999,7.25325325325325
523,475,7.31357552581262,7.22736842105263,998,7.27254509018036
509,490,7.30844793713163,7.17959183673469,999,7.24524524524525
508,486,7.34448818897638,7.15843621399177,994,7.25352112676056
515,484,7.29320388349515,7.18388429752066,999,7.24024024024024
513,485,7.27680311890838,7.21855670103093,998,7.24849699398798
517,482,7.29013539651837,7.22199170124481,999,7.25725725725726
512,487,7.27734375,7.16427104722793,999,7.22222222222222
518,480,7.23552123552124,7.16041666666667,998,7.19939879759519
528,471,7.30681818181818,7.17409766454352,999,7.24424424424424
521,478,7.31285988483685,7.14644351464435,999,7.23323323323323
523,471,7.34225621414914,7.13588110403397,994,7.24446680080483
531,466,7.32580037664783,7.12017167381974,997,7.2296890672016
525,474,7.32380952380952,7.12869198312236,999,7.23123123123123
524,475,7.31870229007634,7.13473684210526,999,7.23123123123123
527,471,7.29601518026565,7.18259023354565,998,7.24248496993988
538,461,7.27695167286245,7.18004338394794,999,7.23223223223223
533,466,7.25328330206379,7.16309012875536,999,7.21121121121121
539,459,7.21706864564007,7.17647058823529,998,7.19839679358717
542,456,7.26568265682657,7.16666666666667,998,7.22044088176353
525,474,7.26857142857143,7.16455696202532,999,7.21921921921922
529,470,7.25897920604915,7.19574468085106,999,7.22922922922923
524,475,7.27290076335878,7.22315789473684,999,7.24924924924925
533,463,7.25140712945591,7.18790496760259,996,7.2218875502008
534,465,7.23595505617978,7.15268817204301,999,7.1971971971972
521,477,7.19385796545106,7.12368972746331,998,7.16032064128257
528,471,7.25,7.15286624203822,999,7.2042042042042
539,460,7.20408163265306,7.11304347826087,999,7.16216216216216
537,460,7.19739292364991,7.07608695652174,997,7.14142427281846
539,460,7.21892393320965,7.12391304347826,999,7.17517517517518
536,463,7.25932835820895,7.16414686825054,999,7.21521521521522
537,460,7.26070763500931,7.20217391304348,997,7.23370110330993
543,456,7.27992633517495,7.23026315789474,999,7.25725725725726
545,453,7.31559633027523,7.21854304635762,998,7.27154308617235
546,453,7.30769230769231,7.22295805739514,999,7.26926926926927
547,451,7.26691042047532,7.23059866962306,998,7.25050100200401
546,453,7.24725274725275,7.2317880794702,999,7.24024024024024
545,453,7.22935779816514,7.22958057395144,998,7.22945891783567
548,451,7.20255474452555,7.23946784922395,999,7.21921921921922
550,448,7.23454545454545,7.27008928571429,998,7.25050100200401
531,468,7.24105461393597,7.2457264957265,999,7.24324324324324
538,461,7.23048327137546,7.17570498915401,999,7.20520520520521
530,468,7.22641509433962,7.22008547008547,998,7.22344689378758
525,473,7.26857142857143,7.21353065539112,998,7.24248496993988
536,463,7.27985074626866,7.18790496760259,999,7.23723723723724
542,456,7.26383763837638,7.16447368421053,998,7.2184368737475
547,450,7.20475319926874,7.15555555555556,997,7.18254764292879
535,462,7.23364485981308,7.11471861471861,997,7.17853560682046
541,458,7.21072088724584,7.1528384279476,999,7.18418418418418
547,452,7.23583180987203,7.1570796460177,999,7.2002002002002
540,457,7.24259259259259,7.15098468271335,997,7.20060180541625
541,457,7.26617375231054,7.15754923413567,998,7.21643286573146
536,460,7.25373134328358,7.14347826086957,996,7.20281124497992
531,468,7.22222222222222,7.17094017094017,999,7.1981981981982
521,476,7.18426103646833,7.12605042016807,997,7.15646940822467
524,475,7.1736641221374,7.13684210526316,999,7.15615615615616
518,481,7.21235521235521,7.11850311850312,999,7.16716716716717
516,483,7.20542635658915,7.10766045548654,999,7.15815815815816
507,491,7.24457593688363,7.15478615071283,998,7.20040080160321
514,484,7.20622568093385,7.14462809917355,998,7.17635270541082
510,488,7.12156862745098,7.15983606557377,998,7.14028056112224
508,489,7.15354330708661,7.13292433537832,997,7.14343029087262
507,492,7.22090729783037,7.17682926829268,999,7.1991991991992
518,479,7.21428571428571,7.09812108559499,997,7.15847542627884
512,487,7.255859375,7.13552361396304,999,7.1971971971972
523,474,7.31357552581262,7.17510548523207,997,7.24774322968907
518,481,7.3011583011583,7.13513513513514,999,7.22122122122122
522,477,7.34099616858238,7.10901467505241,999,7.23023023023023
523,475,7.35181644359465,7.15789473684211,998,7.25951903807615
528,470,7.38068181818182,7.1531914893617,998,7.27354709418838
522,477,7.39655172413793,7.12159329140461,999,7.26526526526527
529,469,7.34404536862004,7.12366737739872,998,7.24048096192385
531,466,7.35969868173258,7.15021459227468,997,7.2617853560682
524,474,7.39885496183206,7.16244725738397,998,7.28657314629258
528,470,7.38825757575758,7.16382978723404,998,7.28256513026052
532,467,7.3796992481203,7.17773019271949,999,7.28528528528529
533,466,7.42213883677298,7.17381974248927,999,7.30630630630631
531,467,7.40866290018832,7.17773019271949,998,7.30060120240481
531,466,7.40866290018832,7.20171673819743,997,7.31193580742227
531,467,7.37853107344633,7.21199143468951,998,7.30060120240481
536,462,7.35074626865672,7.24242424242424,998,7.30060120240481
539,460,7.37291280148423,7.26739130434783,999,7.32432432432432
544,455,7.36397058823529,7.29450549450549,999,7.33233233233233
540,459,7.39444444444444,7.27886710239651,999,7.34134134134134
544,454,7.35477941176471,7.29955947136564,998,7.32965931863727
532,466,7.34962406015038,7.28111587982833,998,7.31763527054108
530,467,7.32075471698113,7.25695931477516,997,7.29087261785356
526,471,7.27946768060836,7.26539278131635,997,7.2728184553661
529,470,7.28922495274102,7.32127659574468,999,7.3043043043043
532,466,7.2687969924812,7.34334763948498,998,7.30360721442886
530,469,7.2811320754717,7.3134328358209,999,7.2962962962963
546,451,7.26556776556777,7.30820399113082,997,7.28485456369107
547,451,7.29250457038391,7.34811529933481,998,7.31763527054108
546,452,7.28021978021978,7.33407079646018,998,7.30460921843687
551,448,7.29038112522686,7.31473214285714,999,7.3013013013013
550,448,7.28545454545455,7.31696428571429,998,7.29959919839679
553,446,7.32368896925859,7.28923766816143,999,7.30830830830831
551,446,7.33212341197822,7.27130044843049,997,7.3049147442327
555,443,7.32792792792793,7.28668171557562,998,7.30961923847695
546,451,7.33699633699634,7.24833702882483,997,7.29689067201605
550,449,7.34,7.27839643652561,999,7.31231231231231
558,441,7.26702508960573,7.27891156462585,999,7.27227227227227
549,449,7.26411657559199,7.26280623608018,998,7.26352705410822
555,444,7.24684684684685,7.26126126126126,999,7.25325325325325
545,453,7.21284403669725,7.26269315673289,998,7.23547094188377
546,452,7.22161172161172,7.29203539823009,998,7.25350701402806
538,460,7.2639405204461,7.28478260869565,998,7.27354709418838
535,463,7.22990654205607,7.31533477321814,998,7.26953907815631
524,475,7.20992366412214,7.35789473684211,999,7.28028028028028
530,469,7.2377358490566,7.43710021321962,999,7.33133133133133
533,466,7.25140712945591,7.39699570815451,999,7.31931931931932
527,472,7.26375711574953,7.39194915254237,999,7.32432432432432
525,473,7.28571428571429,7.40803382663848,998,7.3436873747495
526,473,7.2680608365019,7.44186046511628,999,7.35035035035035
523,475,7.30401529636711,7.43789473684211,998,7.36773547094188
526,473,7.32699619771863,7.43551797040169,999,7.37837837837838
518,480,7.36679536679537,7.4125,998,7.38877755511022
522,477,7.39272030651341,7.41719077568134,999,7.4044044044044
525,473,7.35428571428571,7.42706131078224,998,7.38877755511022
520,479,7.35192307692308,7.42171189979123,999,7.38538538538539
527,471,7.35863377609108,7.40976645435244,998,7.38276553106212
528,469,7.35795454545455,7.46695095948827,997,7.40922768304915
521,478,7.3320537428023,7.44142259414226,999,7.38438438438438
522,477,7.30651340996169,7.48008385744235,999,7.38938938938939
514,485,7.25291828793774,7.47010309278351,999,7.35835835835836
510,488,7.22745098039216,7.46516393442623,998,7.3436873747495
513,485,7.2729044834308,7.49072164948454,998,7.37875751503006
510,488,7.24313725490196,7.49180327868852,998,7.36472945891784
508,491,7.21456692913386,7.5050916496945,999,7.35735735735736
510,489,7.15098039215686,7.53374233128834,999,7.33833833833834
509,490,7.18074656188605,7.54285714285714,999,7.35835835835836
510,489,7.20980392156863,7.49693251533742,999,7.35035035035035
515,484,7.19417475728155,7.51239669421488,999,7.34834834834835
512,487,7.22265625,7.53182751540041,999,7.37337337337337
514,485,7.28793774319066,7.56288659793814,999,7.42142142142142
516,483,7.28294573643411,7.49896480331263,999,7.38738738738739
508,491,7.2755905511811,7.5152749490835,999,7.39339339339339
510,488,7.28627450980392,7.49385245901639,998,7.3877755511022
511,486,7.28375733855186,7.51234567901235,997,7.39518555667001
505,494,7.28712871287129,7.50202429149798,999,7.39339339339339
510,489,7.31372549019608,7.49693251533742,999,7.4034034034034
513,486,7.35087719298246,7.45884773662551,999,7.4034034034034
515,484,7.35922330097087,7.42148760330578,999,7.38938938938939
512,487,7.349609375,7.46201232032854,999,7.4044044044044
505,494,7.34455445544554,7.45546558704453,999,7.3993993993994
506,493,7.32411067193676,7.41987829614604,999,7.37137137137137
505,494,7.32079207920792,7.45141700404858,999,7.38538538538539
505,494,7.31089108910891,7.39878542510121,999,7.35435435435435
510,489,7.30392156862745,7.41104294478528,999,7.35635635635636
510,489,7.33137254901961,7.44989775051125,999,7.38938938938939
510,488,7.30196078431373,7.51844262295082,998,7.40781563126253
512,485,7.291015625,7.4659793814433,997,7.37612838515547
511,488,7.3600782778865,7.46516393442623,999,7.41141141141141
513,486,7.32943469785575,7.46502057613169,999,7.3953953953954
518,481,7.33011583011583,7.42827442827443,999,7.37737737737738
514,483,7.30544747081712,7.37888198757764,997,7.34102306920762
521,478,7.32245681381958,7.39958158995816,999,7.35935935935936
532,467,7.33082706766917,7.40042826552463,999,7.36336336336336
527,470,7.33776091081594,7.38936170212766,997,7.36208625877633
527,472,7.35863377609108,7.46186440677966,999,7.40740740740741
524,475,7.36259541984733,7.51368421052632,999,7.43443443443443
521,478,7.38003838771593,7.4979079497908,999,7.43643643643644
524,475,7.41221374045802,7.52631578947368,999,7.46646646646647
524,473,7.43893129770992,7.54334038054968,997,7.48846539618857
525,473,7.45142857142857,7.58350951374207,998,7.51402805611222
535,463,7.44859813084112,7.52699784017279,998,7.48496993987976
536,462,7.44216417910448,7.51731601731602,998,7.47695390781563
538,460,7.35873605947955,7.5195652173913,998,7.43286573146293
524,475,7.34732824427481,7.53894736842105,999,7.43843843843844
532,466,7.34774436090226,7.45708154506438,998,7.39879759519038
534,463,7.32397003745318,7.40172786177106,997,7.36008024072217
528,470,7.37689393939394,7.42765957446808,998,7.40080160320641
535,463,7.39439252336449,7.44060475161987,998,7.41583166332665
532,464,7.31203007518797,7.38577586206897,996,7.34638554216868
528,471,7.33143939393939,7.38853503184713,999,7.35835835835836
529,467,7.32703213610586,7.38115631691649,996,7.35240963855422
528,471,7.31818181818182,7.36730360934183,999,7.34134134134134
538,461,7.38104089219331,7.40130151843818,999,7.39039039039039
543,455,7.32780847145488,7.4,998,7.36072144288577
551,448,7.29219600725953,7.41741071428571,999,7.34834834834835
547,452,7.29616087751371,7.44469026548673,999,7.36336336336336
543,455,7.27992633517495,7.4,998,7.33466933867735
539,458,7.2987012987013,7.4235807860262,997,7.35606820461384
541,456,7.24953789279113,7.43859649122807,997,7.33600802407222
537,462,7.24767225325885,7.49350649350649,999,7.36136136136136
535,463,7.26168224299065,7.47732181425486,998,7.36172344689379
532,467,7.29135338345865,7.4475374732334,999,7.36436436436436
539,460,7.28571428571429,7.5,999,7.38438438438438
538,461,7.26951672862454,7.53145336225597,999,7.39039039039039
531,464,7.28813559322034,7.51939655172414,995,7.39597989949749
538,460,7.30669144981413,7.46521739130435,998,7.37975951903808
529,469,7.27410207939509,7.51172707889126,998,7.38577154308617
532,466,7.25,7.51931330472103,998,7.37575150300601
530,469,7.23207547169811,7.46695095948827,999,7.34234234234234
528,470,7.22537878787879,7.46808510638298,998,7.33967935871743
525,473,7.23047619047619,7.48625792811839,998,7.35170340681363
515,484,7.19417475728155,7.54132231404959,999,7.36236236236236
513,485,7.18323586744639,7.55463917525773,998,7.36372745490982
519,477,7.16184971098266,7.52830188679245,996,7.33734939759036
512,485,7.146484375,7.52989690721649,997,7.33299899699097
526,470,7.17300380228137,7.57234042553192,996,7.36144578313253
523,475,7.13575525812619,7.59578947368421,998,7.35470941883768
518,481,7.14864864864865,7.61330561330561,999,7.37237237237237
516,483,7.19767441860465,7.57971014492754,999,7.38238238238238
507,491,7.22287968441815,7.58452138492872,998,7.40080160320641
506,491,7.23517786561265,7.57230142566191,997,7.4012036108325
502,497,7.23705179282869,7.60362173038229,999,7.41941941941942
502,497,7.25099601593625,7.6056338028169,999,7.42742742742743
508,489,7.22047244094488,7.60327198364008,997,7.40822467402207
512,486,7.259765625,7.61316872427984,998,7.43186372745491
515,483,7.24854368932039,7.6128364389234,998,7.4248496993988
520,479,7.23653846153846,7.65970772442589,999,7.43943943943944
523,474,7.21797323135755,7.67088607594937,997,7.4332998996991
517,480,7.15667311411992,7.66666666666667,997,7.40220661985958
533,465,7.10881801125704,7.6494623655914,998,7.36072144288577
531,466,7.12617702448211,7.67811158798283,997,7.38415245737212
538,461,7.09665427509294,7.6529284164859,999,7.35335335335335
530,469,7.11698113207547,7.61620469083156,999,7.35135135135135
535,464,7.1588785046729,7.62931034482759,999,7.37737737737738
531,468,7.21845574387947,7.64102564102564,999,7.41641641641642
531,468,7.20715630885122,7.65598290598291,999,7.41741741741742
536,462,7.19962686567164,7.64502164502164,998,7.40581162324649
538,459,7.23048327137546,7.64052287581699,997,7.41925777331996
529,469,7.22117202268431,7.63752665245203,998,7.41683366733467
528,471,7.21212121212121,7.62208067940552,999,7.40540540540541
521,478,7.2168905950096,7.60460251046025,999,7.4024024024024
528,469,7.25568181818182,7.63539445628998,997,7.43430290872618
519,480,7.24470134874759,7.6,999,7.41541541541542
526,473,7.2680608365019,7.54756871035941,999,7.4004004004004
532,467,7.27443609022556,7.58672376873662,999,7.42042042042042
535,464,7.25607476635514,7.53663793103448,999,7.38638638638639
532,466,7.23684210526316,7.50643776824034,998,7.3627254509018
531,468,7.19962335216572,7.48290598290598,999,7.33233233233233
526,472,7.19771863117871,7.46186440677966,998,7.32264529058116
518,481,7.19111969111969,7.45114345114345,999,7.31631631631632
529,470,7.20982986767486,7.44255319148936,999,7.31931931931932
524,475,7.19274809160305,7.41263157894737,999,7.2972972972973
534,464,7.19662921348315,7.41163793103448,998,7.29659318637275
538,460,7.19330855018587,7.40434782608696,998,7.29058116232465
534,464,7.18913857677903,7.44827586206897,998,7.30961923847695
535,463,7.18504672897196,7.48380129589633,998,7.32364729458918
530,468,7.18301886792453,7.47863247863248,998,7.32164328657315
540,457,7.18703703703704,7.46608315098468,997,7.31494483450351
537,462,7.23463687150838,7.46103896103896,999,7.33933933933934
534,464,7.21910112359551,7.41163793103448,998,7.30861723446894
545,454,7.22385321100917,7.40969162995595,999,7.30830830830831
542,457,7.24538745387454,7.42231947483589,999,7.32632632632633
544,455,7.26654411764706,7.48131868131868,999,7.36436436436436
533,466,7.24015009380863,7.41416309012876,999,7.32132132132132
529,470,7.234404536862,7.42553191489362,999,7.32432432432432
531,468,7.19774011299435,7.43803418803419,999,7.31031031031031
526,473,7.20152091254753,7.45665961945032,999,7.32232232232232
529,469,7.19848771266541,7.54371002132196,998,7.36072144288577
534,465,7.22659176029963,7.52258064516129,999,7.36436436436436
532,467,7.2593984962406,7.4796573875803,999,7.36236236236236
530,467,7.25283018867925,7.46252676659529,997,7.35105315947844
528,471,7.22159090909091,7.447983014862,999,7.32832832832833
536,461,7.24067164179105,7.50976138828633,997,7.36509528585757
537,462,7.2364990689013,7.49134199134199,999,7.35435435435435
543,455,7.1804788213628,7.45714285714286,998,7.30661322645291
549,450,7.22040072859745,7.44888888888889,999,7.32332332332332
550,449,7.21818181818182,7.43429844097996,999,7.31531531531532
547,451,7.22669104204753,7.42128603104213,998,7.31462925851703
537,462,7.25698324022346,7.4025974025974,999,7.32432432432432
529,469,7.3648393194707,7.41151385927505,998,7.38677354709419
527,472,7.35294117647059,7.5,999,7.42242242242242
514,484,7.30739299610895,7.49586776859504,998,7.39879759519038
522,477,7.32375478927203,7.48846960167715,999,7.4024024024024
524,475,7.33778625954198,7.54736842105263,999,7.43743743743744
529,469,7.37051039697543,7.46908315565032,998,7.41683366733467
532,467,7.36466165413534,7.51391862955032,999,7.43443443443443
529,470,7.33459357277883,7.48297872340426,999,7.4044044044044
539,459,7.36178107606679,7.46187363834423,998,7.40781563126253
538,460,7.38289962825279,7.47608695652174,998,7.42585170340681
539,457,7.42115027829314,7.46389496717724,996,7.44076305220884
547,452,7.40036563071298,7.49557522123894,999,7.44344344344344
547,451,7.39670932358318,7.47671840354767,998,7.43286573146293
536,462,7.46082089552239,7.51082251082251,998,7.48396793587174
546,452,7.45604395604396,7.51106194690265,998,7.48096192384769
538,458,7.43866171003717,7.51528384279476,996,7.47389558232932
535,463,7.41869158878505,7.48164146868251,998,7.44789579158317
529,470,7.43289224952741,7.46595744680851,999,7.44844844844845
528,471,7.42613636363636,7.48619957537155,999,7.45445445445445
531,468,7.42749529190207,7.50641025641026,999,7.46446446446446
523,473,7.38814531548757,7.4630021141649,996,7.42369477911647
531,466,7.43879472693032,7.49785407725322,997,7.46639919759278
525,474,7.44952380952381,7.55907172995781,999,7.5015015015015
536,463,7.4794776119403,7.57667386609071,999,7.52452452452452
536,461,7.46828358208955,7.52277657266811,997,7.49348044132397
538,460,7.46654275092937,7.55652173913044,998,7.50801603206413
539,460,7.48423005565863,7.4695652173913,999,7.47747747747748
538,460,7.40334572490706,7.49130434782609,998,7.4438877755511
537,461,7.41154562383613,7.5119305856833,998,7.45791583166333
527,471,7.38330170777989,7.53715498938429,998,7.45591182364729
528,470,7.44318181818182,7.47659574468085,998,7.45891783567134
527,472,7.44022770398482,7.50635593220339,999,7.47147147147147
528,471,7.41287878787879,7.5031847133758,999,7.45545545545546
521,477,7.43186180422265,7.46121593291405,998,7.44589178356713
521,478,7.35508637236084,7.46234309623431,999,7.40640640640641
516,482,7.31782945736434,7.48547717842324,998,7.39879759519038
518,481,7.33976833976834,7.4968814968815,999,7.41541541541542
522,476,7.34099616858238,7.41386554621849,998,7.37575150300601
526,472,7.34030418250951,7.41737288135593,998,7.37675350701403
522,475,7.32567049808429,7.40421052631579,997,7.36308926780341
529,470,7.27977315689981,7.4,999,7.33633633633634
533,466,7.30206378986867,7.42703862660944,999,7.36036036036036
534,465,7.34456928838951,7.40215053763441,999,7.37137137137137
533,466,7.36585365853659,7.4206008583691,999,7.39139139139139
537,462,7.32588454376164,7.47186147186147,999,7.39339339339339
537,460,7.3389199255121,7.47608695652174,997,7.40220661985958
546,453,7.35714285714286,7.44812362030905,999,7.3983983983984
547,451,7.3345521023766,7.46784922394678,998,7.39478957915832
549,450,7.30418943533698,7.40222222222222,999,7.34834834834835
560,439,7.30714285714286,7.40091116173121,999,7.34834834834835
559,440,7.3005366726297,7.375,999,7.33333333333333
561,437,7.35115864527629,7.38443935926773,998,7.36573146292585
559,438,7.31842576028623,7.36986301369863,997,7.34102306920762
569,430,7.3286467486819,7.36279069767442,999,7.34334334334334
564,435,7.33510638297872,7.36781609195402,999,7.34934934934935
565,434,7.35575221238938,7.3778801843318,999,7.36536536536537
555,443,7.31711711711712,7.42437923250564,998,7.36472945891784
553,446,7.35623869801085,7.39910313901345,999,7.37537537537538
573,426,7.33682373472949,7.38028169014085,999,7.35535535535536
569,428,7.33743409490334,7.39485981308411,997,7.36208625877633
572,426,7.3479020979021,7.36619718309859,998,7.35571142284569
569,430,7.38664323374341,7.35581395348837,999,7.37337337337337
568,430,7.42253521126761,7.36046511627907,998,7.39579158316633
564,435,7.46631205673759,7.38620689655172,999,7.43143143143143
578,420,7.46020761245675,7.34523809523809,998,7.41182364729459
576,422,7.42881944444444,7.35781990521327,998,7.39879759519038
574,425,7.46515679442509,7.38588235294118,999,7.43143143143143
577,422,7.4419410745234,7.36018957345972,999,7.40740740740741
583,415,7.4631217838765,7.34939759036145,998,7.41583166332665
584,414,7.47945205479452,7.35024154589372,998,7.42585170340681
584,413,7.47945205479452,7.38983050847458,997,7.44232698094283
581,416,7.49569707401033,7.43028846153846,997,7.46840521564694
580,419,7.46034482758621,7.4653937947494,999,7.46246246246246
585,413,7.42905982905983,7.46973365617433,998,7.44589178356713
591,407,7.41116751269035,7.46928746928747,998,7.43486973947896
588,411,7.41156462585034,7.47688564476886,999,7.43843843843844
587,412,7.41396933560477,7.49514563106796,999,7.44744744744745
604,394,7.39569536423841,7.43401015228426,998,7.41082164328657
608,390,7.4375,7.44615384615385,998,7.44088176352705
607,391,7.43163097199341,7.49360613810742,998,7.45591182364729
604,395,7.4387417218543,7.47341772151899,999,7.45245245245245
598,400,7.42809364548495,7.4475,998,7.43587174348697
609,390,7.39901477832512,7.42051282051282,999,7.40740740740741
606,393,7.42409240924092,7.37150127226463,999,7.4034034034034
600,398,7.40833333333333,7.39698492462312,998,7.40380761523046
608,391,7.43256578947368,7.39641943734015,999,7.41841841841842
604,394,7.40397350993377,7.38578680203046,998,7.39679358717435
603,395,7.42620232172471,7.37721518987342,998,7.40681362725451
588,411,7.41666666666667,7.42092457420925,999,7.41841841841842
584,415,7.41095890410959,7.40963855421687,999,7.41041041041041
597,402,7.4572864321608,7.41293532338308,999,7.43943943943944
602,397,7.43521594684385,7.42317380352645,999,7.43043043043043
597,401,7.44053601340033,7.43890274314214,998,7.43987975951904
595,404,7.44705882352941,7.46534653465347,999,7.45445445445445
598,401,7.39799331103679,7.44139650872818,999,7.41541541541542
611,388,7.37152209492635,7.43556701030928,999,7.3963963963964
607,391,7.38714991762768,7.41943734015345,998,7.3997995991984
601,397,7.369384359401,7.42569269521411,998,7.39178356713427
598,401,7.38628762541806,7.46134663341646,999,7.41641641641642
592,407,7.34290540540541,7.43488943488943,999,7.38038038038038
593,406,7.38785834738617,7.43349753694581,999,7.40640640640641
592,407,7.43074324324324,7.42260442260442,999,7.42742742742743
588,411,7.45578231292517,7.43065693430657,999,7.44544544544545
590,409,7.45593220338983,7.44743276283619,999,7.45245245245245
598,401,7.44314381270903,7.39650872817955,999,7.42442442442442
593,406,7.42664418212479,7.40886699507389,999,7.41941941941942
591,407,7.41624365482233,7.3980343980344,998,7.40881763527054
586,410,7.40102389078498,7.40975609756098,996,7.40461847389558
584,412,7.375,7.39320388349515,996,7.38253012048193
587,412,7.36115843270869,7.36165048543689,999,7.36136136136136
583,416,7.36878216123499,7.36298076923077,999,7.36636636636637
587,411,7.39522998296423,7.36739659367397,998,7.38376753507014
587,412,7.37819420783646,7.38834951456311,999,7.38238238238238
585,414,7.36581196581197,7.3719806763285,999,7.36836836836837
587,411,7.41396933560477,7.338199513382,998,7.38276553106212
586,409,7.36348122866894,7.26894865525672,995,7.32462311557789
595,404,7.36638655462185,7.28712871287129,999,7.33433433433433
597,402,7.38525963149079,7.32089552238806,999,7.35935935935936
601,397,7.38435940099834,7.31738035264484,998,7.35771543086172
591,406,7.34856175972927,7.3448275862069,997,7.34704112337011
597,402,7.35510887772194,7.31094527363184,999,7.33733733733734
581,418,7.36833046471601,7.31578947368421,999,7.34634634634635
585,410,7.38803418803419,7.31463414634146,995,7.35778894472362
594,405,7.38888888888889,7.34320987654321,999,7.37037037037037
602,397,7.35049833887043,7.34256926952141,999,7.34734734734735
602,397,7.34883720930233,7.36775818639799,999,7.35635635635636
605,394,7.40165289256198,7.41370558375634,999,7.40640640640641
601,397,7.38435940099834,7.35012594458438,998,7.37074148296593
602,396,7.34717607973422,7.35353535353535,998,7.3496993987976
618,381,7.31391585760518,7.34120734908136,999,7.32432432432432
616,382,7.27922077922078,7.32198952879581,998,7.29559118236473
611,387,7.27986906710311,7.32558139534884,998,7.29759519038076
617,382,7.26742301458671,7.34293193717278,999,7.2962962962963
611,388,7.27823240589198,7.39948453608247,999,7.32532532532533
624,374,7.29647435897436,7.37700534759358,998,7.32665330661323
629,369,7.27344992050874,7.41192411924119,998,7.32464929859719
626,372,7.31948881789137,7.4247311827957,998,7.35871743486974
623,376,7.31781701444623,7.47872340425532,999,7.37837837837838
620,379,7.31774193548387,7.4802110817942,999,7.37937937937938
600,398,7.27166666666667,7.5,998,7.3627254509018
602,397,7.25581395348837,7.48866498740554,999,7.34834834834835
591,407,7.23857868020305,7.40540540540541,998,7.30661322645291
584,414,7.22431506849315,7.3743961352657,998,7.28657314629258
576,423,7.24826388888889,7.39479905437352,999,7.31031031031031
566,432,7.24028268551237,7.41898148148148,998,7.31763527054108
569,430,7.23725834797891,7.45116279069767,999,7.32932932932933
561,437,7.23707664884135,7.45995423340961,998,7.33466933867735
568,431,7.26584507042254,7.45243619489559,999,7.34634634634635
564,435,7.26418439716312,7.40689655172414,999,7.32632632632633
566,433,7.27208480565371,7.42494226327945,999,7.33833833833834
577,422,7.2842287694974,7.43601895734597,999,7.34834834834835
571,427,7.25919439579685,7.41451990632318,998,7.32565130260521
568,431,7.23943661971831,7.40835266821346,999,7.31231231231231
572,427,7.29545454545455,7.37939110070258,999,7.33133133133133
565,432,7.24070796460177,7.38194444444444,997,7.30190571715145
572,427,7.21678321678322,7.40281030444965,999,7.2962962962963
566,433,7.23851590106007,7.39491916859122,999,7.30630630630631
568,431,7.2306338028169,7.4292343387471,999,7.31631631631632
569,428,7.2390158172232,7.42289719626168,997,7.31795386158475
569,429,7.2231985940246,7.42890442890443,998,7.31162324649299
561,436,7.24420677361854,7.38073394495413,997,7.30391173520562
561,438,7.26381461675579,7.43835616438356,999,7.34034034034034
552,447,7.24275362318841,7.4407158836689,999,7.33133133133133
550,449,7.23818181818182,7.48552338530067,999,7.34934934934935
566,432,7.26325088339223,7.49768518518519,998,7.36472945891784
573,425,7.25305410122164,7.50352941176471,998,7.35971943887776
568,431,7.27464788732394,7.50580046403712,999,7.37437437437437
569,428,7.21968365553603,7.46028037383178,997,7.32296890672016
585,413,7.1965811965812,7.48668280871671,998,7.31663326653307
578,420,7.16262975778547,7.42857142857143,998,7.27454909819639
582,416,7.1872852233677,7.47355769230769,998,7.30661322645291
581,418,7.1617900172117,7.49760765550239,999,7.3023023023023
582,417,7.18213058419244,7.46762589928058,999,7.3013013013013
581,418,7.14974182444062,7.48325358851675,999,7.28928928928929
578,421,7.1522491349481,7.49881235154394,999,7.2982982982983
569,430,7.12478031634446,7.47209302325581,999,7.27427427427427
572,426,7.12937062937063,7.50469483568075,998,7.28957915831663
559,439,7.08586762075134,7.48063781321185,998,7.25951903807615
555,443,7.0972972972973,7.50338600451467,998,7.27755511022044
554,445,7.09205776173285,7.47415730337079,999,7.26226226226226
548,450,7.11131386861314,7.51111111111111,998,7.29158316633267
531,467,7.10734463276836,7.51177730192719,998,7.29659318637275
523,476,7.12619502868069,7.47058823529412,999,7.29029029029029
524,474,7.08969465648855,7.45569620253165,998,7.26352705410822
522,474,7.10919540229885,7.4704641350211,996,7.28112449799197
522,475,7.13793103448276,7.47789473684211,997,7.29989969909729
529,469,7.15879017013232,7.50959488272921,998,7.32364729458918
528,471,7.16856060606061,7.4692144373673,999,7.31031031031031
540,458,7.21666666666667,7.47161572052402,998,7.33366733466934
542,455,7.2029520295203,7.47692307692308,997,7.32798395185557
548,451,7.25182481751825,7.49445676274945,999,7.36136136136136
540,458,7.34259259259259,7.47816593886463,998,7.40480961923848
545,451,7.33761467889908,7.45232815964523,996,7.38955823293173
551,448,7.33938294010889,7.421875,999,7.37637637637638
548,450,7.32299270072993,7.45777777777778,998,7.38376753507014
539,458,7.27458256029685,7.44323144104804,997,7.35205616850552
535,464,7.26168224299065,7.47198275862069,999,7.35935935935936
535,464,7.25794392523365,7.50862068965517,999,7.37437437437437
538,461,7.27881040892193,7.47288503253796,999,7.36836836836837
540,458,7.27037037037037,7.53056768558952,998,7.38977955911824
544,455,7.26470588235294,7.51648351648352,999,7.37937937937938
536,462,7.26865671641791,7.51731601731602,998,7.38376753507014
535,464,7.25794392523365,7.51508620689655,999,7.37737737737738
543,456,7.27255985267035,7.58552631578947,999,7.41541541541542
527,471,7.26375711574953,7.57749469214437,998,7.41182364729459
529,470,7.30812854442344,7.58510638297872,999,7.43843843843844
541,458,7.31053604436229,7.58296943231441,999,7.43543543543544
532,467,7.34774436090226,7.56531049250535,999,7.44944944944945
529,468,7.33270321361059,7.54700854700855,997,7.4332998996991
540,459,7.33333333333333,7.57298474945534,999,7.44344344344344
526,473,7.37262357414449,7.57505285412262,999,7.46846846846847
528,471,7.42613636363636,7.56050955414013,999,7.48948948948949
527,472,7.43074003795066,7.52118644067797,999,7.47347347347347
529,470,7.38563327032136,7.51914893617021,999,7.44844844844845
521,477,7.3915547024952,7.50314465408805,998,7.44488977955912
524,474,7.38549618320611,7.49367088607595,998,7.43687374749499
526,472,7.38783269961977,7.46398305084746,998,7.42384769539078
522,476,7.38314176245211,7.48739495798319,998,7.43286573146293
521,478,7.34932821497121,7.50627615062761,999,7.42442442442442
509,486,7.40667976424361,7.48559670781893,995,7.44522613065327
515,483,7.43883495145631,7.45755693581781,998,7.44789579158317
514,485,7.42023346303502,7.44948453608247,999,7.43443443443443
515,484,7.40970873786408,7.46487603305785,999,7.43643643643644
509,490,7.4007858546169,7.45102040816327,999,7.42542542542543
502,495,7.39641434262948,7.45656565656566,997,7.42627883650953
511,486,7.39334637964775,7.45061728395062,997,7.42126379137412
500,499,7.418,7.47294589178357,999,7.44544544544545
496,502,7.45161290322581,7.49203187250996,998,7.47194388777555
498,500,7.46987951807229,7.512,998,7.49098196392786
477,521,7.47379454926625,7.54702495201535,998,7.51202404809619
471,527,7.46709129511677,7.48956356736243,998,7.47895791583166
464,533,7.42025862068965,7.49718574108818,997,7.46138415245737
459,540,7.47930283224401,7.52222222222222,999,7.5025025025025
453,544,7.44370860927152,7.49080882352941,997,7.46940822467402
457,542,7.472647702407,7.47970479704797,999,7.47647647647648
458,540,7.43231441048035,7.51111111111111,998,7.4749498997996
458,541,7.43013100436681,7.46950092421442,999,7.45145145145145
463,536,7.47948164146868,7.45708955223881,999,7.46746746746747
461,538,7.48156182212581,7.4368029739777,999,7.45745745745746
458,541,7.50655021834061,7.47874306839187,999,7.49149149149149
447,552,7.50111856823266,7.45471014492754,999,7.47547547547548
455,542,7.5010989010989,7.4520295202952,997,7.47442326980943
453,546,7.50772626931567,7.41025641025641,999,7.45445445445445
451,547,7.50776053215078,7.42230347349177,998,7.46092184368737
457,542,7.46608315098468,7.38929889298893,999,7.42442442442442
448,550,7.54241071428571,7.35818181818182,998,7.44088176352705
432,567,7.51388888888889,7.39506172839506,999,7.44644644644645
423,576,7.52482269503546,7.40104166666667,999,7.45345345345345
418,580,7.52153110047847,7.41551724137931,998,7.45991983967936
415,584,7.51566265060241,7.3972602739726,999,7.44644644644645
408,590,7.50490196078431,7.38983050847458,998,7.43687374749499
405,593,7.49135802469136,7.39460370994941,998,7.43386773547094
399,600,7.4937343358396,7.37666666666667,999,7.42342342342342
400,598,7.4875,7.34782608695652,998,7.40380761523046
393,606,7.4529262086514,7.35478547854785,999,7.39339339339339
387,610,7.44186046511628,7.35573770491803,997,7.38916750250752
392,607,7.41071428571429,7.35584843492587,999,7.37737737737738
386,613,7.50259067357513,7.35562805872757,999,7.41241241241241
396,603,7.48484848484848,7.33996683250415,999,7.3973973973974
395,604,7.49873417721519,7.33609271523179,999,7.4004004004004
387,612,7.48320413436693,7.33496732026144,999,7.39239239239239
395,604,7.50379746835443,7.35264900662252,999,7.41241241241241
390,608,7.43333333333333,7.34868421052632,998,7.38176352705411
396,603,7.44949494949495,7.32504145936982,999,7.37437437437437
395,604,7.41012658227848,7.31953642384106,999,7.35535535535536
388,610,7.42010309278351,7.29508196721311,998,7.3436873747495
385,612,7.42077922077922,7.29248366013072,997,7.3420260782347
380,619,7.46315789473684,7.26655896607431,999,7.34134134134134
380,619,7.44736842105263,7.25525040387722,999,7.32832832832833
363,636,7.43526170798898,7.24056603773585,999,7.31131131131131
369,629,7.44986449864499,7.2670906200318,998,7.33466933867735
369,629,7.44173441734417,7.30047694753577,998,7.35270541082164
377,622,7.45358090185676,7.32797427652733,999,7.37537537537538
371,628,7.48247978436658,7.34076433121019,999,7.39339339339339
363,636,7.53443526170799,7.35691823899371,999,7.42142142142142
369,630,7.58265582655827,7.37142857142857,999,7.44944944944945
377,622,7.56498673740053,7.38906752411576,999,7.45545545545546
370,628,7.60810810810811,7.42515923566879,998,7.49298597194389
374,625,7.62299465240642,7.4368,999,7.50650650650651
372,625,7.66397849462366,7.3984,997,7.4974924774323
388,610,7.65979381443299,7.44098360655738,998,7.52605210420842
395,603,7.57721518987342,7.42454394693201,998,7.48496993987976
387,612,7.56330749354005,7.42647058823529,999,7.47947947947948
389,609,7.59383033419023,7.39737274220033,998,7.47394789579158
386,610,7.55699481865285,7.39344262295082,996,7.45682730923695
378,620,7.55291005291005,7.34193548387097,998,7.42184368737475
377,622,7.55968169761273,7.35852090032154,999,7.43443443443443
373,624,7.5201072386059,7.35737179487179,997,7.41825476429288
369,628,7.47967479674797,7.35191082802548,997,7.39919759277833
370,629,7.48378378378378,7.33068362480127,999,7.38738738738739
378,621,7.47354497354497,7.34299516908213,999,7.39239239239239
376,623,7.46276595744681,7.31942215088282,999,7.37337337337337
382,616,7.45811518324607,7.33279220779221,998,7.38076152304609
382,617,7.45026178010471,7.3581847649919,999,7.39339339339339
382,615,7.49476439790576,7.38048780487805,997,7.42427281845537
376,622,7.5,7.39871382636656,998,7.43687374749499
381,616,7.49606299212598,7.41396103896104,997,7.44533600802407
389,609,7.51413881748072,7.37766830870279,998,7.43086172344689
390,609,7.48461538461538,7.36288998357964,999,7.41041041041041
389,609,7.48329048843188,7.33825944170772,998,7.39478957915832
393,606,7.56488549618321,7.34488448844884,999,7.43143143143143
398,600,7.5929648241206,7.40333333333333,998,7.47895791583166
390,608,7.58717948717949,7.38322368421053,998,7.46292585170341
387,611,7.61757105943152,7.39770867430442,998,7.48296593186373
387,612,7.70284237726098,7.3937908496732,999,7.51351351351351
379,619,7.73087071240106,7.42164781906301,998,7.53907815631263
381,617,7.75328083989501,7.38573743922204,998,7.52605210420842
385,613,7.6987012987013,7.42088091353997,998,7.52805611222445
394,604,7.73604060913706,7.43708609271523,998,7.55511022044088
391,608,7.70332480818414,7.47368421052632,999,7.56356356356356
392,607,7.75255102040816,7.51894563426689,999,7.61061061061061
387,611,7.71576227390181,7.46317512274959,998,7.56112224448898
391,606,7.68030690537084,7.45379537953795,997,7.54262788365095
398,601,7.68844221105528,7.44758735440932,999,7.54354354354354
401,597,7.70324189526185,7.42881072026801,998,7.53907815631263
406,592,7.70443349753695,7.44932432432432,998,7.55310621242485
404,595,7.68564356435644,7.45882352941176,999,7.55055055055055
408,591,7.67156862745098,7.44670050761421,999,7.53853853853854
412,586,7.66990291262136,7.47098976109215,998,7.55310621242485
415,584,7.72048192771084,7.50342465753425,999,7.59359359359359
415,584,7.73493975903614,7.51883561643836,999,7.60860860860861
411,586,7.77858880778589,7.48805460750853,997,7.60782347041123
424,575,7.76415094339623,7.47130434782609,999,7.5955955955956
428,570,7.80373831775701,7.49298245614035,998,7.62625250501002
425,573,7.78823529411765,7.46945898778359,998,7.60521042084168
434,565,7.7926267281106,7.45132743362832,999,7.5995995995996
448,548,7.765625,7.45620437956204,996,7.59538152610442
446,552,7.78923766816143,7.43659420289855,998,7.59418837675351
462,537,7.76190476190476,7.40223463687151,999,7.56856856856857
460,538,7.78478260869565,7.39219330855019,998,7.57314629258517
460,538,7.8195652173913,7.35873605947955,998,7.57114228456914
469,529,7.79317697228145,7.33270321361059,998,7.54909819639279
464,533,7.73275862068965,7.33020637898687,997,7.51755265797392
462,537,7.74891774891775,7.3147113594041,999,7.51551551551552
458,540,7.74235807860262,7.34259259259259,998,7.52605210420842
462,537,7.74025974025974,7.34823091247672,999,7.52952952952953
460,538,7.72608695652174,7.38847583643123,998,7.54408817635271
458,540,7.67248908296943,7.40185185185185,998,7.52605210420842
454,544,7.68502202643172,7.41360294117647,998,7.53707414829659
439,560,7.6378132118451,7.44642857142857,999,7.53053053053053
442,557,7.5972850678733,7.45421903052065,999,7.51751751751752
434,565,7.59447004608295,7.51858407079646,999,7.55155155155155
437,561,7.53546910755149,7.51515151515152,998,7.52404809619238
434,563,7.48617511520737,7.52220248667851,997,7.50651955867603
441,557,7.46485260770975,7.57630161579892,998,7.52705410821643
437,561,7.49427917620137,7.55793226381462,998,7.53006012024048
443,555,7.53273137697517,7.57297297297297,998,7.55511022044088
441,558,7.53741496598639,7.57168458781362,999,7.55655655655656
443,554,7.48984198645598,7.59205776173285,997,7.54663991975928
445,554,7.43820224719101,7.57581227436823,999,7.51451451451451
438,560,7.44520547945205,7.59285714285714,998,7.52805611222445
439,558,7.49202733485194,7.56810035842294,997,7.5346038114343
443,556,7.46952595936795,7.54496402877698,999,7.51151151151151
451,545,7.49445676274945,7.55779816513761,996,7.52911646586345
458,539,7.48034934497817,7.54916512059369,997,7.51755265797392
450,547,7.45555555555556,7.55393053016453,997,7.50952858575727
455,543,7.52087912087912,7.548802946593,998,7.53607214428858
457,541,7.54485776805252,7.51016635859519,998,7.52605210420842
460,537,7.60217391304348,7.48975791433892,997,7.54162487462387
456,543,7.55263157894737,7.49355432780847,999,7.52052052052052
459,540,7.50762527233115,7.47777777777778,999,7.49149149149149
460,538,7.55,7.47955390334572,998,7.51202404809619
465,534,7.55268817204301,7.46441947565543,999,7.50550550550551
461,537,7.53145336225597,7.44692737430168,998,7.48597194388778
465,534,7.48817204301075,7.4438202247191,999,7.46446446446446
465,533,7.47096774193548,7.47279549718574,998,7.47194388777555
458,541,7.47379912663755,7.46025878003697,999,7.46646646646647
455,544,7.46153846153846,7.48161764705882,999,7.47247247247247
463,534,7.46868250539957,7.45692883895131,997,7.46238716148445
456,543,7.4890350877193,7.44198895027624,999,7.46346346346346
455,543,7.45714285714286,7.43646408839779,998,7.44589178356713
450,548,7.48444444444444,7.45255474452555,998,7.46693386773547
453,545,7.44812362030905,7.44587155963303,998,7.44689378757515
454,544,7.43392070484582,7.40992647058824,998,7.42084168336673
449,548,7.44766146993318,7.43430656934307,997,7.44032096288867
442,556,7.40497737556561,7.42086330935252,998,7.41382765531062
447,551,7.40268456375839,7.41923774954628,998,7.41182364729459
437,560,7.42562929061785,7.41071428571429,997,7.4172517552658
440,559,7.46136363636364,7.40787119856887,999,7.43143143143143
444,554,7.46396396396396,7.36462093862816,998,7.40881763527054
439,560,7.4624145785877,7.38214285714286,999,7.41741741741742
440,558,7.50454545454545,7.37813620071685,998,7.43386773547094
443,556,7.51241534988713,7.44064748201439,999,7.47247247247247
444,555,7.50900900900901,7.45945945945946,999,7.48148148148148
451,548,7.49223946784922,7.45985401459854,999,7.47447447447447
451,548,7.51884700665188,7.48540145985401,999,7.5005005005005
449,550,7.50334075723831,7.52,999,7.51251251251251
456,541,7.49780701754386,7.52495378927911,997,7.51253761283852
452,547,7.50442477876106,7.55758683729433,999,7.53353353353353
449,549,7.51670378619154,7.54098360655738,998,7.53006012024048
458,541,7.52183406113537,7.52495378927911,999,7.52352352352352
457,542,7.52954048140044,7.54612546125461,999,7.53853853853854
453,545,7.54966887417219,7.57247706422018,998,7.56212424849699
458,541,7.4825327510917,7.55637707948244,999,7.52252252252252
466,533,7.43562231759657,7.53470919324578,999,7.48848848848849
450,549,7.44444444444444,7.56466302367942,999,7.51051051051051
458,541,7.41266375545852,7.51571164510166,999,7.46846846846847
456,543,7.375,7.53406998158379,999,7.46146146146146
452,546,7.40044247787611,7.49084249084249,998,7.4498997995992
452,546,7.44690265486726,7.50549450549451,998,7.47895791583166
449,550,7.46102449888641,7.47636363636364,999,7.46946946946947
462,537,7.44805194805195,7.49162011173184,999,7.47147147147147
463,534,7.48812095032397,7.54119850187266,997,7.51654964894684
469,530,7.52452025586354,7.56792452830189,999,7.54754754754755
458,539,7.51310043668122,7.53988868274583,997,7.52758274824473
459,540,7.50108932461874,7.56851851851852,999,7.53753753753754
460,539,7.49347826086957,7.59183673469388,999,7.54654654654655
465,534,7.53978494623656,7.62734082397004,999,7.58658658658659
469,529,7.52452025586354,7.59546313799622,998,7.56212424849699
472,526,7.56991525423729,7.56463878326996,998,7.56713426853707
470,529,7.62340425531915,7.58790170132325,999,7.6046046046046
469,530,7.60980810234542,7.62264150943396,999,7.61661661661662
465,530,7.56774193548387,7.6377358490566,995,7.60502512562814
475,523,7.59789473684211,7.63479923518164,998,7.61723446893788
477,522,7.62473794549266,7.63984674329502,999,7.63263263263263
480,518,7.6375,7.60617760617761,998,7.62124248496994
474,524,7.61814345991561,7.6030534351145,998,7.61022044088176
472,527,7.58474576271186,7.58254269449715,999,7.58358358358358
466,533,7.58369098712446,7.61913696060038,999,7.6026026026026
466,532,7.63090128755365,7.64473684210526,998,7.63827655310621
463,536,7.6695464362851,7.66417910447761,999,7.66666666666667
454,545,7.6431718061674,7.65321100917431,999,7.64864864864865
464,535,7.68534482758621,7.68785046728972,999,7.68668668668669
460,537,7.70434782608696,7.67039106145251,997,7.68605817452357
453,545,7.71081677704194,7.65137614678899,998,7.67835671342685
456,543,7.73026315789474,7.6353591160221,999,7.67867867867868
447,552,7.70246085011186,7.59601449275362,999,7.64364364364364
440,559,7.70454545454545,7.58676207513417,999,7.63863863863864
445,552,7.68539325842697,7.55797101449275,997,7.6148445336008
446,553,7.67713004484305,7.53526220614828,999,7.5985985985986
446,553,7.64125560538117,7.61482820976492,999,7.62662662662663
449,549,7.64587973273942,7.60109289617486,998,7.62124248496994
444,554,7.68468468468468,7.59386281588448,998,7.63426853707415
446,553,7.60538116591928,7.55153707052441,999,7.57557557557558
449,550,7.60801781737194,7.51272727272727,999,7.55555555555556
448,551,7.64285714285714,7.51724137931035,999,7.57357357357357
434,565,7.59907834101382,7.54159292035398,999,7.56656656656657
434,565,7.5668202764977,7.54513274336283,999,7.55455455455455
436,562,7.56880733944954,7.52846975088968,998,7.54609218436874
427,571,7.60655737704918,7.5183887915937,998,7.5561122244489
432,565,7.6087962962963,7.54159292035398,997,7.57071213640923
432,566,7.61342592592593,7.5565371024735,998,7.5811623246493
424,574,7.58490566037736,7.59233449477352,998,7.58917835671343
422,575,7.62085308056872,7.54608695652174,997,7.5777331995988
425,574,7.64,7.58362369337979,999,7.60760760760761
425,572,7.62823529411765,7.56293706293706,997,7.59077231695085
430,568,7.60232558139535,7.56514084507042,998,7.5811623246493
429,570,7.56876456876457,7.56842105263158,999,7.56856856856857
424,574,7.5377358490566,7.55749128919861,998,7.54909819639279
421,577,7.56294536817102,7.51646447140381,998,7.53607214428858
427,572,7.57377049180328,7.55244755244755,999,7.56156156156156
435,563,7.56551724137931,7.53641207815275,998,7.54909819639279
427,572,7.53395784543325,7.54895104895105,999,7.54254254254254
426,571,7.56338028169014,7.55341506129597,997,7.55767301905717
434,565,7.54608294930876,7.52920353982301,999,7.53653653653654
424,574,7.59669811320755,7.51393728222997,998,7.54909819639279
437,561,7.56979405034325,7.51158645276292,998,7.53707414829659
444,555,7.6036036036036,7.47207207207207,999,7.53053053053053
445,554,7.55955056179775,7.45487364620939,999,7.5015015015015
443,554,7.54627539503386,7.48194945848375,997,7.51053159478435
434,565,7.52995391705069,7.50619469026549,999,7.51651651651652
433,566,7.55889145496536,7.46996466431095,999,7.50850850850851
447,552,7.56152125279642,7.47282608695652,999,7.51251251251251
442,557,7.56561085972851,7.46858168761221,999,7.51151151151151
444,555,7.58783783783784,7.46666666666667,999,7.52052052052052
438,560,7.55936073059361,7.45714285714286,998,7.50200400801603
421,578,7.54631828978622,7.43598615916955,999,7.48248248248248
416,583,7.61298076923077,7.43567753001715,999,7.50950950950951
424,573,7.58254716981132,7.41186736474695,997,7.48445336008024
425,574,7.59764705882353,7.47386759581881,999,7.52652652652653
427,571,7.55971896955504,7.49036777583187,998,7.52004008016032
417,582,7.59952038369305,7.47079037800687,999,7.52452452452452
416,581,7.61298076923077,7.46815834767642,997,7.52858575727182
423,576,7.59810874704492,7.48611111111111,999,7.53353353353353
436,562,7.57798165137615,7.53736654804271,998,7.55511022044088
432,566,7.54398148148148,7.49116607773852,998,7.51402805611222
434,565,7.51382488479263,7.50619469026549,999,7.50950950950951
434,564,7.49539170506912,7.48404255319149,998,7.48897795591182
440,559,7.45227272727273,7.46332737030411,999,7.45845845845846
434,564,7.43548387096774,7.42198581560284,998,7.42785571142285
433,565,7.41801385681293,7.45663716814159,998,7.43987975951904
441,556,7.46485260770975,7.46942446043165,997,7.46740220661986
444,555,7.48423423423423,7.48828828828829,999,7.48648648648649
439,559,7.51936218678815,7.45974955277281,998,7.48597194388778
447,552,7.50335570469799,7.45471014492754,999,7.47647647647648
444,554,7.46396396396396,7.46389891696751,998,7.46392785571142
442,555,7.4841628959276,7.47027027027027,997,7.47642928786359
437,562,7.47826086956522,7.5,999,7.49049049049049
449,548,7.49220489977728,7.53284671532847,997,7.51454363089268
459,539,7.53376906318083,7.51020408163265,998,7.52104208416834
459,539,7.53159041394335,7.51020408163265,998,7.52004008016032
472,526,7.55508474576271,7.54562737642586,998,7.5501002004008
477,522,7.51153039832285,7.57088122605364,999,7.54254254254254
476,522,7.49579831932773,7.56513409961686,998,7.53206412825651
472,525,7.49364406779661,7.55619047619048,997,7.52657973921765
471,527,7.46709129511677,7.53700189753321,998,7.50400801603206
473,526,7.47991543340381,7.54752851711027,999,7.51551551551552
475,522,7.52421052631579,7.56513409961686,997,7.5456369107322
469,530,7.47334754797441,7.57358490566038,999,7.52652652652653
463,536,7.47516198704104,7.5634328358209,999,7.52252252252252
453,546,7.50993377483444,7.61721611721612,999,7.56856856856857
450,547,7.47555555555556,7.63254113345521,997,7.5616850551655
444,555,7.44369369369369,7.62702702702703,999,7.54554554554555
445,554,7.4247191011236,7.6028880866426,999,7.52352352352352
446,552,7.40807174887892,7.57608695652174,998,7.50100200400802
446,552,7.42600896860987,7.56340579710145,998,7.50200400801603
438,557,7.38127853881279,7.57091561938959,995,7.48743718592965
440,557,7.375,7.56373429084381,997,7.48044132397192
445,554,7.37303370786517,7.59205776173285,999,7.49449449449449
446,552,7.39013452914798,7.53260869565217,998,7.4689378757515
452,547,7.38495575221239,7.53382084095064,999,7.46646646646647
454,544,7.34581497797357,7.53308823529412,998,7.44789579158317
446,552,7.37219730941704,7.52173913043478,998,7.45490981963928
456,542,7.35526315789474,7.52767527675277,998,7.44889779559118
456,541,7.38157894736842,7.52125693160813,997,7.45737211634905
452,547,7.42920353982301,7.51005484460695,999,7.47347347347347
462,537,7.46536796536797,7.46927374301676,999,7.46746746746747
455,544,7.46153846153846,7.46875,999,7.46546546546547
459,537,7.46840958605665,7.487895716946,996,7.4789156626506
453,544,7.49889624724062,7.47794117647059,997,7.48746238716148
456,543,7.4890350877193,7.48618784530387,999,7.48748748748749
456,543,7.47368421052632,7.48618784530387,999,7.48048048048048
458,540,7.45851528384279,7.47407407407407,998,7.46693386773547
456,542,7.47368421052632,7.50922509225092,998,7.49298597194389
449,550,7.43429844097996,7.54181818181818,999,7.49349349349349
448,550,7.45758928571429,7.52909090909091,998,7.49699398797595
441,557,7.44671201814059,7.50987432675045,998,7.48196392785571
449,548,7.39643652561247,7.47262773722628,997,7.4383149448345
464,535,7.41163793103448,7.52336448598131,999,7.47147147147147
455,543,7.37582417582418,7.55064456721915,998,7.47094188376754
471,528,7.33545647558386,7.50378787878788,999,7.42442442442442
466,533,7.4206008583691,7.4859287054409,999,7.45545545545546
467,532,7.43254817987152,7.46240601503759,999,7.44844844844845
463,535,7.45140388768898,7.48598130841121,998,7.46993987975952
456,543,7.42763157894737,7.53406998158379,999,7.48548548548549
463,535,7.42332613390929,7.55700934579439,998,7.49498997995992
463,535,7.414686825054,7.54579439252336,998,7.48496993987976
472,527,7.44491525423729,7.55787476280835,999,7.5045045045045
476,521,7.45378151260504,7.55086372360845,997,7.50451354062187
481,518,7.46985446985447,7.55019305019305,999,7.51151151151151
475,522,7.50736842105263,7.52873563218391,997,7.518555667001
471,526,7.47346072186837,7.52851711026616,997,7.5025075225677
467,530,7.45396145610278,7.5377358490566,997,7.49849548645938
469,530,7.47334754797441,7.46603773584906,999,7.46946946946947
463,536,7.42548596112311,7.47574626865672,999,7.45245245245245
456,543,7.43640350877193,7.46961325966851,999,7.45445445445445
450,546,7.49555555555556,7.43589743589744,996,7.46285140562249
441,558,7.49433106575964,7.49462365591398,999,7.49449449449449
448,551,7.52678571428571,7.47549909255898,999,7.4984984984985
448,551,7.51785714285714,7.43375680580762,999,7.47147147147147
453,546,7.50110375275938,7.49450549450549,999,7.4974974974975
459,540,7.51633986928105,7.51481481481482,999,7.51551551551552
456,542,7.51535087719298,7.52214022140221,998,7.51903807615231
454,544,7.49559471365639,7.50919117647059,998,7.50300601202405
445,551,7.45168539325843,7.51542649727768,996,7.48694779116466
438,561,7.44063926940639,7.54901960784314,999,7.5015015015015
440,557,7.44090909090909,7.53321364452424,997,7.49247743229689
443,555,7.4334085778781,7.53333333333333,998,7.48897795591182
447,551,7.41163310961969,7.52813067150635,998,7.47595190380762
453,546,7.37306843267108,7.54029304029304,999,7.46446446446446
447,552,7.40044742729306,7.52355072463768,999,7.46846846846847
445,553,7.43370786516854,7.5370705244123,998,7.49098196392786
447,549,7.4496644295302,7.57377049180328,996,7.51807228915663
441,558,7.51700680272109,7.57168458781362,999,7.54754754754755
443,554,7.52144469525959,7.57039711191336,997,7.54864593781344
445,553,7.51910112359551,7.58951175406872,998,7.55811623246493
443,555,7.49887133182844,7.61081081081081,998,7.56112224448898
447,551,7.44295302013423,7.59165154264973,998,7.5250501002004
459,537,7.45098039215686,7.5903165735568,996,7.52610441767068
465,532,7.44086021505376,7.58646616541353,997,7.518555667001
453,545,7.439293598234,7.58348623853211,998,7.51803607214429
454,545,7.38986784140969,7.58165137614679,999,7.49449449449449
453,545,7.35761589403973,7.64036697247706,998,7.51202404809619
448,551,7.36160714285714,7.60254083484574,999,7.49449449449449
448,551,7.38616071428571,7.6043557168784,999,7.50650650650651
438,560,7.35844748858448,7.58928571428571,998,7.48797595190381
438,561,7.32876712328767,7.57397504456328,999,7.46646646646647
440,558,7.27954545454545,7.58243727598566,998,7.44889779559118
432,567,7.29166666666667,7.55026455026455,999,7.43843843843844
434,563,7.34562211981567,7.52220248667851,997,7.44533600802407
435,563,7.29655172413793,7.4404973357016,998,7.37775551102204
433,564,7.30254041570439,7.42553191489362,997,7.37211634904714
425,570,7.27058823529412,7.49122807017544,995,7.39698492462312
432,566,7.26157407407407,7.49116607773852,998,7.39178356713427
418,580,7.31818181818182,7.46206896551724,998,7.40180360721443
419,580,7.32696897374702,7.51034482758621,999,7.43343343343343
427,570,7.36065573770492,7.49298245614035,997,7.43630892678034
424,575,7.34433962264151,7.5095652173913,999,7.43943943943944
417,581,7.33093525179856,7.49225473321859,998,7.4248496993988
418,579,7.34210526315789,7.49395509499136,997,7.43029087261785
432,567,7.29398148148148,7.55026455026455,999,7.43943943943944
420,578,7.31428571428571,7.56920415224914,998,7.46192384769539
418,581,7.29665071770335,7.59896729776248,999,7.47247247247247
420,579,7.33333333333333,7.58031088082902,999,7.47647647647648
428,571,7.32710280373832,7.59369527145359,999,7.47947947947948
421,578,7.30641330166271,7.61418685121107,999,7.48448448448448
425,573,7.28705882352941,7.58115183246073,998,7.45591182364729
423,576,7.31678486997636,7.55729166666667,999,7.45545545545546
424,575,7.31603773584906,7.54086956521739,999,7.44544544544545
431,568,7.33874709976798,7.54577464788732,999,7.45645645645646
431,567,7.29466357308585,7.47089947089947,998,7.39478957915832
421,575,7.30403800475059,7.4504347826087,996,7.38855421686747
424,573,7.30188679245283,7.51657940663176,997,7.42527582748245
425,573,7.25176470588235,7.52006980802792,998,7.40581162324649
422,577,7.2345971563981,7.53032928942808,999,7.40540540540541
420,579,7.24047619047619,7.47322970639033,999,7.37537537537538
418,580,7.23923444976077,7.44137931034483,998,7.35671342685371
414,585,7.23188405797101,7.46495726495727,999,7.36836836836837
