forward_num,reverse_num,forward_rate,reverse_rate,organism_num,organism_rate
5,5,5.0,5.0,10,5.0
5,5,5.0,5.0,10,5.0
5,5,5.0,5.0,10,5.0
6,6,5.33333333333333,5.33333333333333,12,5.33333333333333
7,7,5.42857142857143,5.42857142857143,14,5.42857142857143
8,8,5.375,5.375,16,5.375
11,11,5.54545454545455,5.54545454545455,22,5.54545454545455
14,13,5.42857142857143,5.46153846153846,27,5.44444444444444
14,13,5.42857142857143,5.46153846153846,27,5.44444444444444
20,18,5.7,5.77777777777778,38,5.73684210526316
20,18,5.7,5.77777777777778,38,5.73684210526316
26,24,5.61538461538461,5.66666666666667,50,5.64
34,32,5.94117647058824,6.0,66,5.96969696969697
38,34,5.84210526315789,5.94117647058824,72,5.88888888888889
48,44,5.75,5.81818181818182,92,5.78260869565217
64,59,6.0625,6.13559322033898,123,6.09756097560976
68,63,5.94117647058824,6.0,131,5.96946564885496
92,82,5.8695652173913,5.95121951219512,174,5.90804597701149
124,114,6.16129032258065,6.24561403508772,238,6.20168067226891
124,114,6.16129032258065,6.24561403508772,238,6.20168067226891
124,114,6.16129032258065,6.24561403508772,238,6.20168067226891
248,228,6.16129032258065,6.24561403508772,476,6.20168067226891
248,228,6.16129032258065,6.24561403508772,476,6.20168067226891
248,228,6.16129032258065,6.24561403508772,476,6.20168067226891
440,416,6.38181818181818,6.44230769230769,856,6.41121495327103
472,432,6.28813559322034,6.38888888888889,904,6.33628318584071
519,478,6.26011560693642,6.35983263598326,997,6.30792377131394
521,477,6.28406909788868,6.40670859538784,998,6.34268537074148
525,472,6.27047619047619,6.36864406779661,997,6.31695085255767
529,468,6.25519848771267,6.36752136752137,997,6.30792377131394
524,473,6.28625954198473,6.39957716701903,997,6.34002006018054
523,476,6.24856596558317,6.3718487394958,999,6.30730730730731
531,467,6.25423728813559,6.38758029978587,998,6.31663326653307
538,460,6.28066914498141,6.38695652173913,998,6.32965931863727
536,460,6.2910447761194,6.38913043478261,996,6.3363453815261
545,454,6.31009174311927,6.38546255506608,999,6.34434434434434
534,465,6.34456928838951,6.4258064516129,999,6.38238238238238
540,456,6.36296296296296,6.45175438596491,996,6.40361445783132
552,446,6.3768115942029,6.47982062780269,998,6.42284569138277
546,453,6.3956043956044,6.48565121412804,999,6.43643643643644
542,455,6.43542435424354,6.55824175824176,997,6.49147442326981
539,459,6.42300556586271,6.52941176470588,998,6.47194388777555
536,463,6.41231343283582,6.51835853131749,999,6.46146146146146
536,463,6.40485074626866,6.50323974082073,999,6.45045045045045
534,465,6.3876404494382,6.50537634408602,999,6.44244244244244
539,459,6.38404452690167,6.51416122004357,998,6.4438877755511
538,459,6.37918215613383,6.5359477124183,997,6.45135406218656
544,453,6.37316176470588,6.51876379690949,997,6.43931795386158
551,447,6.38838475499093,6.51454138702461,998,6.44488977955912
538,459,6.40706319702602,6.53159041394335,997,6.46439317953862
545,454,6.40366972477064,6.55506607929515,999,6.47247247247247
546,453,6.39377289377289,6.54525386313466,999,6.46246246246246
545,453,6.35779816513761,6.52980132450331,998,6.43587174348697
542,454,6.37269372693727,6.54845814977974,996,6.45281124497992
541,458,6.35120147874307,6.51528384279476,999,6.42642642642643
544,454,6.35110294117647,6.52863436123348,998,6.43186372745491
547,452,6.36745886654479,6.54203539823009,999,6.44644644644645
541,458,6.39371534195933,6.53275109170306,999,6.45745745745746
530,466,6.40754716981132,6.52575107296137,996,6.46285140562249
525,474,6.39619047619048,6.49367088607595,999,6.44244244244244
529,470,6.40264650283554,6.48723404255319,999,6.44244244244244
527,472,6.41366223908918,6.5021186440678,999,6.45545545545546
534,464,6.40823970037453,6.50431034482759,998,6.45290581162325
531,467,6.42749529190207,6.50321199143469,998,6.46292585170341
527,472,6.40607210626186,6.48516949152542,999,6.44344344344344
523,475,6.39388145315488,6.47578947368421,998,6.43286573146293
521,478,6.40499040307102,6.49163179916318,999,6.44644644644645
525,473,6.40380952380952,6.48414376321353,998,6.44188376753507
524,475,6.42175572519084,6.46736842105263,999,6.44344344344344
526,472,6.44296577946768,6.44703389830508,998,6.44488977955912
519,480,6.4393063583815,6.4375,999,6.43843843843844
522,474,6.41570881226054,6.4662447257384,996,6.43975903614458
526,473,6.4106463878327,6.4630021141649,999,6.43543543543544
533,463,6.4390243902439,6.49244060475162,996,6.46385542168675
528,471,6.41477272727273,6.4692144373673,999,6.44044044044044
529,470,6.4007561436673,6.44255319148936,999,6.42042042042042
524,474,6.42175572519084,6.45147679324895,998,6.43587174348697
528,471,6.4469696969697,6.48832271762208,999,6.46646646646647
522,475,6.44061302681992,6.47789473684211,997,6.45837512537613
527,472,6.44022770398482,6.46822033898305,999,6.45345345345345
526,471,6.4467680608365,6.45222929936306,997,6.4493480441324
525,474,6.4552380952381,6.4662447257384,999,6.46046046046046
528,469,6.48863636363636,6.47761194029851,997,6.48345035105316
538,461,6.48327137546468,6.50325379609544,999,6.49249249249249
531,466,6.46327683615819,6.49356223175966,997,6.47743229689067
538,460,6.48327137546468,6.48695652173913,998,6.48496993987976
535,463,6.53644859813084,6.52051835853132,998,6.52905811623246
526,471,6.54562737642586,6.51804670912951,997,6.53259779338014
537,461,6.54189944134078,6.52277657266811,998,6.53306613226453
524,473,6.56297709923664,6.53488372093023,997,6.54964894684052
514,485,6.57392996108949,6.54639175257732,999,6.56056056056056
524,474,6.56870229007634,6.54008438818565,998,6.55511022044088
519,479,6.5606936416185,6.55949895615866,998,6.56012024048096
515,484,6.57669902912621,6.59090909090909,999,6.58358358358358
511,488,6.59295499021526,6.5594262295082,999,6.57657657657658
512,486,6.58984375,6.55555555555556,998,6.57314629258517
512,484,6.58984375,6.56818181818182,996,6.5793172690763
507,490,6.60749506903353,6.55714285714286,997,6.5827482447342
495,504,6.6040404040404,6.55753968253968,999,6.58058058058058
496,503,6.60282258064516,6.55467196819085,999,6.57857857857858
503,495,6.58846918489066,6.54949494949495,998,6.56913827655311
511,486,6.56555772994129,6.54115226337449,997,6.55366098294885
522,477,6.58620689655172,6.56184486373166,999,6.57457457457457
516,482,6.58333333333333,6.56016597510373,998,6.57214428857715
505,493,6.57227722772277,6.55578093306288,998,6.56412825651303
506,493,6.55533596837945,6.5841784989858,999,6.56956956956957
501,497,6.57085828343313,6.59356136820926,998,6.58216432865731
502,497,6.56972111553785,6.59959758551308,999,6.58458458458458
515,484,6.57864077669903,6.58057851239669,999,6.57957957957958
498,500,6.59236947791165,6.606,998,6.59919839679359
505,493,6.60594059405941,6.59229208924949,998,6.59919839679359
517,482,6.61121856866538,6.58921161825726,999,6.6006006006006
506,493,6.62055335968379,6.6105476673428,999,6.61561561561562
512,487,6.607421875,6.60574948665298,999,6.60660660660661
515,482,6.61747572815534,6.62655601659751,997,6.62186559679037
517,482,6.61895551257253,6.64107883817427,999,6.62962962962963
510,489,6.62156862745098,6.6319018404908,999,6.62662662662663
515,481,6.6252427184466,6.62162162162162,996,6.62349397590361
504,495,6.63095238095238,6.60606060606061,999,6.61861861861862
509,489,6.63654223968566,6.61145194274029,998,6.62424849699399
510,489,6.64313725490196,6.61349693251534,999,6.62862862862863
500,497,6.644,6.60764587525151,997,6.6258776328987
492,505,6.64634146341463,6.61782178217822,997,6.63189568706118
501,496,6.63872255489022,6.62701612903226,997,6.63289869608827
499,497,6.64529058116232,6.62374245472837,996,6.63453815261044
503,496,6.6441351888668,6.63306451612903,999,6.63863863863864
511,488,6.63600782778865,6.64549180327869,999,6.64064064064064
504,495,6.65674603174603,6.67676767676768,999,6.66666666666667
496,503,6.66733870967742,6.68190854870775,999,6.67467467467467
503,495,6.66799204771372,6.69494949494949,998,6.6813627254509
509,489,6.66208251473477,6.69734151329243,998,6.67935871743487
511,488,6.66731898238748,6.70491803278689,999,6.68568568568569
511,488,6.68101761252446,6.71311475409836,999,6.6966966966967
508,491,6.69488188976378,6.70672097759674,999,6.7007007007007
503,496,6.68787276341948,6.72379032258065,999,6.70570570570571
508,491,6.70472440944882,6.72912423625255,999,6.71671671671672
508,490,6.70472440944882,6.7265306122449,998,6.71543086172345
502,496,6.70717131474104,6.72983870967742,998,6.7184368737475
501,496,6.70259481037924,6.70766129032258,997,6.70511534603811
495,504,6.69494949494949,6.70039682539683,999,6.6976976976977
487,511,6.70020533880903,6.70841487279843,998,6.70440881763527
486,512,6.70164609053498,6.712890625,998,6.70741482965932
479,518,6.69519832985386,6.71042471042471,997,6.70310932798395
478,520,6.69456066945607,6.69615384615385,998,6.69539078156313
494,505,6.69635627530364,6.68712871287129,999,6.69169169169169
481,518,6.68191268191268,6.68725868725869,999,6.68468468468468
474,525,6.67932489451477,6.69714285714286,999,6.68868868868869
474,523,6.68143459915612,6.69789674952199,997,6.6900702106319
466,531,6.68884120171674,6.71186440677966,997,6.70110330992979
465,534,6.66881720430108,6.7059925093633,999,6.68868868868869
476,523,6.70168067226891,6.72466539196941,999,6.71371371371371
474,525,6.69198312236287,6.72761904761905,999,6.71071071071071
464,535,6.69612068965517,6.70841121495327,999,6.7027027027027
470,529,6.71489361702128,6.69943289224953,999,6.70670670670671
480,518,6.70208333333333,6.71428571428571,998,6.70841683366733
469,528,6.70149253731343,6.6969696969697,997,6.69909729187563
473,526,6.7061310782241,6.6958174904943,999,6.7007007007007
463,535,6.69330453563715,6.68971962616822,998,6.69138276553106
461,537,6.70065075921909,6.70577281191806,998,6.70340681362725
467,532,6.71306209850107,6.69172932330827,999,6.7017017017017
463,536,6.70194384449244,6.7089552238806,999,6.70570570570571
458,541,6.69650655021834,6.71164510166359,999,6.7047047047047
457,542,6.70678336980306,6.71033210332103,999,6.70870870870871
438,560,6.72146118721461,6.70714285714286,998,6.71342685370742
450,549,6.71777777777778,6.71220400728597,999,6.71471471471471
451,548,6.72505543237251,6.70985401459854,999,6.71671671671672
436,562,6.72477064220184,6.71174377224199,998,6.71743486973948
450,549,6.73111111111111,6.71766848816029,999,6.72372372372372
457,541,6.73522975929978,6.72088724584103,998,6.72745490981964
438,560,6.71917808219178,6.71964285714286,998,6.71943887775551
438,561,6.73972602739726,6.72727272727273,999,6.73273273273273
444,555,6.74099099099099,6.74234234234234,999,6.74174174174174
432,567,6.73842592592593,6.73015873015873,999,6.73373373373373
447,552,6.75167785234899,6.73369565217391,999,6.74174174174174
444,551,6.74099099099099,6.73321234119782,995,6.73668341708543
441,558,6.73469387755102,6.74372759856631,999,6.73973973973974
441,556,6.7437641723356,6.74280575539568,997,6.7432296890672
439,558,6.74487471526196,6.74372759856631,997,6.74423269809428
433,566,6.74364896073903,6.74381625441696,999,6.74374374374374
422,577,6.75829383886256,6.74523396880416,999,6.75075075075075
421,577,6.76959619952494,6.74696707105719,998,6.7565130260521
417,581,6.75779376498801,6.76936316695353,998,6.76452905811623
417,581,6.76498800959233,6.76419965576592,998,6.76452905811623
413,586,6.77239709443099,6.75938566552901,999,6.76476476476476
407,590,6.77395577395577,6.77118644067797,997,6.77231695085256
411,588,6.76642335766423,6.77721088435374,999,6.77277277277277
408,591,6.75980392156863,6.76818950930626,999,6.76476476476476
411,588,6.76885644768856,6.77551020408163,999,6.77277277277277
412,587,6.78640776699029,6.78194207836457,999,6.78378378378378
406,593,6.76847290640394,6.77234401349073,999,6.77077077077077
405,593,6.77037037037037,6.76053962900506,998,6.76452905811623
404,594,6.76980198019802,6.76094276094276,998,6.76452905811623
406,593,6.78325123152709,6.77065767284992,999,6.77577577577578
410,589,6.77560975609756,6.76061120543294,999,6.76676676676677
402,595,6.77363184079602,6.76302521008403,997,6.76730190571715
402,597,6.76865671641791,6.76549413735343,999,6.76676676676677
403,596,6.78411910669975,6.76006711409396,999,6.76976976976977
401,596,6.79800498753117,6.75167785234899,997,6.7703109327984
392,606,6.7780612244898,6.76237623762376,998,6.7685370741483
391,607,6.79539641943734,6.7495881383855,998,6.76753507014028
388,611,6.80927835051546,6.75122749590835,999,6.77377377377377
388,611,6.80927835051546,6.74959083469722,999,6.77277277277277
401,597,6.82793017456359,6.76046901172529,998,6.7875751503006
394,605,6.84010152284264,6.74380165289256,999,6.78178178178178
399,600,6.85213032581454,6.74666666666667,999,6.78878878878879
399,600,6.86466165413534,6.74666666666667,999,6.79379379379379
398,601,6.86180904522613,6.74542429284526,999,6.79179179179179
382,615,6.85340314136126,6.7349593495935,997,6.78034102306921
393,604,6.85496183206107,6.73013245033113,997,6.77933801404213
384,612,6.84895833333333,6.72549019607843,996,6.77309236947791
380,618,6.83947368421053,6.72330097087379,998,6.76753507014028
381,617,6.85564304461942,6.71312803889789,998,6.76753507014028
381,618,6.8503937007874,6.73139158576052,999,6.77677677677678
374,625,6.8475935828877,6.7296,999,6.77377377377377
389,610,6.83804627249357,6.74426229508197,999,6.78078078078078
391,608,6.83887468030691,6.76151315789474,999,6.79179179179179
386,613,6.8419689119171,6.75856443719413,999,6.79079079079079
390,608,6.86153846153846,6.77302631578947,998,6.80761523046092
393,605,6.84732824427481,6.78181818181818,998,6.80761523046092
390,609,6.82820512820513,6.80131362889984,999,6.81181181181181
394,603,6.83248730964467,6.787728026534,997,6.80541624874624
396,603,6.83838383838384,6.79933665008292,999,6.81481481481481
391,606,6.81841432225064,6.8019801980198,997,6.80842527582748
384,612,6.83072916666667,6.79901960784314,996,6.81124497991968
374,622,6.83155080213904,6.80546623794212,996,6.81526104417671
371,627,6.8355795148248,6.81658692185008,998,6.82364729458918
372,627,6.83870967741935,6.82456140350877,999,6.82982982982983
365,633,6.83835616438356,6.82148499210111,998,6.82765531062124
366,633,6.83606557377049,6.82148499210111,999,6.82682682682683
373,626,6.828418230563,6.82428115015974,999,6.82582582582583
365,633,6.84109589041096,6.81042654028436,998,6.82164328657315
370,628,6.82972972972973,6.81369426751592,998,6.81963927855711
367,629,6.82016348773842,6.81399046104928,996,6.81626506024096
358,641,6.82960893854749,6.81903276131045,999,6.82282282282282
364,635,6.83791208791209,6.83464566929134,999,6.83583583583584
358,641,6.81564245810056,6.83619344773791,999,6.82882882882883
353,645,6.79886685552408,6.84186046511628,998,6.82665330661323
345,651,6.80579710144928,6.84178187403994,996,6.8293172690763
344,655,6.80232558139535,6.83358778625954,999,6.82282282282282
337,662,6.77744807121662,6.84743202416918,999,6.82382382382382
340,659,6.77941176470588,6.84825493171472,999,6.82482482482482
331,668,6.77341389728097,6.84730538922156,999,6.82282282282282
331,667,6.75528700906344,6.84857571214393,998,6.81763527054108
331,667,6.75528700906344,6.85157421289355,998,6.81963927855711
318,680,6.75786163522013,6.84705882352941,998,6.8186372745491
327,672,6.76452599388379,6.85119047619048,999,6.82282282282282
334,665,6.76347305389222,6.85714285714286,999,6.82582582582583
323,674,6.75232198142415,6.85905044510386,997,6.82447342026078
324,673,6.78086419753086,6.85586924219911,997,6.83149448345035
332,667,6.75903614457831,6.86206896551724,999,6.82782782782783
321,678,6.78193146417445,6.8716814159292,999,6.84284284284284
327,672,6.782874617737,6.87053571428571,999,6.84184184184184
327,672,6.782874617737,6.87202380952381,999,6.84284284284284
308,691,6.77922077922078,6.88712011577424,999,6.85385385385385
316,683,6.80063291139241,6.8814055636896,999,6.85585585585586
319,680,6.79310344827586,6.87352941176471,999,6.84784784784785
314,684,6.78662420382166,6.87280701754386,998,6.84569138276553
316,681,6.7879746835443,6.87077826725404,997,6.84453360080241
311,686,6.79099678456592,6.87026239067055,997,6.84553660982949
310,686,6.78387096774194,6.86588921282799,996,6.84036144578313
321,678,6.77881619937695,6.86873156342183,999,6.83983983983984
317,679,6.79810725552051,6.86892488954345,996,6.84638554216868
310,689,6.79677419354839,6.8577648766328,999,6.83883883883884
305,694,6.79016393442623,6.85302593659942,999,6.83383383383383
310,689,6.78064516129032,6.85195936139332,999,6.82982982982983
309,690,6.77669902912621,6.84927536231884,999,6.82682682682683
316,683,6.77848101265823,6.85505124450952,999,6.83083083083083
317,681,6.79495268138801,6.8575624082232,998,6.8376753507014
317,682,6.79495268138801,6.84457478005865,999,6.82882882882883
306,693,6.79084967320261,6.83694083694084,999,6.82282282282282
313,686,6.80191693290735,6.84985422740525,999,6.83483483483483
311,688,6.80385852090032,6.8531976744186,999,6.83783783783784
310,689,6.78709677419355,6.84905660377358,999,6.82982982982983
309,689,6.78640776699029,6.86066763425254,998,6.8376753507014
319,680,6.78683385579937,6.86470588235294,999,6.83983983983984
319,680,6.78996865203762,6.86470588235294,999,6.84084084084084
314,684,6.77388535031847,6.86549707602339,998,6.83667334669339
312,687,6.76602564102564,6.86608442503639,999,6.83483483483483
316,681,6.75316455696202,6.86049926578561,997,6.82647943831495
309,690,6.75728155339806,6.85652173913043,999,6.82582582582583
305,692,6.75737704918033,6.86849710982659,997,6.83450351053159
313,685,6.76996805111821,6.87299270072993,998,6.84068136272545
310,688,6.76451612903226,6.87209302325581,998,6.83867735470942
315,683,6.78730158730159,6.87554904831625,998,6.84769539078156
326,673,6.77914110429448,6.88410104011887,999,6.84984984984985
314,685,6.79299363057325,6.87007299270073,999,6.84584584584585
316,683,6.80379746835443,6.85944363103953,999,6.84184184184184
312,686,6.79487179487179,6.86151603498542,998,6.84068136272545
301,698,6.79734219269103,6.86676217765043,999,6.84584584584585
295,703,6.82033898305085,6.85206258890469,998,6.84268537074148
294,704,6.8265306122449,6.86931818181818,998,6.85671342685371
295,704,6.79661016949153,6.87215909090909,999,6.84984984984985
296,702,6.79054054054054,6.87464387464387,998,6.8496993987976
292,706,6.82534246575342,6.87110481586402,998,6.85771543086172
281,717,6.8220640569395,6.8744769874477,998,6.85971943887776
286,713,6.80769230769231,6.88920056100982,999,6.86586586586587
283,716,6.79151943462898,6.8854748603352,999,6.85885885885886
289,710,6.80968858131488,6.88591549295775,999,6.86386386386386
293,706,6.81569965870307,6.88243626062323,999,6.86286286286286
290,709,6.82758620689655,6.87729196050776,999,6.86286286286286
294,705,6.81972789115646,6.87943262411348,999,6.86186186186186
305,694,6.8327868852459,6.89193083573487,999,6.87387387387387
304,694,6.83881578947368,6.89337175792507,998,6.87675350701403
303,696,6.82178217821782,6.89224137931035,999,6.87087087087087
303,696,6.82838283828383,6.90373563218391,999,6.88088088088088
300,699,6.84333333333333,6.90271816881259,999,6.88488488488488
303,695,6.86138613861386,6.89928057553957,998,6.8877755511022
305,694,6.8655737704918,6.90634005763689,999,6.89389389389389
300,699,6.85333333333333,6.90987124463519,999,6.89289289289289
299,700,6.85284280936455,6.91,999,6.89289289289289
297,701,6.85185185185185,6.90870185449358,998,6.89178356713427
293,706,6.84641638225256,6.90793201133144,999,6.88988988988989
305,693,6.83606557377049,6.90764790764791,998,6.88577154308617
295,703,6.86101694915254,6.90469416785206,998,6.89178356713427
291,708,6.85223367697594,6.90819209039548,999,6.89189189189189
286,713,6.85664335664336,6.90743338008415,999,6.89289289289289
282,715,6.85815602836879,6.91888111888112,997,6.90170511534604
280,718,6.86428571428571,6.9150417827298,998,6.90080160320641
279,720,6.88888888888889,6.91805555555556,999,6.90990990990991
279,720,6.89247311827957,6.91805555555556,999,6.91091091091091
274,725,6.88686131386861,6.91586206896552,999,6.90790790790791
284,715,6.88380281690141,6.92167832167832,999,6.91091091091091
274,724,6.88686131386861,6.91850828729282,998,6.90981963927856
272,726,6.88970588235294,6.91597796143251,998,6.90881763527054
287,710,6.8815331010453,6.91408450704225,997,6.90471414242728
286,713,6.88461538461539,6.91164095371669,999,6.9039039039039
287,711,6.89198606271777,6.91561181434599,998,6.90881763527054
285,714,6.89824561403509,6.92016806722689,999,6.91391391391391
289,710,6.88235294117647,6.92676056338028,999,6.91391391391391
291,708,6.88316151202749,6.92372881355932,999,6.91191191191191
288,709,6.88541666666667,6.92101551480959,997,6.91073219658977
287,710,6.8815331010453,6.91830985915493,997,6.90772316950853
292,706,6.85958904109589,6.92067988668555,998,6.90280561122244
288,711,6.86805555555556,6.91420534458509,999,6.9009009009009
287,712,6.8815331010453,6.91011235955056,999,6.9019019019019
278,721,6.89928057553957,6.9126213592233,999,6.90890890890891
283,716,6.8904593639576,6.90782122905028,999,6.9029029029029
279,720,6.89247311827957,6.91111111111111,999,6.90590590590591
262,737,6.88931297709924,6.91587516960651,999,6.90890890890891
260,736,6.89615384615385,6.90625,996,6.90361445783132
264,734,6.89015151515152,6.91144414168937,998,6.90581162324649
257,740,6.89105058365759,6.91486486486486,997,6.90872617853561
256,741,6.87890625,6.91632928475034,997,6.90672016048144
256,743,6.890625,6.91655450874832,999,6.90990990990991
261,738,6.88888888888889,6.9159891598916,999,6.90890890890891
263,734,6.87832699619772,6.91689373297003,997,6.90672016048144
262,737,6.87786259541985,6.921302578019,999,6.90990990990991
258,741,6.89147286821705,6.92172739541161,999,6.91391391391391
267,732,6.87640449438202,6.91939890710383,999,6.90790790790791
267,729,6.86516853932584,6.91906721536351,996,6.90461847389558
267,731,6.87640449438202,6.91655266757866,998,6.90581162324649
273,725,6.87179487179487,6.91448275862069,998,6.90280561122244
270,728,6.86666666666667,6.91346153846154,998,6.90080160320641
277,722,6.86642599277978,6.90858725761773,999,6.8968968968969
280,718,6.87142857142857,6.90807799442897,998,6.89779559118236
273,726,6.86813186813187,6.90909090909091,999,6.8978978978979
278,721,6.88489208633094,6.9001386962552,999,6.8958958958959
281,718,6.86476868327402,6.9025069637883,999,6.89189189189189
281,718,6.86120996441281,6.90389972144847,999,6.89189189189189
277,721,6.87364620938628,6.90429958391123,998,6.89579158316633
278,721,6.87769784172662,6.90568654646325,999,6.8978978978979
286,711,6.85664335664336,6.89732770745429,997,6.88565697091274
277,722,6.86281588447653,6.90443213296399,999,6.89289289289289
279,719,6.86379928315412,6.90264255910988,998,6.89178356713427
278,721,6.88489208633094,6.91400832177531,999,6.90590590590591
268,731,6.88059701492537,6.91381668946648,999,6.9049049049049
275,724,6.90181818181818,6.91988950276243,999,6.91491491491491
273,724,6.89377289377289,6.91574585635359,997,6.90972918756269
269,730,6.90334572490706,6.92054794520548,999,6.91591591591592
275,723,6.89090909090909,6.92392807745505,998,6.91482965931864
266,733,6.88721804511278,6.92633015006821,999,6.91591591591592
272,726,6.88235294117647,6.92837465564738,998,6.91583166332665
275,723,6.87636363636364,6.92807745504841,998,6.91382765531062
284,713,6.86267605633803,6.93267882187938,997,6.91273821464393
278,721,6.88848920863309,6.93619972260749,999,6.92292292292292
275,723,6.87636363636364,6.93222683264177,998,6.91683366733467
286,713,6.87762237762238,6.93548387096774,999,6.91891891891892
287,710,6.86759581881533,6.93943661971831,997,6.91875626880642
284,715,6.89084507042254,6.94125874125874,999,6.92692692692693
294,702,6.86734693877551,6.93589743589744,996,6.91566265060241
295,703,6.87457627118644,6.9402560455192,998,6.92084168336673
298,701,6.8758389261745,6.94151212553495,999,6.92192192192192
296,703,6.86824324324324,6.93598862019915,999,6.91591591591592
296,702,6.84797297297297,6.94017094017094,998,6.91282565130261
298,699,6.85570469798658,6.94420600858369,997,6.91775325977934
295,703,6.87457627118644,6.94167852062589,998,6.92184368737475
290,706,6.88965517241379,6.93909348441926,996,6.92469879518072
288,711,6.88194444444444,6.94374120956399,999,6.92592592592593
288,711,6.89930555555556,6.93811533052039,999,6.92692692692693
293,706,6.90102389078498,6.93909348441926,999,6.92792792792793
284,714,6.8943661971831,6.93837535014006,998,6.92585170340681
280,718,6.9,6.93871866295265,998,6.92785571142285
284,715,6.90140845070423,6.94125874125874,999,6.92992992992993
285,714,6.90175438596491,6.94677871148459,999,6.93393393393393
278,721,6.92446043165468,6.94729542302358,999,6.94094094094094
272,726,6.92279411764706,6.94490358126722,998,6.93887775551102
286,713,6.90559440559441,6.93969144460028,999,6.92992992992993
291,707,6.90721649484536,6.94766619519095,998,6.93587174348697
286,711,6.91958041958042,6.94514767932489,997,6.93781344032096
296,703,6.93243243243243,6.94736842105263,999,6.94294294294294
289,710,6.94117647058824,6.94929577464789,999,6.94694694694695
279,720,6.95340501792115,6.95416666666667,999,6.95395395395395
278,721,6.96043165467626,6.95284327323162,999,6.95495495495495
273,726,6.95970695970696,6.95454545454545,999,6.95595595595596
273,726,6.95970695970696,6.95592286501377,999,6.95695695695696
274,725,6.95620437956204,6.95724137931034,999,6.95695695695696
268,731,6.9589552238806,6.95212038303694,999,6.95395395395395
262,736,6.95801526717557,6.94972826086957,998,6.95190380761523
263,736,6.96577946768061,6.95108695652174,999,6.95495495495495
273,725,6.95970695970696,6.94896551724138,998,6.95190380761523
271,728,6.95571955719557,6.94642857142857,999,6.94894894894895
266,732,6.94360902255639,6.94808743169399,998,6.94689378757515
260,738,6.94615384615385,6.94444444444444,998,6.94488977955912
265,733,6.93962264150943,6.94270122783083,998,6.94188376753507
265,734,6.94339622641509,6.94277929155313,999,6.94294294294294
271,728,6.92619926199262,6.94093406593407,999,6.93693693693694
278,719,6.93525179856115,6.94297635605007,997,6.94082246740221
272,726,6.93014705882353,6.94490358126722,998,6.94088176352705
276,723,6.92753623188406,6.94744121715076,999,6.94194194194194
271,728,6.92619926199262,6.94917582417582,999,6.94294294294294
271,728,6.91881918819188,6.94917582417582,999,6.94094094094094
265,733,6.92075471698113,6.94952251023192,998,6.94188376753507
265,733,6.92830188679245,6.95361527967258,998,6.94689378757515
265,734,6.94339622641509,6.95367847411444,999,6.95095095095095
270,729,6.94074074074074,6.95747599451303,999,6.95295295295295
268,730,6.94776119402985,6.95890410958904,998,6.95591182364729
275,724,6.94545454545455,6.95165745856354,999,6.94994994994995
264,733,6.93939393939394,6.95088676671214,997,6.94784353059178
269,730,6.94052044609665,6.94931506849315,999,6.94694694694695
265,734,6.94339622641509,6.94822888283379,999,6.94694694694695
259,739,6.94208494208494,6.94722598105548,998,6.94589178356713
266,732,6.93984962406015,6.94672131147541,998,6.94488977955912
262,736,6.93129770992366,6.94565217391304,998,6.94188376753507
264,734,6.93181818181818,6.94277929155313,998,6.93987975951904
262,737,6.93129770992366,6.94843962008141,999,6.94394394394394
257,742,6.92607003891051,6.94474393530997,999,6.93993993993994
260,737,6.92307692307692,6.94301221166893,997,6.93781344032096
258,740,6.92248062015504,6.9472972972973,998,6.94088176352705
257,742,6.92996108949416,6.94474393530997,999,6.94094094094094
259,740,6.93436293436293,6.94324324324324,999,6.94094094094094
259,738,6.92664092664093,6.94308943089431,997,6.93881644934804
256,742,6.9296875,6.94878706199461,998,6.9438877755511
252,747,6.92063492063492,6.94779116465863,999,6.94094094094094
241,757,6.92946058091286,6.95244385733157,998,6.94689378757515
237,759,6.92405063291139,6.95388669301713,996,6.94678714859438
243,756,6.93004115226337,6.95634920634921,999,6.94994994994995
247,751,6.93117408906883,6.95073235685752,998,6.94589178356713
246,750,6.9390243902439,6.94933333333333,996,6.94678714859438
249,750,6.92369477911647,6.948,999,6.94194194194194
251,748,6.9203187250996,6.95053475935829,999,6.94294294294294
240,758,6.92916666666667,6.94722955145119,998,6.94288577154309
230,769,6.93478260869565,6.94668400520156,999,6.94394394394394
237,762,6.92405063291139,6.94619422572178,999,6.94094094094094
240,759,6.92916666666667,6.94202898550725,999,6.93893893893894
240,759,6.9375,6.9433465085639,999,6.94194194194194
241,757,6.93775933609959,6.94187582562748,998,6.94088176352705
238,759,6.93697478991597,6.94598155467721,997,6.94383149448345
243,752,6.94650205761317,6.95079787234043,995,6.94974874371859
241,757,6.94605809128631,6.95112285336856,998,6.9498997995992
237,762,6.9535864978903,6.95144356955381,999,6.95195195195195
235,762,6.95744680851064,6.9501312335958,997,6.9518555667001
229,769,6.96506550218341,6.94928478543563,998,6.95290581162325
227,772,6.96916299559471,6.94818652849741,999,6.95295295295295
233,766,6.9656652360515,6.94778067885118,999,6.95195195195195
225,773,6.96444444444444,6.95213454075032,998,6.95490981963928
233,765,6.96995708154506,6.95424836601307,998,6.95791583166333
239,760,6.96234309623431,6.95263157894737,999,6.95495495495495
236,762,6.97033898305085,6.95669291338583,998,6.95991983967936
235,760,6.97021276595745,6.95526315789474,995,6.95879396984925
244,755,6.97131147540984,6.95629139072848,999,6.95995995995996
249,748,6.96385542168675,6.96256684491979,997,6.96288866599799
250,748,6.972,6.96657754010695,998,6.96793587174349
255,744,6.97254901960784,6.96908602150538,999,6.96996996996997
259,739,6.97297297297297,6.97293640054127,998,6.97294589178357
255,744,6.97254901960784,6.9744623655914,999,6.97397397397397
259,739,6.97297297297297,6.97834912043302,998,6.97695390781563
265,734,6.97358490566038,6.97820163487738,999,6.97697697697698
259,740,6.97297297297297,6.97837837837838,999,6.97697697697698
254,745,6.97637795275591,6.97718120805369,999,6.97697697697698
255,743,6.97647058823529,6.97577388963661,998,6.97595190380762
255,743,6.97647058823529,6.97577388963661,998,6.97595190380762
260,739,6.97307692307692,6.97699594046008,999,6.97597597597598
259,740,6.97297297297297,6.97702702702703,999,6.97597597597598
260,738,6.97692307692308,6.97967479674797,998,6.97895791583166
262,737,6.98091603053435,6.98371777476255,999,6.98298298298298
248,750,6.97983870967742,6.98533333333333,998,6.98396793587174
245,753,6.97959183673469,6.9867197875166,998,6.98496993987976
242,755,6.97933884297521,6.9841059602649,997,6.98294884653962
245,750,6.97551020408163,6.98533333333333,995,6.98291457286432
240,759,6.975,6.98550724637681,999,6.98298298298298
239,759,6.97489539748954,6.98418972332016,998,6.98196392785571
239,759,6.97071129707113,6.98155467720685,998,6.97895791583166
238,759,6.97058823529412,6.9828722002635,997,6.97993981945837
234,764,6.97008547008547,6.98429319371728,998,6.98096192384769
236,762,6.97033898305085,6.98425196850394,998,6.98096192384769
239,759,6.97071129707113,6.98418972332016,998,6.98096192384769
238,759,6.97058823529412,6.98418972332016,997,6.98094282848546
241,758,6.97095435684647,6.98284960422164,999,6.97997997997998
239,759,6.97071129707113,6.9828722002635,998,6.97995991983968
242,757,6.97520661157025,6.98282694848085,999,6.98098098098098
239,760,6.97907949790795,6.98552631578947,999,6.98398398398398
244,754,6.97540983606557,6.98806366047745,998,6.98496993987976
243,752,6.97530864197531,6.9906914893617,995,6.98693467336683
240,757,6.975,6.99207397622193,997,6.98796389167503
248,749,6.97983870967742,6.98931909212283,997,6.98696088264794
246,753,6.97560975609756,6.98937583001328,999,6.98598598598599
246,753,6.97967479674797,6.98937583001328,999,6.98698698698699
251,748,6.97609561752988,6.9879679144385,999,6.98498498498498
249,750,6.97590361445783,6.98933333333333,999,6.98598598598599
258,741,6.97674418604651,6.99325236167341,999,6.98898898898899
260,738,6.97692307692308,6.99322493224932,998,6.98897795591182
256,743,6.96875,6.99057873485868,999,6.98498498498498
250,749,6.968,6.99065420560748,999,6.98498498498498
254,745,6.97244094488189,6.98926174496644,999,6.98498498498498
253,745,6.97233201581028,6.98657718120805,998,6.98296593186373
252,746,6.97619047619048,6.98793565683646,998,6.98496993987976
253,746,6.97628458498024,6.98793565683646,999,6.98498498498498
260,739,6.97692307692308,6.98917456021651,999,6.98598598598599
256,742,6.98046875,6.98921832884097,998,6.98697394789579
257,740,6.98443579766537,6.98918918918919,997,6.98796389167503
264,734,6.98484848484848,6.98910081743869,998,6.98797595190381
265,733,6.98490566037736,6.98772169167804,998,6.98697394789579
269,729,6.98513011152416,6.98628257887517,998,6.98597194388778
273,725,6.98534798534799,6.98620689655172,998,6.98597194388778
279,720,6.98566308243728,6.98611111111111,999,6.98598598598599
280,718,6.98214285714286,6.98328690807799,998,6.98296593186373
290,709,6.97931034482759,6.98448519040903,999,6.98298298298298
286,710,6.97902097902098,6.98591549295775,996,6.98393574297189
278,721,6.97482014388489,6.98474341192788,999,6.98198198198198
282,714,6.97163120567376,6.98459383753501,996,6.98092369477912
286,713,6.97202797202797,6.98457223001403,999,6.98098098098098
287,712,6.97212543554007,6.98314606741573,999,6.97997997997998
294,704,6.97278911564626,6.98579545454545,998,6.98196392785571
290,707,6.97241379310345,6.98585572842999,997,6.98194583751254
289,709,6.9757785467128,6.98589562764457,998,6.98296593186373
285,712,6.9719298245614,6.9873595505618,997,6.98294884653962
287,711,6.96864111498258,6.9873417721519,998,6.98196392785571
289,709,6.97231833910035,6.98730606488011,998,6.98296593186373
283,715,6.97526501766784,6.98461538461538,998,6.98196392785571
291,707,6.97250859106529,6.98444130127298,998,6.98096192384769
291,707,6.97250859106529,6.98444130127298,998,6.98096192384769
292,707,6.97602739726027,6.98161244695898,999,6.97997997997998
290,708,6.97241379310345,6.9816384180791,998,6.97895791583166
291,707,6.96907216494845,6.98302687411598,998,6.97895791583166
292,707,6.96575342465753,6.98161244695898,999,6.97697697697698
283,716,6.96466431095406,6.97765363128492,999,6.97397397397397
288,711,6.96180555555556,6.9789029535865,999,6.97397397397397
290,707,6.96206896551724,6.97736916548798,997,6.97291875626881
287,712,6.9581881533101,6.9747191011236,999,6.96996996996997
285,714,6.96491228070175,6.97899159663866,999,6.97497497497497
288,711,6.97222222222222,6.9803094233474,999,6.97797797797798
280,719,6.97142857142857,6.97913769123783,999,6.97697697697698
290,708,6.97241379310345,6.98022598870056,998,6.97795591182365
287,712,6.97212543554007,6.98314606741573,999,6.97997997997998
279,717,6.96774193548387,6.98186889818689,996,6.97791164658635
281,718,6.96797153024911,6.98050139275766,999,6.97697697697698
280,719,6.96785714285714,6.98331015299026,999,6.97897897897898
278,720,6.96402877697842,6.98472222222222,998,6.97895791583166
281,716,6.97153024911032,6.98324022346369,997,6.97993981945837
278,721,6.96402877697842,6.98196948682386,999,6.97697697697698
287,711,6.9616724738676,6.9831223628692,998,6.97695390781563
279,720,6.96415770609319,6.98055555555556,999,6.97597597597598
288,710,6.96180555555556,6.9830985915493,998,6.97695390781563
290,709,6.96896551724138,6.98166431593794,999,6.97797797797798
289,709,6.96539792387543,6.98166431593794,998,6.97695390781563
292,707,6.96917808219178,6.98019801980198,999,6.97697697697698
301,698,6.9734219269103,6.97994269340974,999,6.97797797797798
307,691,6.97394136807818,6.98118668596237,998,6.97895791583166
306,692,6.97385620915033,6.98410404624277,998,6.98096192384769
310,689,6.97096774193548,6.98548621190131,999,6.98098098098098
307,691,6.97068403908795,6.98552821997106,998,6.98096192384769
302,696,6.97350993377483,6.98132183908046,998,6.97895791583166
293,706,6.97610921501706,6.98158640226629,999,6.97997997997998
288,711,6.97569444444444,6.9831223628692,999,6.98098098098098
296,702,6.97635135135135,6.98575498575499,998,6.98296593186373
300,697,6.97666666666667,6.98278335724534,997,6.98094282848546
299,700,6.97324414715719,6.98571428571429,999,6.98198198198198
302,697,6.97682119205298,6.98565279770445,999,6.98298298298298
307,692,6.97394136807818,6.98410404624277,999,6.98098098098098
304,694,6.97039473684211,6.98559077809798,998,6.98096192384769
305,694,6.97704918032787,6.98703170028818,999,6.98398398398398
303,694,6.97359735973597,6.98703170028818,997,6.98294884653962
296,699,6.97297297297297,6.98712446351931,995,6.98291457286432
304,695,6.96710526315789,6.98705035971223,999,6.98098098098098
303,696,6.97029702970297,6.98706896551724,999,6.98198198198198
302,696,6.96688741721854,6.98994252873563,998,6.98296593186373
300,699,6.96333333333333,6.98998569384835,999,6.98198198198198
291,708,6.97250859106529,6.99011299435028,999,6.98498498498498
293,706,6.97610921501706,6.99008498583569,999,6.98598598598599
297,702,6.97306397306397,6.98860398860399,999,6.98398398398398
292,707,6.97260273972603,6.99009900990099,999,6.98498498498498
295,704,6.97627118644068,6.99147727272727,999,6.98698698698699
295,703,6.9728813559322,6.99288762446657,998,6.98697394789579
296,702,6.96959459459459,6.99145299145299,998,6.98496993987976
292,705,6.97945205479452,6.99148936170213,997,6.98796389167503
295,702,6.97627118644068,6.99430199430199,997,6.98896690070211
284,715,6.97887323943662,6.99440559440559,999,6.98998998998999
290,708,6.97931034482759,6.99435028248588,998,6.98997995991984
293,706,6.97610921501706,6.9943342776204,999,6.98898898898899
289,709,6.98269896193772,6.99435825105783,998,6.99098196392786
302,694,6.98344370860927,6.99423631123919,996,6.99096385542169
314,685,6.98407643312102,6.9985401459854,999,6.99399399399399
313,683,6.9776357827476,7.0,996,6.9929718875502
319,680,6.97805642633229,7.0,999,6.99299299299299
307,690,6.9771986970684,7.0,997,6.99297893681043
307,692,6.98697068403909,7.0,999,6.995995995996
316,683,6.98417721518987,7.0,999,6.99499499499499
314,685,6.98407643312102,7.0,999,6.99499499499499
316,683,6.9873417721519,7.0,999,6.995995995996
316,681,6.98417721518987,7.0,997,6.99498495486459
315,684,6.98412698412698,7.0,999,6.99499499499499
318,681,6.98427672955975,7.0,999,6.99499499499499
316,683,6.9873417721519,7.0,999,6.995995995996
312,686,6.98717948717949,7.0,998,6.99599198396794
303,695,6.99009900990099,7.0,998,6.99699398797595
313,684,6.99361022364217,7.0,997,6.99799398194584
309,690,6.99676375404531,7.0,999,6.998998998999
308,691,6.99350649350649,7.0,999,6.997997997998
311,685,6.9935691318328,7.0,996,6.99799196787149
306,692,6.99673202614379,7.0,998,6.99899799599198
317,682,6.99369085173502,7.0,999,6.997997997998
328,671,6.99390243902439,7.0,999,6.997997997998
323,673,6.9938080495356,7.0,996,6.99799196787149
327,672,6.99388379204893,7.0,999,6.997997997998
345,653,6.99420289855072,7.0,998,6.99799599198397
348,651,6.99425287356322,7.0,999,6.997997997998
351,648,6.99430199430199,7.0,999,6.997997997998
352,647,6.99147727272727,7.0,999,6.996996996997
346,653,6.99421965317919,7.0,999,6.997997997998
344,655,6.99418604651163,7.0,999,6.997997997998
348,650,6.99425287356322,7.0,998,6.99799599198397
341,658,6.9941348973607,7.0,999,6.997997997998
340,659,6.99411764705882,7.0,999,6.997997997998
341,658,6.9941348973607,7.0,999,6.997997997998
347,652,6.99423631123919,7.0,999,6.997997997998
353,645,6.9971671388102,7.0,998,6.99899799599198
355,643,6.99718309859155,7.0,998,6.99899799599198
373,626,6.99731903485255,7.0,999,6.998998998999
376,623,6.99734042553191,7.0,999,6.998998998999
374,625,6.99732620320856,7.0,999,6.998998998999
376,622,6.99734042553191,7.0,998,6.99899799599198
370,628,6.9972972972973,7.0,998,6.99899799599198
371,628,6.99730458221024,7.0,999,6.998998998999
380,619,6.99736842105263,7.0,999,6.998998998999
374,623,6.99465240641711,7.0,997,6.99799398194584
376,622,6.99734042553191,7.0,998,6.99899799599198
374,625,6.99732620320856,7.0,999,6.998998998999
372,625,6.99731182795699,7.0,997,6.99899699097292
367,632,6.99455040871935,7.0,999,6.997997997998
364,635,6.99450549450549,7.0,999,6.997997997998
371,627,7.0,7.0,998,7.0
373,626,7.0,7.0,999,7.0
370,628,7.0,7.0,998,7.0
369,630,7.0,7.0,999,7.0
382,615,7.0,7.0,997,7.0
379,619,7.0,7.0,998,7.0
381,618,7.0,7.0,999,7.0
373,625,7.0,7.0,998,7.0
375,624,7.0,7.0,999,7.0
367,632,7.0,7.0,999,7.0
359,639,7.0,7.0,998,7.0
353,644,7.0,7.0,997,7.0
361,635,7.0,7.0,996,7.0
358,641,7.0,7.0,999,7.0
359,640,7.0,7.0,999,7.0
370,629,7.0,7.0,999,7.0
369,628,7.0,7.0,997,7.0
373,624,7.0,7.0,997,7.0
379,620,7.0,7.0,999,7.0
373,626,7.0,7.0,999,7.0
371,628,7.0,7.0,999,7.0
374,622,7.0,7.0,996,7.0
366,633,7.0,7.0,999,7.0
366,633,7.0,7.0,999,7.0
363,635,7.0,7.0,998,7.0
359,640,7.0,7.0,999,7.0
359,640,7.0,7.0,999,7.0
353,645,7.0,7.0,998,7.0
356,643,7.0,7.0,999,7.0
355,640,7.0,7.0,995,7.0
344,654,7.0,7.0,998,7.0
354,645,7.0,7.0,999,7.0
359,640,7.0,7.0,999,7.0
348,651,7.0,7.0,999,7.0
350,647,7.0,7.0,997,7.0
352,645,7.0,7.0,997,7.0
354,643,7.0,7.0,997,7.0
353,644,7.0,7.0,997,7.0
342,656,7.0,7.0,998,7.0
343,656,7.0,7.0,999,7.0
356,642,7.0,7.0,998,7.0
346,653,7.0,7.0,999,7.0
349,649,7.0,7.0,998,7.0
344,653,7.0,7.0,997,7.0
346,653,7.0,7.0,999,7.0
341,657,7.0,7.0,998,7.0
333,665,7.0,7.0,998,7.0
339,657,7.0,7.0,996,7.0
328,671,7.0,7.0,999,7.0
319,679,7.0,7.0,998,7.0
326,673,7.0,7.0,999,7.0
329,670,7.0,7.0,999,7.0
320,678,7.0,7.0,998,7.0
322,677,7.0,7.0,999,7.0
322,676,7.0,7.0,998,7.0
317,682,7.0,7.0,999,7.0
330,669,7.0,7.0,999,7.0
327,672,7.0,7.0,999,7.0
329,669,7.0,7.0,998,7.0
336,661,7.0,7.0,997,7.0
333,666,7.0,7.0,999,7.0
330,668,7.0,7.0,998,7.0
332,667,7.0,7.0,999,7.0
316,683,7.0,7.0,999,7.0
317,681,7.0,7.0,998,7.0
324,673,7.0,7.0,997,7.0
312,686,7.0,7.0,998,7.0
322,676,7.0,7.0,998,7.0
324,673,7.0,7.0,997,7.0
316,681,7.0,7.0,997,7.0
311,688,7.0,7.0,999,7.0
318,681,7.0,7.0,999,7.0
316,682,7.0,7.0,998,7.0
328,671,7.0,7.0,999,7.0
323,676,7.0,7.0,999,7.0
327,672,7.0,7.0,999,7.0
323,676,7.0,7.0,999,7.0
319,680,7.0,7.0,999,7.0
325,673,7.0,7.0,998,7.0
325,673,7.0,7.0,998,7.0
328,671,7.0,7.0,999,7.0
328,671,7.0,7.0,999,7.0
322,674,7.0,7.0,996,7.0
317,682,7.0,7.0,999,7.0
319,679,7.0,7.0,998,7.0
314,683,7.0,7.0,997,7.0
315,681,7.0,7.0,996,7.0
321,678,7.0,7.0,999,7.0
320,679,7.0,7.0,999,7.0
318,681,7.0,7.0,999,7.0
330,669,7.0,7.0,999,7.0
332,667,7.0,7.0,999,7.0
328,670,7.0,7.0,998,7.0
327,672,7.0,7.0,999,7.0
337,660,7.0,7.0,997,7.0
332,667,7.0,7.0,999,7.0
340,658,7.0,7.0,998,7.0
334,665,7.0,7.0,999,7.0
339,660,7.0,7.0,999,7.0
338,660,7.0,7.0,998,7.0
340,658,7.0,7.0,998,7.0
343,655,7.0,7.0,998,7.0
358,641,7.0,7.0,999,7.0
350,649,7.0,7.0,999,7.0
360,638,7.0,7.0,998,7.0
376,621,7.0,7.0,997,7.0
365,634,7.0,7.0,999,7.0
379,619,7.0,7.0,998,7.0
383,615,7.0,7.0,998,7.0
375,624,7.0,7.0,999,7.0
380,619,7.0,7.0,999,7.0
381,617,7.0,7.0,998,7.0
363,634,7.0,7.0,997,7.0
372,626,7.0,7.0,998,7.0
374,625,7.0,7.0,999,7.0
366,633,7.0,7.0,999,7.0
370,629,7.0,7.0,999,7.0
360,635,7.0,7.0,995,7.0
358,641,7.0,7.0,999,7.0
363,636,7.0,7.0,999,7.0
351,645,7.0,7.0,996,7.0
353,644,7.0,7.0,997,7.0
350,649,7.0,7.0,999,7.0
349,650,7.0,7.0,999,7.0
351,647,7.0,7.0,998,7.0
360,638,7.0,7.0,998,7.0
359,639,7.0,7.0,998,7.0
357,640,7.0,7.0,997,7.0
354,644,7.0,7.0,998,7.0
364,635,7.0,7.0,999,7.0
359,639,7.0,7.0,998,7.0
347,652,7.0,7.0,999,7.0
354,645,7.0,7.0,999,7.0
355,644,7.0,7.0,999,7.0
351,647,7.0,7.0,998,7.0
361,635,7.0,7.0,996,7.0
360,639,7.0,7.0,999,7.0
358,641,7.0,7.0,999,7.0
356,643,7.0,7.0,999,7.0
359,640,7.0,7.0,999,7.0
366,633,7.0,7.0,999,7.0
369,630,7.0,7.0,999,7.0
371,628,7.0,7.0,999,7.0
374,623,7.0,7.0,997,7.0
369,630,7.0,7.0,999,7.0
357,640,7.0,7.0,997,7.0
367,630,7.0,7.0,997,7.0
360,638,7.0,7.0,998,7.0
351,646,7.0,7.0,997,7.0
361,637,7.0,7.0,998,7.0
355,642,7.0,7.0,997,7.0
353,645,7.0,7.0,998,7.0
363,636,7.0,7.0,999,7.0
357,642,7.0,7.0,999,7.0
362,636,7.0,7.0,998,7.0
380,619,7.0,7.0,999,7.0
386,613,7.0,7.0,999,7.0
390,609,7.0,7.0,999,7.0
401,598,7.0,7.0,999,7.0
394,604,7.0,7.0,998,7.0
394,604,7.0,7.0,998,7.0
394,603,7.0,7.0,997,7.0
402,596,7.0,7.0,998,7.0
395,604,7.0,7.0,999,7.0
419,579,7.0,7.0,998,7.0
415,584,7.0,7.0,999,7.0
400,598,7.0,7.0,998,7.0
411,588,7.0,7.0,999,7.0
417,581,7.0,7.0,998,7.0
415,584,7.0,7.0,999,7.0
411,587,7.0,7.0,998,7.0
401,597,7.0,7.0,998,7.0
400,598,7.0,7.0,998,7.0
403,596,7.0,7.0,999,7.0
400,599,7.0,7.0,999,7.0
407,591,7.0,7.0,998,7.0
415,584,7.0,7.0,999,7.0
414,584,7.0,7.0,998,7.0
417,581,7.0,7.0,998,7.0
419,578,7.0,7.0,997,7.0
416,581,7.0,7.0,997,7.0
418,579,7.0,7.0,997,7.0
412,586,7.0,7.0,998,7.0
410,588,7.0,7.0,998,7.0
408,591,7.0,7.0,999,7.0
406,592,7.0,7.0,998,7.0
408,589,7.0,7.0,997,7.0
410,589,7.0,7.0,999,7.0
408,590,7.0,7.0,998,7.0
413,586,7.0,7.0,999,7.0
414,584,7.0,7.0,998,7.0
407,591,7.0,7.0,998,7.0
415,581,7.0,7.0,996,7.0
414,585,7.0,7.0,999,7.0
414,585,7.0,7.0,999,7.0
414,584,7.0,7.0,998,7.0
414,584,7.0,7.0,998,7.0
410,587,7.0,7.0,997,7.0
413,584,7.0,7.0,997,7.0
409,589,7.0,7.0,998,7.0
409,589,7.0,7.0,998,7.0
415,581,7.0,7.0,996,7.0
412,585,7.0,7.0,997,7.0
421,578,7.0,7.0,999,7.0
427,571,7.0,7.0,998,7.0
419,580,7.0,7.0,999,7.0
430,568,7.0,7.0,998,7.0
436,562,7.0,7.0,998,7.0
422,576,7.0,7.0,998,7.0
429,570,7.0,7.0,999,7.0
430,569,7.0,7.0,999,7.0
424,574,7.0,7.0,998,7.0
425,573,7.0,7.0,998,7.0
430,569,7.0,7.0,999,7.0
421,577,7.0,7.0,998,7.0
426,572,7.0,7.0,998,7.0
428,569,7.0,7.0,997,7.0
420,579,7.0,7.0,999,7.0
424,575,7.0,7.0,999,7.0
411,587,7.0,7.0,998,7.0
414,584,7.0,7.0,998,7.0
418,579,7.0,7.0,997,7.0
407,591,7.0,7.0,998,7.0
401,595,7.0,7.0,996,7.0
402,595,7.0,7.0,997,7.0
397,601,7.0,7.0,998,7.0
407,591,7.0,7.0,998,7.0
406,593,7.0,7.0,999,7.0
389,609,7.0,7.0,998,7.0
386,610,7.0,7.0,996,7.0
395,604,7.0,7.0,999,7.0
392,607,7.0,7.0,999,7.0
390,609,7.0,7.0,999,7.0
400,599,7.0,7.0,999,7.0
392,607,7.0,7.0,999,7.0
388,610,7.0,7.0,998,7.0
395,604,7.0,7.0,999,7.0
388,611,7.0,7.0,999,7.0
387,612,7.0,7.0,999,7.0
386,613,7.0,7.0,999,7.0
378,621,7.0,7.0,999,7.0
383,614,7.0,7.0,997,7.0
393,605,7.0,7.0,998,7.0
374,625,7.0,7.0,999,7.0
383,616,7.0,7.0,999,7.0
385,613,7.0,7.0,998,7.0
372,627,7.0,7.0,999,7.0
381,618,7.0,7.0,999,7.0
389,609,7.0,7.0,998,7.0
380,617,7.0,7.0,997,7.0
396,601,7.0,7.0,997,7.0
396,603,7.0,7.0,999,7.0
390,609,7.0,7.0,999,7.0
403,596,7.0,7.0,999,7.0
403,596,7.0,7.0,999,7.0
405,594,7.0,7.0,999,7.0
414,584,7.0,7.0,998,7.0
406,593,7.0,7.0,999,7.0
406,593,7.0,7.0,999,7.0
409,589,7.0,7.0,998,7.0
408,591,7.0,7.0,999,7.0
408,591,7.0,7.0,999,7.0
407,591,7.0,7.0,998,7.0
410,588,7.0,7.0,998,7.0
411,588,7.0,7.0,999,7.0
409,589,7.0,7.0,998,7.0
399,599,7.0,7.0,998,7.0
402,596,7.0,7.0,998,7.0
398,600,7.0,7.0,998,7.0
396,602,7.0,7.0,998,7.0
398,601,7.0,7.0,999,7.0
398,598,7.0,7.0,996,7.0
402,596,7.0,7.0,998,7.0
419,579,7.0,7.0,998,7.0
419,578,7.0,7.0,997,7.0
424,573,7.0,7.0,997,7.0
431,567,7.0,7.0,998,7.0
428,571,7.0,7.0,999,7.0
443,555,7.0,7.0,998,7.0
437,562,7.0,7.0,999,7.0
426,573,7.0,7.0,999,7.0
426,571,7.0,7.0,997,7.0
422,577,7.0,7.0,999,7.0
420,579,7.0,7.0,999,7.0
414,585,7.0,7.0,999,7.0
419,580,7.0,7.0,999,7.0
416,583,7.0,7.0,999,7.0
411,588,7.0,7.0,999,7.0
414,585,7.0,7.0,999,7.0
414,585,7.0,7.0,999,7.0
415,581,7.0,7.0,996,7.0
420,578,7.0,7.0,998,7.0
420,579,7.0,7.0,999,7.0
429,569,7.0,7.0,998,7.0
427,568,7.0,7.0,995,7.0
432,565,7.0,7.0,997,7.0
426,573,7.0,7.0,999,7.0
416,583,7.0,7.0,999,7.0
424,574,7.0,7.0,998,7.0
415,583,7.0,7.0,998,7.0
416,580,7.0,7.0,996,7.0
408,590,7.0,7.0,998,7.0
408,589,7.0,7.0,997,7.0
405,594,7.0,7.0,999,7.0
404,594,7.0,7.0,998,7.0
409,590,7.0,7.0,999,7.0
405,594,7.0,7.0,999,7.0
408,591,7.0,7.0,999,7.0
402,596,7.0,7.0,998,7.0
393,606,7.0,7.0,999,7.0
407,592,7.0,7.0,999,7.0
399,600,7.0,7.0,999,7.0
386,611,7.0,7.0,997,7.0
391,608,7.0,7.0,999,7.0
385,613,7.0,7.0,998,7.0
390,607,7.0,7.0,997,7.0
393,605,7.0,7.0,998,7.0
394,604,7.0,7.0,998,7.0
398,600,7.0,7.0,998,7.0
400,599,7.0,7.0,999,7.0
404,595,7.0,7.0,999,7.0
403,596,7.0,7.0,999,7.0
400,598,7.0,7.0,998,7.0
399,599,7.0,7.0,998,7.0
398,598,7.0,7.0,996,7.0
400,599,7.0,7.0,999,7.0
401,596,7.0,7.0,997,7.0
401,598,7.0,7.0,999,7.0
401,598,7.0,7.0,999,7.0
396,600,7.0,7.0,996,7.0
396,603,7.0,7.0,999,7.0
396,603,7.0,7.0,999,7.0
398,600,7.0,7.0,998,7.0
396,602,7.0,7.0,998,7.0
393,606,7.0,7.0,999,7.0
393,606,7.0,7.0,999,7.0
393,606,7.0,7.0,999,7.0
387,612,7.0,7.0,999,7.0
394,605,7.0,7.0,999,7.0
387,612,7.0,7.0,999,7.0
384,615,7.0,7.0,999,7.0
393,606,7.0,7.0,999,7.0
394,604,7.0,7.0,998,7.0
385,614,7.0,7.0,999,7.0
394,603,7.0,7.0,997,7.0
393,605,7.0,7.0,998,7.0
384,613,7.0,7.0,997,7.0
394,605,7.0,7.0,999,7.0
391,607,7.0,7.0,998,7.0
385,614,7.0,7.0,999,7.0
386,613,7.0,7.0,999,7.0
