forward_num,reverse_num,forward_rate,reverse_rate,organism_num,organism_rate
5,5,5.0,5.0,10,5.0
5,5,5.0,5.0,10,5.0
5,5,5.0,5.0,10,5.0
6,6,5.33333333333333,5.33333333333333,12,5.33333333333333
7,7,5.42857142857143,5.42857142857143,14,5.42857142857143
8,8,5.375,5.375,16,5.375
11,11,5.54545454545455,5.54545454545455,22,5.54545454545455
14,14,5.42857142857143,5.42857142857143,28,5.42857142857143
14,13,5.42857142857143,5.38461538461539,27,5.40740740740741
20,19,5.7,5.68421052631579,39,5.69230769230769
20,19,5.7,5.68421052631579,39,5.69230769230769
26,24,5.61538461538461,5.58333333333333,50,5.6
34,32,5.94117647058824,5.9375,66,5.93939393939394
38,36,5.84210526315789,5.83333333333333,74,5.83783783783784
48,44,5.75,5.72727272727273,92,5.73913043478261
64,60,6.0625,6.06666666666667,124,6.06451612903226
68,64,5.94117647058824,5.9375,132,5.93939393939394
92,72,5.8695652173913,5.83333333333333,164,5.85365853658537
124,116,6.16129032258065,6.17241379310345,240,6.16666666666667
124,116,6.16129032258065,6.17241379310345,240,6.16666666666667
124,116,6.16129032258065,6.17241379310345,240,6.16666666666667
248,232,6.16129032258065,6.17241379310345,480,6.16666666666667
248,232,6.16129032258065,6.17241379310345,480,6.16666666666667
247,232,6.15789473684211,6.17241379310345,479,6.16492693110647
438,361,6.37899543378995,6.46537396121884,799,6.4180225281602
470,435,6.28510638297872,6.32413793103448,905,6.30386740331492
484,456,6.20661157024793,6.2280701754386,940,6.21702127659574
556,443,6.33093525179856,6.28216704288939,999,6.30930930930931
543,455,6.30018416206261,6.28791208791209,998,6.29458917835671
574,425,6.22648083623693,6.29647058823529,999,6.25625625625626
574,425,6.2787456445993,6.31058823529412,999,6.29229229229229
588,411,6.27040816326531,6.27250608272506,999,6.27127127127127
563,435,6.2664298401421,6.25747126436782,998,6.2625250501002
578,420,6.28892733564014,6.29761904761905,998,6.29258517034068
582,417,6.3127147766323,6.29016786570743,999,6.3033033033033
581,418,6.34939759036145,6.2799043062201,999,6.32032032032032
602,397,6.37209302325581,6.34005037783375,999,6.35935935935936
592,407,6.375,6.36363636363636,999,6.37037037037037
602,396,6.35714285714286,6.36868686868687,998,6.36172344689379
610,387,6.37540983606557,6.37209302325581,997,6.3741223671013
595,401,6.36806722689076,6.38403990024938,996,6.37449799196787
604,395,6.3476821192053,6.3493670886076,999,6.34834834834835
607,391,6.34266886326194,6.35805626598466,998,6.34869739478958
602,397,6.35880398671096,6.38035264483627,999,6.36736736736737
592,407,6.34966216216216,6.3980343980344,999,6.36936936936937
603,393,6.37147595356551,6.38676844783715,996,6.37751004016064
593,406,6.36762225969646,6.38177339901478,999,6.37337337337337
587,412,6.37819420783646,6.3252427184466,999,6.35635635635636
593,406,6.41483979763912,6.32758620689655,999,6.37937937937938
596,403,6.3993288590604,6.36228287841191,999,6.38438438438438
615,382,6.42764227642276,6.34816753926702,997,6.39719157472417
615,384,6.43739837398374,6.3125,999,6.38938938938939
613,386,6.43719412724307,6.32901554404145,999,6.3953953953954
630,369,6.41746031746032,6.31436314363144,999,6.37937937937938
635,364,6.42362204724409,6.32142857142857,999,6.38638638638639
621,378,6.43961352657005,6.35185185185185,999,6.40640640640641
632,366,6.42879746835443,6.37431693989071,998,6.40881763527054
641,358,6.41965678627145,6.36312849162011,999,6.3993993993994
640,357,6.421875,6.40056022408964,997,6.41424272818455
642,357,6.45171339563863,6.40336134453782,999,6.43443443443443
645,354,6.45426356589147,6.40960451977401,999,6.43843843843844
646,352,6.46130030959752,6.40909090909091,998,6.44288577154309
643,354,6.45878693623639,6.42372881355932,997,6.44633901705115
633,364,6.45813586097946,6.40934065934066,997,6.44032096288867
636,363,6.4559748427673,6.40495867768595,999,6.43743743743744
630,369,6.46825396825397,6.42818428184282,999,6.45345345345345
629,368,6.47217806041335,6.40489130434783,997,6.44734202607823
633,365,6.49289099526066,6.37534246575343,998,6.4498997995992
627,372,6.5103668261563,6.38440860215054,999,6.46346346346346
627,372,6.52153110047847,6.38978494623656,999,6.47247247247247
629,370,6.51033386327504,6.4,999,6.46946946946947
625,374,6.5136,6.38770053475936,999,6.46646646646647
617,382,6.52836304700162,6.3979057591623,999,6.47847847847848
623,376,6.53932584269663,6.39095744680851,999,6.48348348348348
624,375,6.50801282051282,6.37066666666667,999,6.45645645645646
619,380,6.51373182552504,6.35789473684211,999,6.45445445445445
624,373,6.53365384615385,6.37533512064343,997,6.47442326980943
628,371,6.51114649681529,6.36927223719677,999,6.45845845845846
618,381,6.51941747572816,6.39370078740157,999,6.47147147147147
620,378,6.53225806451613,6.3968253968254,998,6.48096192384769
622,375,6.52090032154341,6.416,997,6.481444332999
620,378,6.51612903225806,6.45502645502645,998,6.49298597194389
625,373,6.5104,6.44772117962466,998,6.48697394789579
623,376,6.52969502407705,6.42553191489362,999,6.49049049049049
613,386,6.55138662316476,6.45336787564767,999,6.51351351351351
613,386,6.55628058727569,6.48445595854922,999,6.52852852852853
617,379,6.55915721231767,6.49604221635884,996,6.535140562249
610,386,6.55081967213115,6.46632124352332,996,6.51807228915663
608,390,6.56907894736842,6.49230769230769,998,6.53907815631263
608,391,6.57072368421053,6.48081841432225,999,6.53553553553554
606,392,6.55775577557756,6.47959183673469,998,6.52705410821643
613,383,6.56769983686786,6.48825065274151,996,6.53714859437751
604,395,6.5794701986755,6.50379746835443,999,6.54954954954955
609,390,6.58784893267652,6.4974358974359,999,6.55255255255255
603,396,6.58706467661692,6.50757575757576,999,6.55555555555556
592,407,6.58614864864865,6.49385749385749,999,6.54854854854855
590,409,6.59661016949153,6.49144254278729,999,6.55355355355355
583,415,6.61921097770154,6.50602409638554,998,6.57214428857715
573,424,6.61256544502618,6.5377358490566,997,6.58074222668004
573,426,6.61256544502618,6.53990610328638,999,6.58158158158158
577,421,6.61871750433276,6.50593824228029,998,6.57114228456914
575,424,6.61739130434783,6.50235849056604,999,6.56856856856857
578,421,6.60034602076125,6.5083135391924,999,6.56156156156156
570,429,6.59122807017544,6.52913752913753,999,6.56456456456456
568,431,6.60387323943662,6.50812064965197,999,6.56256256256256
570,429,6.60526315789474,6.52214452214452,999,6.56956956956957
573,426,6.58464223385689,6.50469483568075,999,6.55055055055055
569,429,6.59402460456942,6.51748251748252,998,6.56112224448898
565,434,6.60176991150442,6.51382488479263,999,6.56356356356356
572,426,6.61888111888112,6.52112676056338,998,6.57715430861723
584,415,6.59760273972603,6.56144578313253,999,6.58258258258258
578,420,6.60207612456747,6.55,998,6.58016032064128
579,419,6.60103626943005,6.55131264916468,998,6.58016032064128
573,426,6.60907504363002,6.55868544600939,999,6.58758758758759
573,424,6.6108202443281,6.56132075471698,997,6.58976930792377
570,427,6.62631578947368,6.56206088992974,997,6.5987963891675
578,419,6.63667820069204,6.57756563245823,997,6.61183550651956
572,425,6.6520979020979,6.57882352941176,997,6.62086258776329
568,431,6.65492957746479,6.59396751740139,999,6.62862862862863
556,439,6.66187050359712,6.59908883826879,995,6.63417085427136
551,448,6.66424682395644,6.62276785714286,999,6.64564564564565
552,447,6.68659420289855,6.60626398210291,999,6.65065065065065
547,451,6.69469835466179,6.61640798226164,998,6.65931863727455
554,445,6.68592057761733,6.62247191011236,999,6.65765765765766
561,436,6.68805704099822,6.60550458715596,997,6.65195586760281
564,435,6.69326241134752,6.60229885057471,999,6.65365365365365
560,437,6.68571428571429,6.60183066361556,997,6.64894684052156
567,431,6.68783068783069,6.60324825986079,998,6.65130260521042
560,438,6.70178571428571,6.59360730593607,998,6.65430861723447
562,437,6.70284697508897,6.59038901601831,999,6.65365365365365
564,434,6.69503546099291,6.61290322580645,998,6.65931863727455
559,439,6.70304114490161,6.59908883826879,998,6.65731462925852
568,430,6.68838028169014,6.6046511627907,998,6.65230460921844
577,422,6.6949740034662,6.6303317535545,999,6.66766766766767
568,431,6.69718309859155,6.61484918793504,999,6.66166166166166
580,419,6.69310344827586,6.59665871121718,999,6.65265265265265
573,426,6.69109947643979,6.61032863849765,999,6.65665665665666
578,421,6.71280276816609,6.61757719714964,999,6.67267267267267
565,433,6.71504424778761,6.60508083140878,998,6.66733466933868
566,432,6.71554770318021,6.61574074074074,998,6.67234468937876
568,431,6.72535211267606,6.62877030162413,999,6.68368368368368
571,427,6.7215411558669,6.64168618266979,998,6.687374749499
565,433,6.72920353982301,6.64203233256351,998,6.69138276553106
566,433,6.73851590106007,6.65127020785219,999,6.7007007007007
559,440,6.74239713774598,6.66363636363636,999,6.70770770770771
552,447,6.7445652173913,6.65995525727069,999,6.70670670670671
551,447,6.74410163339383,6.66890380313199,998,6.71042084168337
549,450,6.7431693989071,6.66666666666667,999,6.70870870870871
550,448,6.75454545454545,6.65178571428571,998,6.70841683366733
549,450,6.76502732240437,6.64888888888889,999,6.71271271271271
559,439,6.76207513416816,6.65603644646925,998,6.71543086172345
559,440,6.76744186046512,6.64545454545455,999,6.71371371371371
558,440,6.76702508960573,6.65227272727273,998,6.71643286573146
561,438,6.76827094474153,6.64155251141552,999,6.71271271271271
555,443,6.77477477477477,6.65462753950339,998,6.72144288577154
556,443,6.7841726618705,6.67268623024831,999,6.73473473473473
554,442,6.78519855595668,6.68099547511312,996,6.73895582329317
562,436,6.79181494661922,6.6697247706422,998,6.73847695390782
573,425,6.79406631762653,6.66117647058824,998,6.7374749498998
579,420,6.78929188255613,6.67142857142857,999,6.73973973973974
577,422,6.79549393414211,6.68483412322275,999,6.74874874874875
570,428,6.79298245614035,6.69158878504673,998,6.74949899799599
561,438,6.7843137254902,6.66666666666667,999,6.73273273273273
561,435,6.79144385026738,6.65977011494253,996,6.73393574297189
568,429,6.79401408450704,6.65268065268065,997,6.73319959879639
560,437,6.80178571428571,6.67276887871854,997,6.74523570712136
551,448,6.81125226860254,6.66741071428571,999,6.74674674674675
567,432,6.81657848324515,6.67824074074074,999,6.75675675675676
567,430,6.81834215167548,6.69302325581395,997,6.76429287863591
569,430,6.81370826010545,6.71162790697674,999,6.76976976976977
574,425,6.81184668989547,6.68705882352941,999,6.75875875875876
571,427,6.8231173380035,6.69320843091335,998,6.76753507014028
578,419,6.82525951557093,6.71121718377088,997,6.77733199598796
582,416,6.82302405498282,6.70192307692308,998,6.77254509018036
572,427,6.82517482517482,6.70257611241218,999,6.77277277277277
567,427,6.82363315696649,6.70725995316159,994,6.77364185110664
585,413,6.82393162393162,6.70217917675545,998,6.77354709418838
591,406,6.81725888324873,6.69704433497537,997,6.76830491474423
589,409,6.82173174872666,6.70904645476773,998,6.77555110220441
585,414,6.82222222222222,6.70772946859903,999,6.77477477477477
575,424,6.81913043478261,6.70754716981132,999,6.77177177177177
576,422,6.81944444444444,6.71563981042654,998,6.77555110220441
582,416,6.83161512027491,6.69230769230769,998,6.77354709418838
580,418,6.82758620689655,6.6866028708134,998,6.7685370741483
580,419,6.82931034482759,6.68973747016706,999,6.77077077077077
577,420,6.83535528596187,6.6952380952381,997,6.77632898696088
578,418,6.84429065743945,6.70813397129187,996,6.78714859437751
587,411,6.85008517887564,6.70316301703163,998,6.78957915831663
588,410,6.84353741496599,6.70487804878049,998,6.78657314629258
592,407,6.84628378378378,6.7027027027027,999,6.78778778778779
585,414,6.84615384615385,6.68357487922705,999,6.77877877877878
590,404,6.83898305084746,6.70792079207921,994,6.78571428571429
593,404,6.83473861720067,6.69059405940594,997,6.77632898696088
596,401,6.84395973154362,6.70324189526185,997,6.78736208625878
600,398,6.84166666666667,6.7286432160804,998,6.79659318637275
602,397,6.82724252491694,6.73047858942066,999,6.78878878878879
606,393,6.83663366336634,6.71246819338422,999,6.78778778778779
610,389,6.82786885245902,6.70694087403599,999,6.78078078078078
612,387,6.8218954248366,6.72609819121447,999,6.78478478478478
605,392,6.81487603305785,6.72959183673469,997,6.78134403209629
602,396,6.81395348837209,6.7020202020202,998,6.76953907815631
597,402,6.81239530988275,6.71641791044776,999,6.77377377377377
608,391,6.80263157894737,6.72634271099744,999,6.77277277277277
601,397,6.80698835274542,6.75314861460957,998,6.78557114228457
592,406,6.80405405405405,6.73891625615764,998,6.77755511022044
597,398,6.80402010050251,6.73618090452261,995,6.77688442211055
594,405,6.79461279461279,6.75308641975309,999,6.77777777777778
592,405,6.79054054054054,6.75802469135802,997,6.77733199598796
598,401,6.7876254180602,6.73815461346633,999,6.76776776776777
598,401,6.78595317725753,6.75062344139651,999,6.77177177177177
598,401,6.78428093645485,6.75810473815461,999,6.77377377377377
600,398,6.78,6.75879396984925,998,6.77154308617235
589,407,6.78268251273345,6.75429975429975,996,6.7710843373494
592,407,6.79560810810811,6.76167076167076,999,6.78178178178178
595,404,6.8,6.76980198019802,999,6.78778778778779
591,406,6.78172588832487,6.79064039408867,997,6.78535606820461
592,407,6.78209459459459,6.78378378378378,999,6.78278278278278
602,397,6.78737541528239,6.78589420654912,999,6.78678678678679
597,401,6.77721943048576,6.77805486284289,998,6.77755511022044
604,395,6.76158940397351,6.77974683544304,999,6.76876876876877
608,391,6.76644736842105,6.76726342710997,999,6.76676676676677
603,395,6.76948590381426,6.78227848101266,998,6.77454909819639
608,390,6.76644736842105,6.78205128205128,998,6.77254509018036
608,391,6.77960526315789,6.79028132992327,999,6.78378378378378
592,405,6.77364864864865,6.79753086419753,997,6.78335005015045
593,405,6.76897133220911,6.79259259259259,998,6.77855711422846
606,393,6.76567656765677,6.79643765903308,999,6.77777777777778
597,399,6.75376884422111,6.83208020050125,996,6.785140562249
595,404,6.7546218487395,6.83415841584158,999,6.78678678678679
591,406,6.74957698815567,6.82758620689655,997,6.78134403209629
600,399,6.74166666666667,6.84210526315789,999,6.78178178178178
593,405,6.74536256323777,6.83703703703704,998,6.78256513026052
593,406,6.74030354131535,6.83990147783251,999,6.78078078078078
593,406,6.73355817875211,6.83743842364532,999,6.77577577577578
595,403,6.73949579831933,6.84367245657568,998,6.7815631262525
588,411,6.73469387755102,6.85158150851581,999,6.78278278278278
585,412,6.74358974358974,6.8495145631068,997,6.78736208625878
593,406,6.73861720067454,6.84975369458128,999,6.78378378378378
591,408,6.74957698815567,6.85294117647059,999,6.79179179179179
590,409,6.74915254237288,6.85330073349633,999,6.79179179179179
591,408,6.74450084602369,6.8578431372549,999,6.79079079079079
587,411,6.74787052810903,6.85888077858881,998,6.7935871743487
585,414,6.74529914529915,6.84541062801932,999,6.78678678678679
579,419,6.75993091537133,6.86634844868735,998,6.80460921843687
577,422,6.74696707105719,6.86729857819905,999,6.7977977977978
572,427,6.75699300699301,6.88992974238876,999,6.81381381381381
579,420,6.75993091537133,6.89047619047619,999,6.81481481481481
576,422,6.76215277777778,6.88625592417062,998,6.81462925851703
575,423,6.76173913043478,6.8936170212766,998,6.81763527054108
584,414,6.75856164383562,6.89613526570048,998,6.81563126252505
581,418,6.75903614457831,6.89952153110048,999,6.81781781781782
579,419,6.75647668393782,6.90453460620525,998,6.8186372745491
581,418,6.75559380378658,6.90909090909091,999,6.81981981981982
579,418,6.74956822107081,6.91387559808612,997,6.81845536609829
576,422,6.74479166666667,6.91706161137441,998,6.81763527054108
576,423,6.74479166666667,6.9290780141844,999,6.82282282282282
568,429,6.75176056338028,6.93006993006993,997,6.82848545636911
559,438,6.75134168157424,6.9337899543379,997,6.83149448345035
569,429,6.7609841827768,6.94638694638695,998,6.84068136272545
576,423,6.75868055555556,6.94562647754137,999,6.83783783783784
582,416,6.76288659793814,6.94471153846154,998,6.83867735470942
593,406,6.76053962900506,6.94827586206897,999,6.83683683683684
593,404,6.76391231028668,6.9529702970297,997,6.84052156469408
604,394,6.77152317880795,6.9492385786802,998,6.84168336673347
609,390,6.76683087027915,6.95128205128205,999,6.83883883883884
601,398,6.76871880199667,6.95226130653266,999,6.84184184184184
601,398,6.77703826955075,6.94974874371859,999,6.84584584584585
623,375,6.78330658105939,6.94666666666667,998,6.84468937875751
618,380,6.77993527508091,6.95,998,6.84468937875751
616,383,6.78733766233766,6.94778067885118,999,6.84884884884885
629,369,6.79650238473768,6.93766937669377,998,6.84869739478958
624,375,6.79326923076923,6.94133333333333,999,6.84884884884885
616,380,6.79383116883117,6.93947368421053,996,6.84939759036145
630,369,6.7968253968254,6.93766937669377,999,6.84884884884885
628,369,6.79458598726115,6.92953929539295,997,6.84453360080241
630,367,6.79206349206349,6.93188010899183,997,6.84353059177533
631,367,6.80031695721078,6.93732970027248,998,6.85070140280561
627,370,6.79744816586922,6.93243243243243,997,6.84754262788365
613,383,6.80750407830343,6.93211488250653,996,6.85542168674699
614,385,6.81596091205212,6.93246753246753,999,6.86086086086086
603,394,6.81923714759536,6.93401015228426,997,6.86459378134403
602,395,6.80897009966777,6.93164556962025,997,6.85757271815446
605,392,6.81652892561983,6.93622448979592,997,6.86359077231695
597,402,6.82412060301507,6.94029850746269,999,6.87087087087087
601,398,6.82529118136439,6.93718592964824,999,6.86986986986987
604,395,6.8294701986755,6.92911392405063,999,6.86886886886887
603,394,6.83250414593698,6.93654822335025,997,6.87362086258776
620,379,6.84193548387097,6.93403693931398,999,6.87687687687688
616,382,6.84253246753247,6.93717277486911,998,6.87875751503006
606,392,6.84158415841584,6.93112244897959,998,6.87675350701403
614,384,6.84201954397394,6.9375,998,6.87875751503006
593,404,6.82967959527825,6.94059405940594,997,6.87462387161484
588,411,6.82312925170068,6.9367396593674,999,6.86986986986987
586,413,6.82252559726962,6.94915254237288,999,6.87487487487487
582,417,6.81099656357388,6.94244604316547,999,6.86586586586587
582,417,6.80927835051546,6.93525179856115,999,6.86186186186186
583,416,6.81303602058319,6.93990384615385,999,6.86586586586587
579,419,6.81001727115717,6.93078758949881,998,6.86072144288577
585,414,6.81538461538462,6.92753623188406,999,6.86186186186186
583,415,6.81646655231561,6.92771084337349,998,6.8627254509018
578,419,6.81141868512111,6.93317422434368,997,6.86258776328987
595,404,6.81848739495798,6.93316831683168,999,6.86486486486486
590,409,6.82881355932203,6.93154034229829,999,6.87087087087087
597,402,6.82579564489112,6.93283582089552,999,6.86886886886887
609,390,6.82758620689655,6.93846153846154,999,6.87087087087087
605,393,6.83471074380165,6.93638676844784,998,6.874749498998
603,394,6.82421227197347,6.93401015228426,997,6.86760280842528
616,382,6.81818181818182,6.93455497382199,998,6.8627254509018
608,391,6.80592105263158,6.94373401534527,999,6.85985985985986
609,389,6.80459770114942,6.94087403598972,998,6.85771543086172
610,389,6.7983606557377,6.9305912596401,999,6.84984984984985
600,399,6.79666666666667,6.92731829573935,999,6.84884884884885
605,393,6.80330578512397,6.93129770992366,998,6.85370741482966
609,388,6.80623973727422,6.92783505154639,997,6.85356068204614
596,402,6.80201342281879,6.92537313432836,998,6.85170340681363
601,396,6.80033277870216,6.93181818181818,997,6.85255767301906
603,396,6.80928689883914,6.93686868686869,999,6.85985985985986
596,402,6.80536912751678,6.93532338308458,998,6.85771543086172
602,396,6.79900332225914,6.92929292929293,998,6.85070140280561
598,400,6.81103678929766,6.9325,998,6.85971943887776
594,405,6.80808080808081,6.93086419753086,999,6.85785785785786
595,404,6.81512605042017,6.93316831683168,999,6.86286286286286
593,406,6.81956155143339,6.92610837438424,999,6.86286286286286
586,413,6.81740614334471,6.92493946731235,999,6.86186186186186
593,406,6.81112984822934,6.91871921182266,999,6.85485485485485
593,405,6.80775716694772,6.92098765432099,998,6.85370741482966
593,406,6.80944350758853,6.91379310344828,999,6.85185185185185
587,412,6.80408858603066,6.91747572815534,999,6.85085085085085
589,408,6.81154499151104,6.91911764705882,997,6.8555667001003
595,403,6.82352941176471,6.92059553349876,998,6.8627254509018
594,404,6.81818181818182,6.93316831683168,998,6.86472945891784
598,401,6.81939799331104,6.93516209476309,999,6.86586586586587
603,395,6.81260364842454,6.93670886075949,998,6.86172344689379
597,402,6.8107202680067,6.93532338308458,999,6.86086086086086
602,396,6.80564784053156,6.94444444444444,998,6.86072144288577
613,385,6.81402936378467,6.94285714285714,998,6.86372745490982
610,388,6.81803278688525,6.94072164948454,998,6.86573146292585
615,382,6.82439024390244,6.93717277486911,997,6.86760280842528
607,392,6.81878088962109,6.93622448979592,999,6.86486486486486
597,399,6.80904522613065,6.94987468671679,996,6.86546184738956
601,398,6.81364392678869,6.94723618090452,999,6.86686686686687
597,401,6.82579564489112,6.94763092269327,998,6.874749498998
600,399,6.82666666666667,6.95488721804511,999,6.87787787787788
600,397,6.83333333333333,6.94710327455919,997,6.87863590772317
598,400,6.83444816053512,6.95,998,6.88076152304609
605,394,6.82809917355372,6.9492385786802,999,6.87587587587588
611,388,6.83469721767594,6.94587628865979,999,6.87787787787788
608,391,6.83717105263158,6.9462915601023,999,6.87987987987988
610,388,6.82950819672131,6.94072164948454,998,6.87274549098196
610,388,6.83114754098361,6.93814432989691,998,6.87274549098196
601,396,6.8369384359401,6.93434343434343,997,6.87562688064193
602,396,6.83388704318937,6.93434343434343,998,6.87374749498998
603,396,6.83416252072969,6.93939393939394,999,6.87587587587588
596,402,6.83892617449664,6.94278606965174,998,6.88076152304609
587,411,6.83986371379898,6.93917274939173,998,6.88076152304609
590,408,6.83050847457627,6.94362745098039,998,6.87675350701403
594,403,6.83501683501683,6.93796526054591,997,6.87662988966901
587,411,6.83645655877342,6.93187347931873,998,6.87575150300601
583,415,6.82847341337907,6.93253012048193,998,6.87174348697395
577,421,6.83362218370884,6.92874109263658,998,6.87374749498998
580,419,6.82931034482759,6.92840095465394,999,6.87087087087087
574,424,6.82404181184669,6.92924528301887,998,6.8687374749499
584,414,6.83047945205479,6.93961352657005,998,6.87575150300601
575,424,6.83304347826087,6.94339622641509,999,6.87987987987988
576,422,6.83333333333333,6.94549763033175,998,6.88076152304609
593,406,6.83136593591906,6.95566502463054,999,6.88188188188188
588,410,6.84183673469388,6.95609756097561,998,6.88877755511022
582,416,6.84364261168385,6.95432692307692,998,6.88977955911824
580,419,6.84310344827586,6.94749403341289,999,6.88688688688689
588,410,6.84183673469388,6.95853658536585,998,6.88977955911824
588,411,6.84523809523809,6.95863746958637,999,6.89189189189189
588,410,6.85374149659864,6.96341463414634,998,6.89879759519038
595,404,6.8453781512605,6.96287128712871,999,6.89289289289289
590,406,6.84745762711864,6.96059113300493,996,6.89357429718875
596,403,6.84395973154362,6.96277915632754,999,6.89189189189189
598,401,6.8494983277592,6.96259351620948,999,6.89489489489489
609,389,6.85878489326765,6.97172236503856,998,6.90280561122244
613,386,6.86460032626427,6.96891191709845,999,6.9049049049049
607,392,6.85996705107084,6.97448979591837,999,6.9049049049049
612,386,6.86111111111111,6.97927461139896,998,6.90681362725451
602,397,6.87043189368771,6.97984886649874,999,6.91391391391391
592,407,6.86655405405405,6.98525798525799,999,6.91491491491491
601,396,6.86688851913478,6.98737373737374,997,6.91474423269809
607,392,6.8665568369028,6.98979591836735,999,6.91491491491491
604,394,6.86423841059603,6.98730964467005,998,6.91282565130261
606,393,6.86303630363036,6.98727735368957,999,6.91191191191191
602,395,6.86212624584718,6.98987341772152,997,6.91273821464393
602,397,6.85880398671096,6.98992443324937,999,6.91091091091091
606,392,6.85643564356436,6.98979591836735,998,6.90881763527054
612,387,6.85294117647059,6.9922480620155,999,6.90690690690691
619,380,6.8578352180937,6.9921052631579,999,6.90890890890891
613,386,6.85970636215334,6.99222797927461,999,6.91091091091091
618,381,6.85922330097087,6.99212598425197,999,6.90990990990991
618,381,6.86245954692557,6.99475065616798,999,6.91291291291291
628,369,6.85987261146497,6.99457994579946,997,6.90972918756269
630,369,6.86349206349206,6.99457994579946,999,6.91191191191191
625,374,6.8544,7.0,999,6.90890890890891
625,373,6.8592,7.0,998,6.91182364729459
621,378,6.86312399355878,7.0,999,6.91491491491491
619,378,6.8529886914378,7.0,997,6.90872617853561
617,381,6.85089141004862,7.0,998,6.90781563126253
619,380,6.8546042003231,7.0,999,6.90990990990991
617,381,6.84602917341977,7.0,998,6.90480961923848
616,383,6.8474025974026,7.0,999,6.90590590590591
615,384,6.85853658536585,7.0,999,6.91291291291291
610,389,6.85737704918033,7.0,999,6.91291291291291
607,392,6.85667215815486,7.0,999,6.91291291291291
604,394,6.85430463576159,7.0,998,6.91182364729459
612,386,6.8562091503268,7.0,998,6.91182364729459
615,384,6.86016260162602,7.0,999,6.91391391391391
618,380,6.86084142394822,7.0,998,6.91382765531062
618,381,6.85922330097087,7.0,999,6.91291291291291
614,385,6.8599348534202,7.0,999,6.91391391391391
611,388,6.8494271685761,7.0,999,6.90790790790791
619,380,6.8578352180937,7.0,999,6.91191191191191
615,383,6.8520325203252,7.0,998,6.90881763527054
618,381,6.85113268608414,7.0,999,6.90790790790791
622,377,6.85209003215434,7.0,999,6.90790790790791
617,382,6.85413290113452,7.0,999,6.90990990990991
619,380,6.84652665589661,7.0,999,6.9049049049049
626,372,6.84185303514377,7.0,998,6.90080160320641
629,370,6.85214626391097,7.0,999,6.90690690690691
625,373,6.8576,7.0,998,6.91082164328657
624,373,6.85576923076923,7.0,997,6.90972918756269
614,382,6.8599348534202,7.0,996,6.9136546184739
614,383,6.85016286644951,7.0,997,6.90772316950853
624,375,6.84935897435897,7.0,999,6.90590590590591
615,384,6.85691056910569,7.0,999,6.91191191191191
609,387,6.86042692939245,7.0,996,6.91465863453815
612,387,6.86111111111111,7.0,999,6.91491491491491
620,379,6.85967741935484,7.0,999,6.91291291291291
619,379,6.8546042003231,7.0,998,6.90981963927856
622,376,6.85048231511254,7.0,998,6.90681362725451
615,383,6.85528455284553,7.0,998,6.91082164328657
614,384,6.86156351791531,7.0,998,6.91482965931864
610,389,6.86393442622951,7.0,999,6.91691691691692
613,386,6.84502446982055,7.0,999,6.9049049049049
621,378,6.84863123993559,7.0,999,6.90590590590591
619,378,6.84491114701131,7.0,997,6.9037111334002
623,376,6.83948635634029,7.0,999,6.8998998998999
620,379,6.84516129032258,7.0,999,6.9039039039039
616,383,6.85714285714286,7.0,999,6.91191191191191
619,380,6.8546042003231,7.0,999,6.90990990990991
618,381,6.84466019417476,7.0,999,6.9039039039039
615,382,6.8520325203252,7.0,997,6.90872617853561
615,383,6.85691056910569,7.0,998,6.91182364729459
613,386,6.86133768352365,7.0,999,6.91491491491491
609,387,6.8752052545156,7.0,996,6.92369477911647
610,389,6.87540983606557,7.0,999,6.92392392392392
612,386,6.88235294117647,7.0,998,6.92785571142285
615,383,6.88617886178862,7.0,998,6.92985971943888
620,379,6.88064516129032,7.0,999,6.92592592592593
621,378,6.88566827697263,7.0,999,6.92892892892893
622,377,6.88745980707395,7.0,999,6.92992992992993
625,374,6.8896,7.0,999,6.93093093093093
624,374,6.88461538461539,7.0,998,6.92785571142285
633,365,6.87993680884676,7.0,998,6.92384769539078
633,365,6.87677725118483,7.0,998,6.92184368737475
631,366,6.8811410459588,7.0,997,6.92477432296891
636,362,6.88364779874214,7.0,998,6.92585170340681
639,360,6.8810641627543,7.0,999,6.92392392392392
643,354,6.88491446345257,7.0,997,6.92577733199599
645,353,6.88062015503876,7.0,998,6.92284569138277
635,363,6.8755905511811,7.0,998,6.92084168336673
643,355,6.87713841368585,7.0,998,6.92084168336673
640,357,6.875,7.0,997,6.9197592778335
634,364,6.87697160883281,7.0,998,6.92184368737475
637,361,6.8712715855573,7.0,998,6.91783567134269
631,366,6.87638668779715,7.0,997,6.92176529588766
631,366,6.8811410459588,7.0,997,6.92477432296891
636,361,6.87735849056604,7.0,997,6.92176529588766
632,365,6.87974683544304,7.0,997,6.92377131394183
629,370,6.88235294117647,7.0,999,6.92592592592593
625,374,6.8864,7.0,999,6.92892892892893
624,372,6.88461538461539,7.0,996,6.92771084337349
616,381,6.88474025974026,7.0,997,6.92878635907723
613,385,6.88417618270799,7.0,998,6.92885771543086
616,381,6.87987012987013,7.0,997,6.92577733199599
616,383,6.87337662337662,7.0,999,6.92192192192192
613,386,6.87765089722675,7.0,999,6.92492492492492
616,381,6.88961038961039,7.0,997,6.93179538615848
618,380,6.88025889967638,7.0,998,6.92585170340681
615,383,6.88943089430894,7.0,998,6.93186372745491
613,385,6.89396411092985,7.0,998,6.93486973947896
607,392,6.89456342668863,7.0,999,6.93593593593594
609,390,6.89655172413793,7.0,999,6.93693693693694
607,392,6.89621087314662,7.0,999,6.93693693693694
602,396,6.90033222591362,7.0,998,6.93987975951904
609,390,6.89819376026273,7.0,999,6.93793793793794
610,389,6.89672131147541,7.0,999,6.93693693693694
608,390,6.89638157894737,7.0,998,6.93687374749499
608,391,6.90296052631579,7.0,999,6.94094094094094
603,395,6.90049751243781,7.0,998,6.93987975951904
607,392,6.89785831960461,7.0,999,6.93793793793794
602,396,6.90199335548173,7.0,998,6.94088176352705
601,397,6.89683860232945,7.0,998,6.93787575150301
608,390,6.89309210526316,7.0,998,6.93486973947896
601,396,6.89351081530782,7.0,997,6.9358074222668
604,395,6.89569536423841,7.0,999,6.93693693693694
604,395,6.89735099337748,7.0,999,6.93793793793794
606,393,6.8976897689769,7.0,999,6.93793793793794
595,404,6.90084033613445,7.0,999,6.94094094094094
609,388,6.89655172413793,7.0,997,6.93681043129388
612,386,6.89542483660131,7.0,998,6.93587174348697
609,390,6.89983579638752,7.0,999,6.93893893893894
622,377,6.88906752411576,7.0,999,6.93093093093093
617,382,6.89465153970827,7.0,999,6.93493493493493
615,383,6.89756097560976,7.0,998,6.93687374749499
614,385,6.8957654723127,7.0,999,6.93593593593594
622,375,6.89067524115756,7.0,997,6.93179538615848
620,379,6.88387096774194,7.0,999,6.92792792792793
619,379,6.88529886914378,7.0,998,6.92885771543086
626,371,6.88019169329073,7.0,997,6.92477432296891
627,372,6.87878787878788,7.0,999,6.92392392392392
631,368,6.87797147385103,7.0,999,6.92292292292292
627,370,6.87400318979266,7.0,997,6.92076228686058
629,369,6.87440381558029,7.0,998,6.92084168336673
636,362,6.87578616352201,7.0,998,6.92084168336673
633,366,6.87361769352291,7.0,999,6.91991991991992
627,372,6.87878787878788,7.0,999,6.92392392392392
625,371,6.8784,7.0,996,6.92369477911647
615,384,6.88292682926829,7.0,999,6.92792792792793
617,382,6.88168557536467,7.0,999,6.92692692692693
622,376,6.88906752411576,7.0,998,6.93086172344689
615,384,6.88455284552846,7.0,999,6.92892892892893
624,374,6.88141025641026,7.0,998,6.92585170340681
629,368,6.88235294117647,7.0,997,6.92577733199599
634,365,6.88328075709779,7.0,999,6.92592592592593
633,365,6.88783570300158,7.0,998,6.92885771543086
641,358,6.88767550702028,7.0,999,6.92792792792793
640,359,6.8890625,7.0,999,6.92892892892893
644,353,6.88819875776398,7.0,997,6.92778335005015
638,361,6.89028213166144,7.0,999,6.92992992992993
635,364,6.89133858267717,7.0,999,6.93093093093093
629,370,6.89507154213037,7.0,999,6.93393393393393
632,367,6.90189873417722,7.0,999,6.93793793793794
626,372,6.90415335463259,7.0,998,6.93987975951904
624,375,6.89903846153846,7.0,999,6.93693693693694
630,369,6.90634920634921,7.0,999,6.94094094094094
631,367,6.90174326465927,7.0,998,6.93787575150301
626,372,6.90255591054313,7.0,998,6.93887775551102
626,372,6.90575079872204,7.0,998,6.94088176352705
624,374,6.90384615384615,7.0,998,6.93987975951904
622,373,6.89871382636656,7.0,995,6.93668341708543
632,366,6.9003164556962,7.0,998,6.93687374749499
630,369,6.90634920634921,7.0,999,6.94094094094094
631,366,6.89857369255151,7.0,997,6.9358074222668
640,359,6.903125,7.0,999,6.93793793793794
629,369,6.89984101748808,7.0,998,6.93687374749499
629,370,6.89030206677266,7.0,999,6.93093093093093
631,367,6.88906497622821,7.0,998,6.92985971943888
620,377,6.89193548387097,7.0,997,6.93279839518556
624,375,6.88942307692308,7.0,999,6.93093093093093
620,379,6.89354838709677,7.0,999,6.93393393393393
618,380,6.8915857605178,7.0,998,6.93286573146293
613,385,6.89559543230016,7.0,998,6.93587174348697
604,394,6.90066225165563,7.0,998,6.93987975951904
603,396,6.90381426202322,7.0,999,6.94194194194194
602,397,6.90863787375415,7.0,999,6.94494494494494
602,395,6.90863787375415,7.0,997,6.94483450351053
608,391,6.91118421052632,7.0,999,6.94594594594595
612,386,6.90359477124183,7.0,998,6.94088176352705
610,389,6.89836065573771,7.0,999,6.93793793793794
611,387,6.90180032733224,7.0,998,6.93987975951904
612,386,6.90196078431373,7.0,998,6.93987975951904
605,391,6.89917355371901,7.0,996,6.93875502008032
600,398,6.91,7.0,998,6.94589178356713
614,385,6.91205211726384,7.0,999,6.94594594594595
600,399,6.915,7.0,999,6.94894894894895
605,394,6.91900826446281,7.0,999,6.95095095095095
608,389,6.92105263157895,7.0,997,6.9518555667001
605,393,6.92066115702479,7.0,998,6.95190380761523
609,389,6.92775041050903,7.0,998,6.95591182364729
622,377,6.92765273311897,7.0,999,6.95495495495495
629,370,6.93322734499205,7.0,999,6.95795795795796
630,367,6.93650793650794,7.0,997,6.95987963891675
630,368,6.93333333333333,7.0,998,6.95791583166333
637,361,6.9309262166405,7.0,998,6.95591182364729
635,364,6.92755905511811,7.0,999,6.95395395395395
623,375,6.93418940609952,7.0,998,6.95891783567134
625,372,6.9328,7.0,997,6.95787362086259
618,380,6.92718446601942,7.0,998,6.95490981963928
618,378,6.92394822006472,7.0,996,6.95281124497992
613,386,6.92985318107667,7.0,999,6.95695695695696
612,385,6.93464052287582,7.0,997,6.95987963891675
601,394,6.94342762063228,7.0,995,6.96582914572864
604,395,6.95198675496689,7.0,999,6.97097097097097
601,397,6.95008319467554,7.0,998,6.96993987975952
602,397,6.95182724252492,7.0,999,6.97097097097097
597,402,6.94974874371859,7.0,999,6.96996996996997
601,398,6.94509151414309,7.0,999,6.96696696696697
595,402,6.94621848739496,7.0,997,6.9679037111334
592,406,6.94932432432432,7.0,998,6.96993987975952
596,403,6.94463087248322,7.0,999,6.96696696696697
597,400,6.94472361809045,7.0,997,6.96690070210632
597,402,6.9463986599665,7.0,999,6.96796796796797
592,406,6.94256756756757,7.0,998,6.96593186372746
597,401,6.93802345058626,7.0,998,6.96292585170341
594,405,6.94276094276094,7.0,999,6.96596596596597
591,408,6.9424703891709,7.0,999,6.96596596596597
590,409,6.93728813559322,7.0,999,6.96296296296296
582,417,6.93470790378007,7.0,999,6.96196196196196
576,423,6.9375,7.0,999,6.96396396396396
578,420,6.93771626297578,7.0,998,6.96392785571142
583,416,6.92967409948542,7.0,999,6.95895895895896
598,401,6.92809364548495,7.0,999,6.95695695695696
594,405,6.92424242424242,7.0,999,6.95495495495495
589,409,6.92190152801358,7.0,998,6.95390781563126
587,412,6.91822827938671,7.0,999,6.95195195195195
585,414,6.92478632478633,7.0,999,6.95595595595596
583,414,6.92109777015437,7.0,997,6.95386158475426
579,419,6.92227979274611,7.0,998,6.95490981963928
571,428,6.9246935201401,7.0,999,6.95695695695696
575,424,6.92173913043478,7.0,999,6.95495495495495
574,425,6.91811846689895,7.0,999,6.95295295295295
572,426,6.92132867132867,7.0,998,6.95490981963928
576,423,6.92361111111111,7.0,999,6.95595595595596
580,418,6.91724137931034,7.0,998,6.95190380761523
576,422,6.92708333333333,7.0,998,6.95791583166333
581,417,6.92598967297763,7.0,998,6.95691382765531
575,424,6.92173913043478,7.0,999,6.95495495495495
576,423,6.92361111111111,7.0,999,6.95595595595596
583,416,6.92967409948542,7.0,999,6.95895895895896
581,418,6.92943201376936,7.0,999,6.95895895895896
583,416,6.93138936535163,7.0,999,6.95995995995996
580,418,6.92931034482759,7.0,998,6.95891783567134
580,419,6.93275862068965,7.0,999,6.96096096096096
588,410,6.93367346938776,7.0,998,6.96092184368737
582,417,6.93298969072165,7.0,999,6.96096096096096
579,419,6.93782383419689,7.0,998,6.96392785571142
572,427,6.93356643356643,7.0,999,6.96196196196196
562,437,6.9270462633452,7.0,999,6.95895895895896
574,425,6.93205574912892,7.0,999,6.96096096096096
581,418,6.92943201376936,7.0,999,6.95895895895896
575,424,6.92869565217391,7.0,999,6.95895895895896
572,427,6.92832167832168,7.0,999,6.95895895895896
581,416,6.92943201376936,7.0,997,6.95887662988967
581,418,6.92771084337349,7.0,999,6.95795795795796
588,411,6.93367346938776,7.0,999,6.96096096096096
579,420,6.93609671848014,7.0,999,6.96296296296296
589,410,6.93718166383701,7.0,999,6.96296296296296
592,406,6.93581081081081,7.0,998,6.96192384769539
587,410,6.93696763202726,7.0,997,6.96288866599799
593,406,6.93929173693086,7.0,999,6.96396396396396
608,391,6.93585526315789,7.0,999,6.96096096096096
600,398,6.94166666666667,7.0,998,6.96492985971944
604,395,6.94370860927152,7.0,999,6.96596596596597
601,398,6.95174708818636,7.0,999,6.97097097097097
587,411,6.95059625212947,7.0,998,6.97094188376754
586,412,6.94880546075085,7.0,998,6.96993987975952
583,413,6.94682675814751,7.0,996,6.96887550200803
587,412,6.93696763202726,7.0,999,6.96296296296296
584,413,6.93835616438356,7.0,997,6.96389167502508
583,416,6.93825042881647,7.0,999,6.96396396396396
576,421,6.93402777777778,7.0,997,6.96188565697091
580,418,6.93275862068965,7.0,998,6.96092184368737
584,414,6.93150684931507,7.0,998,6.95991983967936
578,421,6.93771626297578,7.0,999,6.96396396396396
576,423,6.93402777777778,7.0,999,6.96196196196196
574,424,6.93205574912892,7.0,998,6.96092184368737
586,413,6.93515358361775,7.0,999,6.96196196196196
589,409,6.93039049235993,7.0,998,6.95891783567134
596,403,6.93288590604027,7.0,999,6.95995995995996
611,388,6.93453355155483,7.0,999,6.95995995995996
610,386,6.94098360655738,7.0,996,6.96385542168675
615,382,6.94146341463415,7.0,997,6.96389167502508
618,380,6.94336569579288,7.0,998,6.96492985971944
614,384,6.94625407166124,7.0,998,6.96693386773547
610,389,6.94262295081967,7.0,999,6.96496496496496
607,392,6.94233937397035,7.0,999,6.96496496496496
605,394,6.93884297520661,7.0,999,6.96296296296296
596,402,6.93959731543624,7.0,998,6.96392785571142
603,395,6.9485903814262,7.0,998,6.9689378757515
609,389,6.94417077175698,7.0,998,6.96593186372746
599,399,6.94991652754591,7.0,998,6.96993987975952
595,404,6.94789915966387,7.0,999,6.96896896896897
587,411,6.94548551959114,7.0,998,6.96793587174349
589,410,6.94227504244482,7.0,999,6.96596596596597
589,410,6.94567062818336,7.0,999,6.96796796796797
587,412,6.94378194207836,7.0,999,6.96696696696697
595,404,6.93949579831933,7.0,999,6.96396396396396
585,413,6.93846153846154,7.0,998,6.96392785571142
583,416,6.93825042881647,7.0,999,6.96396396396396
588,411,6.93707482993197,7.0,999,6.96296296296296
589,410,6.93378607809847,7.0,999,6.96096096096096
583,416,6.93996569468268,7.0,999,6.96496496496496
586,412,6.9419795221843,7.0,998,6.96593186372746
591,407,6.9424703891709,7.0,998,6.96593186372746
582,416,6.94329896907217,7.0,998,6.96693386773547
583,416,6.9451114922813,7.0,999,6.96796796796797
579,417,6.9412780656304,7.0,996,6.96586345381526
579,420,6.94300518134715,7.0,999,6.96696696696697
569,429,6.94200351493849,7.0,998,6.96693386773547
567,432,6.94179894179894,7.0,999,6.96696696696697
561,438,6.94652406417112,7.0,999,6.96996996996997
556,443,6.94424460431655,7.0,999,6.96896896896897
540,457,6.94074074074074,7.0,997,6.9679037111334
537,462,6.93854748603352,7.0,999,6.96696696696697
543,456,6.93554327808471,7.0,999,6.96496496496496
534,462,6.94194756554307,7.0,996,6.96887550200803
542,457,6.93911439114391,7.0,999,6.96696696696697
537,461,6.94413407821229,7.0,998,6.96993987975952
538,461,6.94237918215613,7.0,999,6.96896896896897
539,460,6.94248608534323,7.0,999,6.96896896896897
540,457,6.9462962962963,7.0,997,6.97091273821464
532,466,6.94924812030075,7.0,998,6.97294589178357
536,462,6.94776119402985,7.0,998,6.97194388777555
534,463,6.94756554307116,7.0,997,6.97191574724173
537,461,6.94785847299814,7.0,998,6.97194388777555
542,456,6.94464944649446,7.0,998,6.96993987975952
535,464,6.94018691588785,7.0,999,6.96796796796797
529,469,6.94328922495274,7.0,998,6.96993987975952
537,462,6.93854748603352,7.0,999,6.96696696696697
521,477,6.9404990403071,7.0,998,6.9689378757515
513,482,6.93957115009747,7.0,995,6.96884422110553
529,470,6.94517958412098,7.0,999,6.97097097097097
525,474,6.94476190476191,7.0,999,6.97097097097097
526,473,6.94486692015209,7.0,999,6.97097097097097
523,476,6.94646271510516,7.0,999,6.97197197197197
523,475,6.94646271510516,7.0,998,6.97194388777555
520,478,6.94807692307692,7.0,998,6.97294589178357
518,480,6.94980694980695,7.0,998,6.97394789579158
517,482,6.95357833655706,7.0,999,6.97597597597598
525,474,6.95047619047619,7.0,999,6.97397397397397
524,475,6.95038167938931,7.0,999,6.97397397397397
532,464,6.95488721804511,7.0,996,6.97590361445783
527,472,6.95635673624288,7.0,999,6.97697697697698
521,478,6.95777351247601,7.0,999,6.97797797797798
525,474,6.96190476190476,7.0,999,6.97997997997998
524,475,6.95992366412214,7.0,999,6.97897897897898
526,473,6.95817490494297,7.0,999,6.97797797797798
528,469,6.95643939393939,7.0,997,6.97693079237713
526,471,6.95247148288973,7.0,997,6.97492477432297
527,472,6.95256166982922,7.0,999,6.97497497497497
527,471,6.95066413662239,7.0,998,6.97394789579158
521,477,6.95009596928983,7.0,998,6.97394789579158
522,477,6.95593869731801,7.0,999,6.97697697697698
518,481,6.95945945945946,7.0,999,6.97897897897898
508,489,6.96653543307087,7.0,997,6.98294884653962
507,492,6.96252465483235,7.0,999,6.98098098098098
512,486,6.9609375,7.0,998,6.97995991983968
512,487,6.966796875,7.0,999,6.98298298298298
514,484,6.96303501945525,7.0,998,6.98096192384769
512,486,6.9609375,7.0,998,6.97995991983968
517,482,6.9651837524178,7.0,999,6.98198198198198
510,489,6.96862745098039,7.0,999,6.98398398398398
503,495,6.96421471172962,7.0,998,6.98196392785571
510,486,6.96078431372549,7.0,996,6.97991967871486
504,494,6.96230158730159,7.0,998,6.98096192384769
497,502,6.95975855130785,7.0,999,6.97997997997998
502,496,6.95617529880478,7.0,998,6.97795591182365
500,499,6.96,7.0,999,6.97997997997998
499,499,6.95991983967936,7.0,998,6.97995991983968
505,494,6.95841584158416,7.0,999,6.97897897897898
509,490,6.95677799607073,7.0,999,6.97797797797798
497,501,6.96177062374245,7.0,998,6.98096192384769
501,498,6.96407185628743,7.0,999,6.98198198198198
509,489,6.96070726915521,7.0,998,6.97995991983968
507,491,6.96252465483235,7.0,998,6.98096192384769
497,499,6.96177062374245,7.0,996,6.98092369477912
509,490,6.96463654223969,7.0,999,6.98198198198198
504,494,6.96825396825397,7.0,998,6.98396793587174
507,492,6.97041420118343,7.0,999,6.98498498498498
510,489,6.97058823529412,7.0,999,6.98498498498498
509,490,6.9705304518664,7.0,999,6.98498498498498
507,492,6.97041420118343,7.0,999,6.98498498498498
500,499,6.966,7.0,999,6.98298298298298
507,492,6.96646942800789,7.0,999,6.98298298298298
501,496,6.97205588822355,7.0,997,6.98595787362086
505,494,6.97029702970297,7.0,999,6.98498498498498
507,492,6.96646942800789,7.0,999,6.98298298298298
515,482,6.96699029126214,7.0,997,6.98294884653962
522,476,6.96551724137931,7.0,998,6.98196392785571
520,478,6.96346153846154,7.0,998,6.98096192384769
523,475,6.96175908221797,7.0,998,6.97995991983968
522,476,6.96360153256705,7.0,998,6.98096192384769
526,472,6.95817490494297,7.0,998,6.97795591182365
523,476,6.95793499043977,7.0,999,6.97797797797798
531,466,6.95856873822976,7.0,997,6.97793380140421
527,471,6.96584440227704,7.0,998,6.98196392785571
518,481,6.96525096525097,7.0,999,6.98198198198198
528,468,6.96401515151515,7.0,996,6.98092369477912
528,469,6.96590909090909,7.0,997,6.98194583751254
525,473,6.96380952380952,7.0,998,6.98096192384769
529,469,6.96786389413989,7.0,998,6.98296593186373
523,473,6.97131931166348,7.0,996,6.98493975903614
525,474,6.96761904761905,7.0,999,6.98298298298298
527,472,6.96774193548387,7.0,999,6.98298298298298
522,475,6.97126436781609,7.0,997,6.98495486459378
530,469,6.97169811320755,7.0,999,6.98498498498498
530,469,6.96981132075472,7.0,999,6.98398398398398
526,473,6.97148288973384,7.0,999,6.98498498498498
530,467,6.97358490566038,7.0,997,6.98595787362086
536,463,6.97201492537313,7.0,999,6.98498498498498
530,468,6.97169811320755,7.0,998,6.98496993987976
533,466,6.97748592870544,7.0,999,6.98798798798799
533,466,6.97560975609756,7.0,999,6.98698698698699
519,479,6.97302504816956,7.0,998,6.98597194388778
515,484,6.97087378640777,7.0,999,6.98498498498498
518,479,6.97297297297297,7.0,997,6.98595787362086
514,485,6.9727626459144,7.0,999,6.98598598598599
512,485,6.97265625,7.0,997,6.98595787362086
514,485,6.97081712062257,7.0,999,6.98498498498498
512,486,6.970703125,7.0,998,6.98496993987976
521,478,6.97504798464491,7.0,999,6.98698698698699
515,484,6.97281553398058,7.0,999,6.98598598598599
514,485,6.96887159533074,7.0,999,6.98398398398398
515,484,6.96699029126214,7.0,999,6.98298298298298
517,481,6.9651837524178,7.0,998,6.98196392785571
522,477,6.96934865900383,7.0,999,6.98398398398398
528,471,6.96969696969697,7.0,999,6.98398398398398
528,470,6.97348484848485,7.0,998,6.98597194388778
534,465,6.97191011235955,7.0,999,6.98498498498498
536,462,6.97388059701493,7.0,998,6.98597194388778
536,462,6.97014925373134,7.0,998,6.98396793587174
532,467,6.9718045112782,7.0,999,6.98498498498498
531,468,6.9774011299435,7.0,999,6.98798798798799
520,477,6.97307692307692,7.0,997,6.98595787362086
514,485,6.97081712062257,7.0,999,6.98498498498498
512,486,6.97265625,7.0,998,6.98597194388778
507,489,6.97633136094675,7.0,996,6.98795180722892
516,482,6.97480620155039,7.0,998,6.98697394789579
520,479,6.97884615384615,7.0,999,6.98898898898899
509,490,6.98231827111984,7.0,999,6.99099099099099
514,485,6.98443579766537,7.0,999,6.99199199199199
509,490,6.98428290766208,7.0,999,6.99199199199199
497,501,6.98390342052314,7.0,998,6.99198396793587
501,496,6.98602794411178,7.0,997,6.99297893681043
499,499,6.98396793587174,7.0,998,6.99198396793587
492,506,6.98577235772358,7.0,998,6.99298597194389
506,492,6.98814229249012,7.0,998,6.9939879759519
504,495,6.99007936507936,7.0,999,6.99499499499499
513,484,6.98635477582846,7.0,997,6.99297893681043
527,470,6.98671726755218,7.0,997,6.99297893681043
526,471,6.98669201520913,7.0,997,6.99297893681043
523,476,6.98279158699809,7.0,999,6.99099099099099
527,470,6.98292220113852,7.0,997,6.99097291875627
523,475,6.98279158699809,7.0,998,6.99098196392786
527,472,6.98102466793169,7.0,999,6.98998998998999
534,465,6.97752808988764,7.0,999,6.98798798798799
529,469,6.98109640831758,7.0,998,6.98997995991984
534,464,6.97940074906367,7.0,998,6.98897795591182
535,463,6.97757009345794,7.0,998,6.98797595190381
529,470,6.9773156899811,7.0,999,6.98798798798799
531,467,6.98116760828625,7.0,998,6.98997995991984
537,461,6.98137802607076,7.0,998,6.98997995991984
529,470,6.98298676748582,7.0,999,6.99099099099099
539,460,6.98515769944341,7.0,999,6.99199199199199
532,465,6.98496240601504,7.0,997,6.99197592778335
519,479,6.98073217726397,7.0,998,6.98997995991984
518,479,6.98262548262548,7.0,997,6.99097291875627
520,479,6.98269230769231,7.0,999,6.99099099099099
510,489,6.98235294117647,7.0,999,6.99099099099099
514,485,6.98054474708171,7.0,999,6.98998998998999
515,484,6.98252427184466,7.0,999,6.99099099099099
507,490,6.98224852071006,7.0,997,6.99097291875627
512,487,6.974609375,7.0,999,6.98698698698699
511,487,6.97651663405088,7.0,998,6.98797595190381
516,482,6.98062015503876,7.0,998,6.98997995991984
519,479,6.97687861271676,7.0,998,6.98797595190381
518,481,6.97297297297297,7.0,999,6.98598598598599
521,477,6.97696737044146,7.0,998,6.98797595190381
515,484,6.97864077669903,7.0,999,6.98898898898899
517,482,6.97485493230174,7.0,999,6.98698698698699
515,481,6.9747572815534,7.0,996,6.98694779116466
505,494,6.97623762376238,7.0,999,6.98798798798799
504,494,6.97619047619048,7.0,998,6.98797595190381
513,486,6.9766081871345,7.0,999,6.98798798798799
499,500,6.97795591182365,7.0,999,6.98898898898899
498,500,6.97791164658635,7.0,998,6.98897795591182
501,497,6.98003992015968,7.0,998,6.98997995991984
490,508,6.97959183673469,7.0,998,6.98997995991984
488,510,6.98155737704918,7.0,998,6.99098196392786
496,501,6.98185483870968,7.0,997,6.99097291875627
499,499,6.97995991983968,7.0,998,6.98997995991984
499,500,6.98396793587174,7.0,999,6.99199199199199
505,494,6.98415841584158,7.0,999,6.99199199199199
507,492,6.98224852071006,7.0,999,6.99099099099099
506,493,6.98616600790514,7.0,999,6.99299299299299
502,497,6.98605577689243,7.0,999,6.99299299299299
495,503,6.98181818181818,7.0,998,6.99098196392786
495,503,6.98181818181818,7.0,998,6.99098196392786
495,503,6.98181818181818,7.0,998,6.99098196392786
499,499,6.97795591182365,7.0,998,6.98897795591182
502,497,6.97808764940239,7.0,999,6.98898898898899
488,510,6.98155737704918,7.0,998,6.99098196392786
493,503,6.98174442190669,7.0,996,6.99096385542169
493,505,6.98377281947262,7.0,998,6.99198396793587
484,514,6.98347107438016,7.0,998,6.99198396793587
488,509,6.98565573770492,7.0,997,6.99297893681043
497,502,6.97987927565392,7.0,999,6.98998998998999
499,499,6.97995991983968,7.0,998,6.98997995991984
503,496,6.98409542743539,7.0,999,6.99199199199199
504,493,6.98015873015873,7.0,997,6.98996990972919
500,499,6.98,7.0,999,6.98998998998999
503,495,6.98210735586481,7.0,998,6.99098196392786
499,500,6.98396793587174,7.0,999,6.99199199199199
497,502,6.97987927565392,7.0,999,6.98998998998999
502,497,6.9800796812749,7.0,999,6.98998998998999
499,499,6.98396793587174,7.0,998,6.99198396793587
499,498,6.98396793587174,7.0,997,6.99197592778335
501,498,6.98802395209581,7.0,999,6.99399399399399
494,504,6.98785425101215,7.0,998,6.9939879759519
495,502,6.98585858585859,7.0,997,6.99297893681043
507,491,6.98422090729783,7.0,998,6.99198396793587
509,490,6.98821218074656,7.0,999,6.99399399399399
509,490,6.98624754420432,7.0,999,6.99299299299299
510,489,6.98235294117647,7.0,999,6.99099099099099
503,496,6.98608349900596,7.0,999,6.99299299299299
496,503,6.98588709677419,7.0,999,6.99299299299299
495,503,6.98181818181818,7.0,998,6.99098196392786
482,516,6.98755186721992,7.0,998,6.9939879759519
477,522,6.9874213836478,7.0,999,6.99399399399399
480,517,6.98541666666667,7.0,997,6.99297893681043
480,517,6.98541666666667,7.0,997,6.99297893681043
477,522,6.9895178197065,7.0,999,6.99499499499499
479,518,6.99164926931106,7.0,997,6.99598796389168
477,521,6.9916142557652,7.0,998,6.99599198396794
484,514,6.99173553719008,7.0,998,6.99599198396794
485,513,6.99175257731959,7.0,998,6.99599198396794
484,514,6.99380165289256,7.0,998,6.99699398797595
493,506,6.99594320486815,7.0,999,6.997997997998
503,496,6.99602385685885,7.0,999,6.997997997998
503,496,6.99602385685885,7.0,999,6.997997997998
505,494,6.99405940594059,7.0,999,6.996996996997
509,489,6.99410609037328,7.0,998,6.99699398797595
517,482,6.99613152804642,7.0,999,6.997997997998
514,482,6.99610894941634,7.0,996,6.99799196787149
509,490,6.99410609037328,7.0,999,6.996996996997
517,481,6.99419729206963,7.0,998,6.99699398797595
520,479,6.99423076923077,7.0,999,6.996996996997
520,479,6.99423076923077,7.0,999,6.996996996997
521,478,6.99424184261036,7.0,999,6.996996996997
526,472,6.99619771863118,7.0,998,6.99799599198397
521,476,6.99424184261036,7.0,997,6.99699097291876
522,477,6.99425287356322,7.0,999,6.996996996997
524,475,6.99427480916031,7.0,999,6.996996996997
520,479,6.99423076923077,7.0,999,6.996996996997
517,482,6.99226305609284,7.0,999,6.995995995996
526,472,6.99239543726236,7.0,998,6.99599198396794
532,467,6.99436090225564,7.0,999,6.996996996997
529,469,6.99243856332703,7.0,998,6.99599198396794
536,463,6.99253731343284,7.0,999,6.995995995996
534,464,6.99250936329588,7.0,998,6.99599198396794
542,456,6.99261992619926,7.0,998,6.99599198396794
545,453,6.99082568807339,7.0,998,6.99498997995992
547,452,6.9926873857404,7.0,999,6.995995995996
548,451,6.99452554744526,7.0,999,6.996996996997
545,453,6.99449541284404,7.0,998,6.99699398797595
545,454,6.99449541284404,7.0,999,6.996996996997
544,454,6.99448529411765,7.0,998,6.99699398797595
540,457,6.99259259259259,7.0,997,6.99598796389168
539,460,6.99257884972171,7.0,999,6.995995995996
552,447,6.99275362318841,7.0,999,6.995995995996
550,449,6.98909090909091,7.0,999,6.99399399399399
551,448,6.98911070780399,7.0,999,6.99399399399399
553,445,6.99095840867993,7.0,998,6.99498997995992
551,447,6.98911070780399,7.0,998,6.9939879759519
546,453,6.98717948717949,7.0,999,6.99299299299299
559,440,6.98747763864043,7.0,999,6.99299299299299
549,450,6.98724954462659,7.0,999,6.99299299299299
547,451,6.9853747714808,7.0,998,6.99198396793587
558,440,6.98387096774194,7.0,998,6.99098196392786
549,450,6.98360655737705,7.0,999,6.99099099099099
544,455,6.97977941176471,7.0,999,6.98898898898899
560,439,6.97857142857143,7.0,999,6.98798798798799
556,443,6.98021582733813,7.0,999,6.98898898898899
558,441,6.98207885304659,7.0,999,6.98998998998999
560,438,6.98392857142857,7.0,998,6.99098196392786
541,457,6.98706099815157,7.0,998,6.99298597194389
539,460,6.98886827458256,7.0,999,6.99399399399399
538,461,6.98513011152416,7.0,999,6.99199199199199
537,462,6.98696461824953,7.0,999,6.99299299299299
541,455,6.98706099815157,7.0,996,6.9929718875502
548,450,6.98540145985401,7.0,998,6.99198396793587
549,450,6.98178506375228,7.0,999,6.98998998998999
537,462,6.98324022346369,7.0,999,6.99099099099099
538,460,6.98513011152416,7.0,998,6.99198396793587
535,463,6.98317757009346,7.0,998,6.99098196392786
528,471,6.98106060606061,7.0,999,6.98998998998999
533,466,6.9812382739212,7.0,999,6.98998998998999
533,466,6.98311444652908,7.0,999,6.99099099099099
530,467,6.98490566037736,7.0,997,6.99197592778335
533,466,6.98686679174484,7.0,999,6.99299299299299
527,471,6.98671726755218,7.0,998,6.99298597194389
539,459,6.98330241187384,7.0,998,6.99098196392786
543,456,6.98342541436464,7.0,999,6.99099099099099
552,447,6.98369565217391,7.0,999,6.99099099099099
545,452,6.98715596330275,7.0,997,6.99297893681043
538,459,6.98884758364312,7.0,997,6.99398194583751
550,448,6.98909090909091,7.0,998,6.9939879759519
543,454,6.98895027624309,7.0,997,6.99398194583751
535,463,6.98691588785047,7.0,998,6.99298597194389
539,460,6.99072356215213,7.0,999,6.99499499499499
541,458,6.98890942698706,7.0,999,6.99399399399399
540,459,6.98888888888889,7.0,999,6.99399399399399
539,459,6.98886827458256,7.0,998,6.9939879759519
538,460,6.98698884758364,7.0,998,6.99298597194389
539,460,6.98886827458256,7.0,999,6.99399399399399
540,458,6.98888888888889,7.0,998,6.9939879759519
538,460,6.98698884758364,7.0,998,6.99298597194389
