forward_num,reverse_num,forward_rate,reverse_rate,organism_num,organism_rate
50,50,5.5,5.5,100,5.5
63,63,5.87301587301587,5.6031746031746,126,5.73809523809524
75,76,5.93333333333333,6.0,151,5.96688741721854
97,98,6.28865979381443,6.13265306122449,195,6.21025641025641
115,121,6.48695652173913,6.44628099173554,236,6.46610169491525
151,151,6.82781456953642,6.60927152317881,302,6.71854304635762
185,200,7.06486486486487,6.95,385,7.00519480519481
249,226,7.36546184738956,7.02654867256637,475,7.20421052631579
309,328,7.45307443365696,7.48170731707317,637,7.46781789638932
391,380,7.72122762148338,7.55263157894737,771,7.63813229571984
503,495,7.90854870775348,7.91717171717172,998,7.91282565130261
490,509,7.8530612244898,7.82514734774067,999,7.83883883883884
492,506,7.91056910569106,7.87351778656126,998,7.89178356713427
488,511,7.92213114754098,7.81800391389432,999,7.86886886886887
487,510,7.91786447638604,7.88039215686275,997,7.89869608826479
493,502,7.87221095334686,7.91633466135458,995,7.89447236180905
496,503,7.90322580645161,7.95427435387674,999,7.92892892892893
488,510,7.89549180327869,7.95686274509804,998,7.92685370741483
488,511,7.875,8.0293542074364,999,7.95395395395395
483,515,7.91718426501035,8.00194174757281,998,7.96092184368737
470,529,8.0,8.08884688090737,999,8.04704704704705
468,531,7.96794871794872,8.11864406779661,999,8.04804804804805
469,530,7.99573560767591,8.17358490566038,999,8.09009009009009
460,539,7.99347826086957,8.1317254174397,999,8.06806806806807
457,542,8.05032822757112,8.07933579335793,999,8.06606606606607
464,535,8.10560344827586,8.09719626168224,999,8.1011011011011
460,539,8.16086956521739,8.09647495361781,999,8.12612612612613
471,528,8.20382165605096,8.125,999,8.16216216216216
470,529,8.25744680851064,8.17202268431002,999,8.21221221221221
479,519,8.27557411273486,8.21194605009634,998,8.24248496993988
482,517,8.32572614107884,8.23404255319149,999,8.27827827827828
474,525,8.31012658227848,8.24190476190476,999,8.27427427427427
474,524,8.32911392405063,8.20992366412214,998,8.26653306613226
472,527,8.33686440677966,8.25806451612903,999,8.2952952952953
482,517,8.33609958506224,8.24371373307543,999,8.28828828828829
475,524,8.34315789473684,8.25381679389313,999,8.2962962962963
481,518,8.31392931392931,8.27027027027027,999,8.29129129129129
474,525,8.31012658227848,8.30095238095238,999,8.30530530530531
472,527,8.34957627118644,8.29032258064516,999,8.31831831831832
472,526,8.38559322033898,8.31178707224335,998,8.34669338677355
460,538,8.37173913043478,8.29368029739777,998,8.32965931863727
467,531,8.40899357601713,8.29755178907721,998,8.3496993987976
464,535,8.39655172413793,8.31588785046729,999,8.35335335335335
466,532,8.42918454935622,8.29887218045113,998,8.35971943887776
473,526,8.42283298097252,8.29087452471483,999,8.35335335335335
475,524,8.44631578947368,8.34541984732824,999,8.39339339339339
483,516,8.48447204968944,8.32364341085271,999,8.4014014014014
486,512,8.59876543209877,8.3515625,998,8.47194388777555
489,508,8.60122699386503,8.3503937007874,997,8.47342026078235
492,507,8.65650406504065,8.3353057199211,999,8.49349349349349
497,501,8.62575452716298,8.36127744510978,998,8.49298597194389
504,494,8.63888888888889,8.36842105263158,998,8.50501002004008
499,497,8.63326653306613,8.35613682092555,996,8.49497991967871
498,501,8.6566265060241,8.40119760479042,999,8.52852852852853
493,506,8.66125760649087,8.37747035573122,999,8.51751751751752
508,488,8.66732283464567,8.38114754098361,996,8.52710843373494
499,500,8.625250501002,8.422,999,8.52352352352352
500,499,8.656,8.46092184368737,999,8.55855855855856
487,512,8.65708418891171,8.474609375,999,8.56356356356356
486,513,8.67901234567901,8.50292397660819,999,8.58858858858859
481,517,8.64241164241164,8.4990328820116,998,8.56813627254509
483,516,8.68530020703934,8.53488372093023,999,8.60760760760761
478,517,8.69456066945607,8.52030947775629,995,8.60402010050251
473,526,8.6723044397463,8.54182509505703,999,8.6036036036036
472,526,8.6864406779661,8.52851711026616,998,8.60320641282565
475,522,8.69473684210526,8.53639846743295,997,8.61183550651956
467,530,8.68950749464668,8.52264150943396,997,8.60080240722166
468,531,8.72435897435897,8.55555555555556,999,8.63463463463463
461,537,8.70498915401302,8.57355679702048,998,8.63426853707415
474,524,8.78902953586498,8.58015267175572,998,8.67935871743487
476,523,8.78361344537815,8.58699808795411,999,8.68068068068068
480,519,8.84375,8.5626204238921,999,8.6976976976977
477,522,8.84067085953878,8.58429118773946,999,8.70670670670671
477,522,8.85744234800839,8.66091954022989,999,8.75475475475475
478,520,8.8347280334728,8.67115384615385,998,8.74949899799599
485,512,8.83298969072165,8.70703125,997,8.76830491474423
481,518,8.84615384615385,8.74324324324324,999,8.79279279279279
484,515,8.89049586776859,8.74563106796117,999,8.81581581581582
480,518,8.89166666666667,8.77413127413127,998,8.83066132264529
480,518,8.90416666666667,8.7953667953668,998,8.84769539078156
482,517,8.88589211618257,8.79110251450677,999,8.83683683683684
489,510,8.93251533742331,8.79019607843137,999,8.85985985985986
491,508,8.93279022403259,8.83070866141732,999,8.88088088088088
494,504,8.95141700404858,8.84126984126984,998,8.89579158316633
484,514,8.96694214876033,8.87548638132296,998,8.91983967935872
477,521,8.9937106918239,8.83301343570058,998,8.90981963927856
481,518,8.99376299376299,8.85714285714286,999,8.92292292292292
486,513,9.00411522633745,8.9317738791423,999,8.96696696696697
483,513,8.97515527950311,8.91617933723197,996,8.94477911646586
483,516,9.03933747412008,8.92441860465116,999,8.97997997997998
479,518,9.02713987473904,8.92277992277992,997,8.97291875626881
482,517,9.03734439834025,8.89555125725338,999,8.96396396396396
479,519,9.02505219206681,8.89980732177264,998,8.95991983967936
484,513,9.04545454545454,8.92007797270955,997,8.98094282848546
482,517,9.03526970954357,8.92456479690522,999,8.97797797797798
489,509,9.03680981595092,8.93123772102161,998,8.98296593186373
486,513,9.05349794238683,8.93957115009747,999,8.99499499499499
483,515,9.05797101449275,8.94757281553398,998,9.00100200400802
480,519,9.02291666666667,8.94990366088632,999,8.98498498498498
479,520,9.02087682672234,8.91346153846154,999,8.96496496496496
476,522,9.05042016806723,8.89272030651341,998,8.96793587174349
476,519,9.04201680672269,8.88631984585742,995,8.9608040201005
468,530,9.05982905982906,8.87547169811321,998,8.96192384769539
471,528,9.06157112526539,8.90530303030303,999,8.97897897897898
472,526,9.07838983050847,8.97908745247148,998,9.02605210420842
465,532,9.06451612903226,8.98684210526316,997,9.02306920762287
460,539,9.09782608695652,8.9721706864564,999,9.03003003003003
457,541,9.08315098468271,9.00369685767098,998,9.04008016032064
457,540,9.10940919037199,8.97407407407407,997,9.03610832497492
454,544,9.1057268722467,8.98713235294118,998,9.04108216432866
445,554,9.09213483146067,9.02346570397112,999,9.05405405405405
449,550,9.07795100222717,9.0,999,9.03503503503504
444,555,9.06306306306306,9.01981981981982,999,9.03903903903904
449,550,9.05345211581292,9.00909090909091,999,9.02902902902903
443,553,9.05417607223476,9.01989150090416,996,9.035140562249
444,554,9.04954954954955,9.01083032490975,998,9.02805611222445
445,554,9.05842696629214,9.00541516245487,999,9.02902902902903
453,545,9.09713024282561,9.01467889908257,998,9.05210420841683
455,544,9.10549450549451,9.00551470588235,999,9.05105105105105
448,548,9.10267857142857,8.99270072992701,996,9.04216867469879
461,537,9.06724511930586,9.02420856610801,998,9.04408817635271
463,536,9.07991360691145,9.00373134328358,999,9.03903903903904
467,531,9.10706638115632,8.99435028248588,998,9.04709418837675
469,529,9.09808102345416,8.97164461247637,998,9.0310621242485
469,529,9.07462686567164,8.96975425330813,998,9.0190380761523
467,530,9.06852248394004,8.93396226415094,997,8.99699097291876
465,532,9.06881720430107,8.93984962406015,997,9.0
461,538,9.09761388286334,8.93866171003718,999,9.01201201201201
463,536,9.07127429805615,8.94776119402985,999,9.00500500500501
468,531,9.07692307692308,8.95668549905838,999,9.01301301301301
466,533,9.10729613733906,8.95872420262664,999,9.02802802802803
466,533,9.1244635193133,8.97560975609756,999,9.04504504504505
469,530,9.15778251599147,8.97924528301887,999,9.06306306306306
476,522,9.14495798319328,8.98467432950192,998,9.06112224448898
482,515,9.20954356846473,9.00582524271845,997,9.10431293881645
482,517,9.19917012448133,9.03094777562863,999,9.11211211211211
484,515,9.25826446280992,9.01359223300971,999,9.13213213213213
477,522,9.26834381551363,9.01532567049808,999,9.13613613613614
470,529,9.28297872340426,9.03780718336484,999,9.15315315315315
457,541,9.30634573304158,9.01478743068392,998,9.14829659318637
458,540,9.2707423580786,9.02962962962963,998,9.14028056112224
455,543,9.28351648351648,9.04051565377532,998,9.15130260521042
457,540,9.32603938730853,9.02592592592593,997,9.16349047141424
454,545,9.3568281938326,9.02568807339449,999,9.17617617617618
449,550,9.34075723830735,9.02545454545455,999,9.16716716716717
453,545,9.33333333333333,9.00917431192661,998,9.1563126252505
453,546,9.32891832229581,9.00915750915751,999,9.15415415415415
450,547,9.31777777777778,9.0146252285192,997,9.15145436308927
441,556,9.3265306122449,9.01258992805755,997,9.15145436308927
442,557,9.33484162895928,9.02692998204668,999,9.16316316316316
436,563,9.33256880733945,9.02131438721137,999,9.15715715715716
441,557,9.32199546485261,9.03590664272891,998,9.1623246492986
447,551,9.31767337807606,9.03811252268603,998,9.16332665330661
449,549,9.3652561247216,9.03642987249545,998,9.18436873747495
452,547,9.34513274336283,9.04570383912249,999,9.18118118118118
447,551,9.35123042505593,9.01996370235935,998,9.16833667334669
449,548,9.35189309576838,9.01094890510949,997,9.16449348044132
450,547,9.40222222222222,8.9890310786106,997,9.17552657973922
449,548,9.39643652561247,9.01277372262774,997,9.18555667001003
451,546,9.45232815964523,9.01465201465201,997,9.21263791374122
448,551,9.43973214285714,9.01996370235935,999,9.20820820820821
452,547,9.43805309734513,9.04204753199269,999,9.22122122122122
456,543,9.42763157894737,9.06813996316759,999,9.23223223223223
460,538,9.45869565217391,9.07806691449814,998,9.25350701402806
454,545,9.41189427312775,9.07889908256881,999,9.23023023023023
459,537,9.43572984749455,9.07635009310987,996,9.24196787148594
463,533,9.42980561555076,9.09943714821764,996,9.25301204819277
463,536,9.42764578833693,9.12873134328358,999,9.26726726726727
464,534,9.41163793103448,9.12921348314607,998,9.26052104208417
464,535,9.4051724137931,9.11588785046729,999,9.25025025025025
462,535,9.45021645021645,9.16261682242991,997,9.29588766298897
459,540,9.43137254901961,9.14259259259259,999,9.27527527527528
451,548,9.43680709534368,9.17335766423358,999,9.29229229229229
459,540,9.4400871459695,9.1962962962963,999,9.30830830830831
455,543,9.45494505494506,9.19152854511971,998,9.31162324649299
453,546,9.45916114790287,9.17948717948718,999,9.30630630630631
449,549,9.45657015590201,9.18761384335155,998,9.30861723446894
451,545,9.4589800443459,9.21100917431193,996,9.32329317269076
454,545,9.46916299559471,9.21651376146789,999,9.33133133133133
448,550,9.46205357142857,9.23636363636364,998,9.3376753507014
454,544,9.48678414096916,9.25551470588235,998,9.36072144288577
458,539,9.50873362445415,9.24118738404453,997,9.36409227683049
451,545,9.50776053215078,9.21834862385321,996,9.34939759036145
458,541,9.50436681222707,9.19593345656192,999,9.33733733733734
460,538,9.48913043478261,9.16542750929368,998,9.31462925851703
463,535,9.48596112311015,9.18317757009346,998,9.32364729458918
474,524,9.4746835443038,9.1412213740458,998,9.29959919839679
474,523,9.4535864978903,9.15869980879541,997,9.29889669007021
485,514,9.47216494845361,9.1420233463035,999,9.3023023023023
479,518,9.44258872651357,9.14478764478764,997,9.28786359077232
490,509,9.4530612244898,9.15717092337917,999,9.3023023023023
480,519,9.46041666666667,9.15606936416185,999,9.3023023023023
484,513,9.47520661157025,9.10916179337232,997,9.28686058174524
484,514,9.46487603305785,9.12062256809338,998,9.2875751503006
493,505,9.48884381338742,9.1009900990099,998,9.29258517034068
488,511,9.48155737704918,9.11937377690802,999,9.2962962962963
501,498,9.47904191616766,9.13052208835341,999,9.30530530530531
496,500,9.46975806451613,9.122,996,9.29518072289157
503,496,9.4831013916501,9.1491935483871,999,9.31731731731732
507,492,9.48126232741617,9.14430894308943,999,9.31531531531532
509,490,9.475442043222,9.17959183673469,999,9.33033033033033
528,469,9.45833333333333,9.22174840085288,997,9.34704112337011
529,469,9.46691871455577,9.25373134328358,998,9.36673346693387
532,464,9.46616541353383,9.23922413793103,996,9.36044176706827
523,475,9.48948374760994,9.24842105263158,998,9.374749498998
515,484,9.48932038834952,9.24173553719008,999,9.36936936936937
510,489,9.49803921568627,9.24539877300614,999,9.37437437437437
507,492,9.48520710059172,9.23780487804878,999,9.36336336336336
497,502,9.48893360160966,9.24501992031873,999,9.36636636636637
493,505,9.49087221095335,9.23564356435643,998,9.36172344689379
497,502,9.49496981891348,9.22908366533865,999,9.36136136136136
500,498,9.476,9.20281124497992,998,9.33967935871743
501,496,9.48303393213573,9.19354838709677,997,9.33901705115346
490,509,9.47959183673469,9.22986247544204,999,9.35235235235235
485,514,9.49484536082474,9.22373540856031,999,9.35535535535536
487,511,9.50924024640657,9.22896281800391,998,9.36573146292585
486,511,9.5082304526749,9.20939334637965,997,9.35506519558676
482,515,9.53526970954357,9.21553398058252,997,9.37011033099298
489,510,9.52965235173824,9.2156862745098,999,9.36936936936937
491,507,9.5213849287169,9.22879684418146,998,9.37274549098196
489,509,9.52147239263804,9.2475442043222,998,9.38176352705411
499,499,9.50901803607214,9.24448897795591,998,9.37675350701403
505,494,9.52673267326733,9.26315789473684,999,9.3963963963964
510,489,9.53921568627451,9.27402862985685,999,9.40940940940941
513,486,9.53216374269006,9.28395061728395,999,9.41141141141141
524,475,9.52480916030534,9.27368421052632,999,9.40540540540541
512,486,9.541015625,9.27777777777778,998,9.4128256513026
505,493,9.56039603960396,9.27586206896552,998,9.41983967935872
505,494,9.56633663366337,9.27732793522267,999,9.42342342342342
513,486,9.55945419103314,9.32921810699589,999,9.44744744744745
504,494,9.56944444444444,9.33400809716599,998,9.45290581162325
505,494,9.57623762376238,9.31781376518219,999,9.44844844844845
511,488,9.57142857142857,9.34016393442623,999,9.45845845845846
521,478,9.56813819577735,9.33054393305439,999,9.45445445445445
519,480,9.54913294797688,9.32083333333333,999,9.43943943943944
522,476,9.55938697318008,9.32773109243698,998,9.44889779559118
514,484,9.56809338521401,9.33264462809917,998,9.45390781563126
516,483,9.58139534883721,9.33540372670807,999,9.46246246246246
507,492,9.59763313609468,9.3150406504065,999,9.45845845845846
505,494,9.6,9.35222672064777,999,9.47747747747748
506,493,9.60869565217391,9.35294117647059,999,9.48248248248248
492,507,9.60772357723577,9.37080867850099,999,9.48748748748749
495,504,9.60808080808081,9.38690476190476,999,9.4964964964965
491,507,9.59877800407332,9.39842209072978,998,9.49699398797595
503,495,9.61630218687873,9.41010101010101,998,9.51402805611222
498,501,9.59236947791165,9.41516966067864,999,9.5035035035035
506,492,9.59288537549407,9.43089430894309,998,9.51302605210421
506,493,9.57707509881423,9.45436105476673,999,9.51651651651652
511,488,9.58317025440313,9.42622950819672,999,9.50650650650651
502,495,9.56573705179283,9.44444444444444,997,9.50551654964895
496,501,9.57459677419355,9.47305389221557,997,9.52357071213641
481,516,9.55717255717256,9.47093023255814,997,9.51253761283852
483,514,9.54244306418219,9.47665369649805,997,9.50852557673019
485,514,9.54845360824742,9.48249027237354,999,9.51451451451451
477,519,9.53039832285115,9.49325626204239,996,9.51104417670683
477,522,9.52201257861635,9.50191570881226,999,9.51151151151151
484,514,9.4896694214876,9.47665369649805,998,9.48296593186373
477,522,9.49895178197065,9.49616858237548,999,9.4974974974975
480,517,9.47916666666667,9.49516441005803,997,9.48746238716148
476,523,9.47478991596639,9.48374760994264,999,9.47947947947948
489,507,9.48875255623722,9.46351084812623,996,9.47590361445783
492,507,9.5,9.44575936883629,999,9.47247247247247
496,503,9.48185483870968,9.44333996023857,999,9.46246246246246
499,500,9.50901803607214,9.448,999,9.47847847847848
502,497,9.5199203187251,9.44869215291751,999,9.48448448448448
497,501,9.53923541247485,9.45908183632734,998,9.49899799599198
513,486,9.55360623781676,9.47325102880658,999,9.51451451451451
508,491,9.54330708661417,9.4765784114053,999,9.51051051051051
515,484,9.53398058252427,9.48553719008265,999,9.51051051051051
506,491,9.51778656126482,9.4826883910387,997,9.50050150451354
507,492,9.534516765286,9.47357723577236,999,9.5045045045045
515,483,9.52815533980583,9.50103519668737,998,9.51503006012024
516,483,9.5077519379845,9.48654244306418,999,9.4974974974975
525,472,9.53333333333333,9.51906779661017,997,9.52657973921765
530,467,9.52452830188679,9.50321199143469,997,9.51454363089268
533,465,9.5422138836773,9.50967741935484,998,9.52705410821643
531,468,9.54802259887006,9.52777777777778,999,9.53853853853854
530,469,9.56037735849057,9.52665245202559,999,9.54454454454454
523,473,9.55640535372849,9.52008456659619,996,9.53915662650602
524,474,9.56870229007634,9.5168776371308,998,9.54408817635271
523,476,9.5697896749522,9.52941176470588,999,9.55055055055055
522,475,9.57088122605364,9.53052631578947,997,9.55165496489468
514,485,9.5875486381323,9.57113402061856,999,9.57957957957958
506,492,9.59090909090909,9.58333333333333,998,9.5871743486974
507,491,9.60157790927022,9.59063136456212,998,9.59619238476954
515,483,9.59417475728155,9.58385093167702,998,9.58917835671343
515,484,9.59223300970874,9.58264462809917,999,9.58758758758759
521,476,9.60268714011516,9.55882352941176,997,9.58174523570712
510,487,9.5921568627451,9.57700205338809,997,9.58475426278837
518,481,9.59266409266409,9.56340956340956,999,9.57857857857858
512,487,9.59375,9.56262833675565,999,9.57857857857858
515,484,9.57669902912621,9.56404958677686,999,9.57057057057057
518,481,9.57528957528958,9.56756756756757,999,9.57157157157157
526,472,9.59505703422053,9.5635593220339,998,9.58016032064128
521,478,9.57389635316699,9.57740585774058,999,9.57557557557558
517,480,9.58413926499033,9.59375,997,9.58876629889669
513,486,9.58674463937622,9.58024691358025,999,9.58358358358358
519,480,9.5645472061657,9.58333333333333,999,9.57357357357357
518,480,9.54826254826255,9.59375,998,9.57014028056112
526,472,9.54942965779468,9.56991525423729,998,9.55911823647295
529,470,9.56143667296786,9.58723404255319,999,9.57357357357357
524,473,9.54580152671756,9.58139534883721,997,9.56268806419258
522,476,9.54980842911877,9.58613445378151,998,9.56713426853707
527,471,9.56166982922201,9.5859872611465,998,9.57314629258517
527,472,9.57685009487666,9.57203389830508,999,9.57457457457457
535,464,9.57009345794392,9.56896551724138,999,9.56956956956957
532,464,9.56578947368421,9.56896551724138,996,9.56726907630522
526,473,9.56844106463878,9.58139534883721,999,9.57457457457457
534,465,9.55056179775281,9.57634408602151,999,9.56256256256256
531,468,9.55367231638418,9.6025641025641,999,9.57657657657658
533,466,9.55534709193246,9.60085836909871,999,9.57657657657658
519,479,9.56840077071291,9.60542797494781,998,9.58617234468938
521,478,9.5873320537428,9.61087866108787,999,9.5985985985986
512,485,9.578125,9.61237113402062,997,9.59478435305918
514,485,9.58365758754864,9.60824742268041,999,9.5955955955956
513,485,9.5692007797271,9.62061855670103,998,9.59418837675351
516,483,9.58720930232558,9.6231884057971,999,9.6046046046046
512,487,9.6015625,9.62833675564682,999,9.61461461461461
506,493,9.59090909090909,9.63286004056795,999,9.61161161161161
505,494,9.6039603960396,9.63157894736842,999,9.61761761761762
512,486,9.60546875,9.61728395061728,998,9.61122244488978
506,492,9.61067193675889,9.61991869918699,998,9.61523046092184
509,489,9.59724950884086,9.62985685071575,998,9.61322645290581
508,490,9.60826771653543,9.62857142857143,998,9.61823647294589
510,489,9.61372549019608,9.61758691206544,999,9.61561561561562
511,487,9.61252446183953,9.62217659137577,998,9.61723446893788
505,493,9.63168316831683,9.62271805273834,998,9.62725450901804
511,488,9.63013698630137,9.64549180327869,999,9.63763763763764
517,482,9.6247582205029,9.649377593361,999,9.63663663663664
517,481,9.63442940038685,9.66735966735967,998,9.6503006012024
516,482,9.62790697674419,9.66182572614108,998,9.64428857715431
523,476,9.65200764818356,9.65966386554622,999,9.65565565565566
521,478,9.65451055662188,9.68410041841004,999,9.66866866866867
514,485,9.6692607003891,9.67422680412371,999,9.67167167167167
511,487,9.69471624266145,9.68788501026694,998,9.69138276553106
509,490,9.70726915520629,9.68775510204082,999,9.6976976976977
510,486,9.7,9.7037037037037,996,9.70180722891566
514,484,9.71011673151751,9.69421487603306,998,9.70240480961924
516,483,9.69961240310078,9.69979296066253,999,9.6996996996997
510,487,9.68823529411765,9.70020533880903,997,9.69408224674022
523,476,9.69598470363289,9.71008403361344,999,9.7027027027027
525,473,9.68952380952381,9.71247357293869,998,9.70040080160321
532,465,9.69360902255639,9.70967741935484,997,9.70110330992979
527,472,9.69070208728653,9.71610169491525,999,9.7027027027027
540,458,9.68888888888889,9.72052401746725,998,9.70340681362725
541,458,9.71164510166359,9.72052401746725,999,9.71571571571572
544,455,9.70588235294118,9.71868131868132,999,9.71171171171171
539,458,9.70686456400742,9.7292576419214,997,9.71715145436309
544,455,9.68382352941176,9.72307692307692,999,9.7017017017017
542,456,9.68081180811808,9.70614035087719,998,9.69238476953908
545,454,9.68623853211009,9.74229074889868,999,9.71171171171171
542,456,9.6789667896679,9.73684210526316,998,9.70541082164329
530,468,9.67924528301887,9.73931623931624,998,9.70741482965932
537,461,9.68342644320298,9.72017353579176,998,9.70040080160321
533,466,9.68105065666041,9.72532188841202,999,9.7017017017017
541,458,9.71164510166359,9.73799126637555,999,9.72372372372372
532,466,9.69924812030075,9.74034334763948,998,9.71843687374749
531,468,9.70433145009416,9.75213675213675,999,9.72672672672673
525,473,9.71428571428571,9.77589852008457,998,9.7434869739479
523,476,9.7151051625239,9.77941176470588,999,9.74574574574575
518,478,9.71235521235521,9.79707112970711,996,9.75301204819277
525,474,9.73142857142857,9.78691983122363,999,9.75775775775776
535,463,9.74953271028037,9.79049676025918,998,9.7685370741483
534,465,9.75280898876404,9.78709677419355,999,9.76876876876877
534,464,9.75842696629213,9.7823275862069,998,9.76953907815631
537,461,9.74674115456238,9.78524945770065,998,9.76452905811623
544,454,9.77389705882353,9.78854625550661,998,9.78056112224449
540,457,9.77777777777778,9.80962800875274,997,9.79237713139418
538,460,9.78810408921933,9.81739130434783,998,9.80160320641283
537,461,9.80633147113594,9.8177874186551,998,9.81162324649299
534,465,9.80337078651685,9.82150537634409,999,9.81181181181181
537,461,9.80260707635009,9.81561822125813,998,9.80861723446894
539,458,9.7847866419295,9.81659388646288,997,9.79939819458375
541,458,9.78373382624769,9.81659388646288,999,9.7987987987988
538,461,9.78624535315985,9.80694143167028,999,9.7957957957958
548,450,9.78284671532847,9.81333333333333,998,9.79659318637275
549,450,9.77049180327869,9.82,999,9.79279279279279
547,450,9.76782449725777,9.82888888888889,997,9.79538615847543
543,455,9.76243093922652,9.82857142857143,998,9.79258517034068
551,445,9.7568058076225,9.82022471910112,996,9.785140562249
549,450,9.73952641165756,9.81777777777778,999,9.77477477477477
547,451,9.74040219378428,9.82926829268293,998,9.78056112224449
537,462,9.74301675977654,9.82900432900433,999,9.78278278278278
545,453,9.75596330275229,9.82781456953642,998,9.78857715430862
540,459,9.75185185185185,9.83877995642701,999,9.79179179179179
540,457,9.74814814814815,9.84682713347921,997,9.79338014042126
542,457,9.7380073800738,9.86214442013129,999,9.79479479479479
539,460,9.75324675324675,9.85652173913043,999,9.8008008008008
539,458,9.7569573283859,9.85152838427948,997,9.80040120361083
542,457,9.77121771217712,9.84245076586433,999,9.8038038038038
548,451,9.75912408759124,9.84257206208426,999,9.7967967967968
553,446,9.77396021699819,9.84753363228699,999,9.80680680680681
550,448,9.78,9.84151785714286,998,9.80761523046092
554,444,9.78158844765343,9.8490990990991,998,9.81162324649299
559,440,9.7906976744186,9.84545454545455,999,9.81481481481481
555,444,9.7963963963964,9.83783783783784,999,9.81481481481481
557,442,9.78994614003591,9.82352941176471,999,9.8048048048048
557,441,9.79533213644524,9.81179138321995,998,9.80260521042084
556,442,9.80035971223022,9.81221719457014,998,9.80561122244489
552,446,9.79528985507246,9.81614349775785,998,9.80460921843687
548,451,9.79744525547445,9.81152993348115,999,9.8038038038038
544,455,9.78125,9.7978021978022,999,9.78878878878879
548,450,9.78102189781022,9.78666666666667,998,9.78356713426854
551,448,9.76406533575318,9.80357142857143,999,9.78178178178178
549,450,9.76867030965392,9.80444444444444,999,9.78478478478478
547,452,9.77696526508227,9.80973451327434,999,9.79179179179179
559,440,9.76744186046512,9.81818181818182,999,9.78978978978979
555,443,9.77477477477477,9.81264108352145,998,9.79158316633267
565,433,9.77522123893805,9.8175519630485,998,9.7935871743487
556,443,9.78597122302158,9.8216704288939,999,9.8018018018018
560,439,9.78928571428571,9.82915717539863,999,9.80680680680681
563,435,9.79751332149201,9.84367816091954,998,9.81763527054108
559,440,9.81395348837209,9.84090909090909,999,9.82582582582583
562,436,9.81316725978648,9.85321100917431,998,9.83066132264529
569,429,9.8207381370826,9.87645687645688,998,9.84468937875751
566,433,9.81448763250883,9.8729792147806,999,9.83983983983984
561,438,9.81461675579323,9.86986301369863,999,9.83883883883884
564,435,9.81560283687943,9.88045977011494,999,9.84384384384384
552,445,9.81159420289855,9.88539325842697,997,9.84453360080241
569,428,9.81019332161687,9.89485981308411,997,9.84653961885657
562,436,9.80249110320285,9.89908256880734,998,9.84468937875751
563,436,9.80639431616341,9.90137614678899,999,9.84784784784785
556,442,9.79676258992806,9.90497737556561,998,9.84468937875751
566,433,9.79151943462898,9.90069284064665,999,9.83883883883884
562,435,9.78825622775801,9.90114942528736,997,9.83751253761284
563,435,9.79928952042629,9.89655172413793,998,9.84168336673347
560,438,9.78035714285714,9.90639269406393,998,9.83567134268537
561,437,9.77005347593583,9.90846681922197,998,9.83066132264529
557,441,9.75583482944345,9.90249433106576,998,9.82064128256513
549,449,9.77231329690346,9.90200445434298,998,9.83066132264529
549,450,9.78870673952641,9.89555555555556,999,9.83683683683684
542,457,9.7859778597786,9.90153172866521,999,9.83883883883884
551,448,9.79491833030853,9.91294642857143,999,9.84784784784785
549,449,9.80327868852459,9.90423162583519,998,9.84869739478958
545,453,9.79816513761468,9.90949227373068,998,9.84869739478958
535,463,9.79252336448598,9.90280777537797,998,9.8436873747495
531,468,9.80037664783428,9.9017094017094,999,9.84784784784785
522,475,9.80268199233717,9.89894736842105,997,9.84854563691073
534,462,9.7940074906367,9.89393939393939,996,9.84036144578313
521,477,9.79846449136276,9.89517819706499,998,9.84468937875751
526,473,9.8041825095057,9.90274841437632,999,9.85085085085085
517,482,9.78723404255319,9.90041493775934,999,9.84184184184184
516,482,9.7984496124031,9.89626556016598,998,9.84569138276553
508,488,9.80314960629921,9.89344262295082,996,9.84738955823293
509,489,9.79567779960707,9.90593047034765,998,9.8496993987976
504,494,9.79960317460317,9.90485829959514,998,9.85170340681363
504,492,9.79761904761905,9.90447154471545,996,9.8504016064257
509,489,9.80157170923379,9.9038854805726,998,9.85170340681363
515,484,9.80776699029126,9.90495867768595,999,9.85485485485485
519,478,9.80732177263969,9.90794979079498,997,9.8555667001003
519,479,9.80346820809249,9.91440501043841,998,9.85671342685371
527,472,9.80834914611006,9.91101694915254,999,9.85685685685686
521,477,9.78886756238004,9.90356394129979,998,9.8436873747495
521,477,9.79846449136276,9.90775681341719,998,9.85070140280561
522,477,9.81609195402299,9.90985324947589,999,9.86086086086086
519,480,9.82080924855491,9.90833333333333,999,9.86286286286286
528,471,9.81439393939394,9.91082802547771,999,9.85985985985986
523,475,9.82791586998088,9.90526315789474,998,9.86472945891784
528,470,9.82954545454546,9.91276595744681,998,9.8687374749499
522,476,9.82375478927203,9.91806722689076,998,9.8687374749499
531,468,9.84180790960452,9.91666666666667,999,9.87687687687688
525,473,9.83238095238095,9.90909090909091,998,9.8687374749499
528,471,9.82954545454546,9.91082802547771,999,9.86786786786787
529,469,9.83175803402647,9.90191897654584,998,9.86472945891784
525,474,9.83809523809524,9.89662447257384,999,9.86586586586587
528,470,9.83143939393939,9.90425531914894,998,9.86573146292585
525,473,9.83238095238095,9.8985200845666,998,9.86372745490982
531,466,9.82674199623352,9.89270386266094,997,9.85757271815446
523,475,9.82600382409178,9.89052631578947,998,9.85671342685371
529,468,9.83742911153119,9.89102564102564,997,9.86258776328987
528,471,9.83522727272727,9.8895966029724,999,9.86086086086086
531,467,9.83427495291902,9.88436830835118,998,9.85771543086172
529,470,9.83364839319471,9.88510638297872,999,9.85785785785786
516,482,9.83333333333333,9.88174273858921,998,9.85671342685371
519,479,9.83815028901734,9.88308977035491,998,9.85971943887776
521,477,9.83109404990403,9.88259958071279,998,9.85571142284569
515,482,9.83495145631068,9.89004149377593,997,9.86158475426279
518,481,9.83976833976834,9.8981288981289,999,9.86786786786787
512,485,9.83984375,9.90927835051546,997,9.87362086258776
511,487,9.82974559686888,9.90349075975359,998,9.86573146292585
511,487,9.82583170254403,9.89938398357289,998,9.86172344689379
514,484,9.83657587548638,9.90495867768595,998,9.86973947895792
513,486,9.83820662768031,9.90740740740741,999,9.87187187187187
515,483,9.83495145631068,9.91511387163561,998,9.87374749498998
517,481,9.82785299806576,9.92099792099792,998,9.87274549098196
525,473,9.84,9.9154334038055,998,9.87575150300601
524,474,9.85114503816794,9.90928270042194,998,9.87875751503006
525,473,9.84190476190476,9.9154334038055,998,9.87675350701403
529,470,9.85066162570888,9.91063829787234,999,9.87887887887888
529,470,9.85255198487713,9.90851063829787,999,9.87887887887888
529,469,9.85066162570888,9.90831556503198,998,9.87775551102204
531,466,9.84557438794727,9.90557939914163,997,9.87362086258776
531,468,9.85875706214689,9.91025641025641,999,9.88288288288288
524,475,9.8530534351145,9.90947368421053,999,9.87987987987988
536,463,9.85634328358209,9.91576673866091,999,9.88388388388388
537,460,9.85661080074488,9.91086956521739,997,9.88164493480441
534,464,9.85393258426966,9.90948275862069,998,9.87975951903808
532,467,9.84962406015038,9.90792291220557,999,9.87687687687688
534,464,9.86142322097378,9.90301724137931,998,9.88076152304609
531,468,9.85310734463277,9.90598290598291,999,9.87787787787788
543,455,9.84898710865562,9.90549450549451,998,9.874749498998
540,457,9.8537037037037,9.90809628008753,997,9.87863590772317
546,452,9.85164835164835,9.89823008849558,998,9.87274549098196
546,452,9.85164835164835,9.90486725663717,998,9.87575150300601
548,451,9.85583941605839,9.89578713968958,999,9.87387387387387
543,455,9.85451197053407,9.90769230769231,998,9.87875751503006
542,457,9.8450184501845,9.91466083150985,999,9.87687687687688
535,464,9.85233644859813,9.9051724137931,999,9.87687687687688
528,471,9.84848484848485,9.91082802547771,999,9.87787787787788
518,481,9.84942084942085,9.9002079002079,999,9.87387387387387
522,477,9.85249042145594,9.89937106918239,999,9.87487487487487
509,489,9.83693516699411,9.8997955010225,998,9.86773547094188
508,490,9.8503937007874,9.89387755102041,998,9.87174348697395
514,485,9.84046692607004,9.89896907216495,999,9.86886886886887
521,478,9.83877159309021,9.89121338912134,999,9.86386386386386
529,468,9.83742911153119,9.88247863247863,997,9.85857572718155
546,452,9.85347985347985,9.87389380530973,998,9.8627254509018
550,448,9.85272727272727,9.87946428571429,998,9.86472945891784
550,448,9.85090909090909,9.87946428571429,998,9.86372745490982
553,446,9.85352622061483,9.87443946188341,999,9.86286286286286
561,436,9.84670231729055,9.87385321100918,997,9.85857572718155
555,443,9.84864864864865,9.88261851015801,998,9.86372745490982
555,442,9.85405405405405,9.87782805429864,997,9.86459378134403
554,444,9.85920577617328,9.88288288288288,998,9.86973947895792
559,440,9.86583184257603,9.88409090909091,999,9.87387387387387
555,443,9.86486486486486,9.8803611738149,998,9.87174348697395
559,440,9.86583184257603,9.87727272727273,999,9.87087087087087
560,438,9.86428571428571,9.87442922374429,998,9.8687374749499
558,440,9.8673835125448,9.86818181818182,998,9.86773547094188
557,441,9.87253141831239,9.87755102040816,998,9.874749498998
560,439,9.86964285714286,9.85193621867882,999,9.86186186186186
557,442,9.87253141831239,9.86199095022624,999,9.86786786786787
560,437,9.86071428571429,9.8649885583524,997,9.86258776328987
560,437,9.86785714285714,9.85812356979405,997,9.86359077231695
555,443,9.86486486486486,9.87133182844244,998,9.86773547094188
551,448,9.86751361161524,9.85491071428571,999,9.86186186186186
545,453,9.88623853211009,9.85651214128035,998,9.87274549098196
544,455,9.88235294117647,9.86153846153846,999,9.87287287287287
542,457,9.88929889298893,9.84682713347921,999,9.86986986986987
542,456,9.89852398523985,9.85526315789474,998,9.87875751503006
538,461,9.89591078066914,9.84381778741865,999,9.87187187187187
534,463,9.89138576779026,9.84017278617711,997,9.86760280842528
533,466,9.8968105065666,9.8412017167382,999,9.87087087087087
523,475,9.89483747609943,9.83789473684211,998,9.86773547094188
535,464,9.89345794392523,9.84913793103448,999,9.87287287287287
528,471,9.89204545454546,9.85350318471338,999,9.87387387387387
537,461,9.89199255121043,9.85032537960955,998,9.87274549098196
526,472,9.89163498098859,9.84957627118644,998,9.87174348697395
524,474,9.88931297709924,9.83966244725738,998,9.86573146292585
529,470,9.88090737240076,9.83617021276596,999,9.85985985985986
538,461,9.88289962825279,9.82863340563991,999,9.85785785785786
549,450,9.87613843351548,9.83333333333333,999,9.85685685685686
555,444,9.87207207207207,9.83783783783784,999,9.85685685685686
551,448,9.86388384754991,9.84151785714286,999,9.85385385385385
553,444,9.86437613019891,9.84684684684685,997,9.85656970912738
556,443,9.86151079136691,9.83972911963883,999,9.85185185185185
565,434,9.87079646017699,9.84101382488479,999,9.85785785785786
562,437,9.87188612099644,9.85354691075515,999,9.86386386386386
564,434,9.87765957446809,9.85714285714286,998,9.8687374749499
573,426,9.87783595113438,9.86384976525822,999,9.87187187187187
570,429,9.88070175438597,9.86713286713287,999,9.87487487487487
570,429,9.88245614035088,9.87412587412587,999,9.87887887887888
582,416,9.87800687285223,9.88221153846154,998,9.87975951903808
577,420,9.88388214904679,9.87380952380952,997,9.87963891675025
576,422,9.88888888888889,9.87440758293839,998,9.88276553106212
581,418,9.89156626506024,9.88277511961723,999,9.88788788788789
583,416,9.89536878216123,9.86538461538461,999,9.88288288288288
588,411,9.9030612244898,9.87591240875912,999,9.89189189189189
584,415,9.9041095890411,9.87951807228916,999,9.89389389389389
590,407,9.91016949152542,9.87960687960688,997,9.89769307923771
589,409,9.91850594227504,9.88508557457213,998,9.90480961923848
588,410,9.91836734693878,9.87804878048781,998,9.90180360721443
583,416,9.91766723842196,9.875,999,9.8998998998999
582,416,9.91580756013746,9.875,998,9.89879759519038
573,425,9.92321116928447,9.85647058823529,998,9.89478957915832
573,426,9.92146596858639,9.86150234741784,999,9.8958958958959
569,430,9.91739894551845,9.86046511627907,999,9.89289289289289
571,426,9.91768826619965,9.86150234741784,997,9.89368104312939
583,416,9.91080617495712,9.86538461538461,999,9.89189189189189
579,419,9.91709844559585,9.86157517899761,998,9.8937875751503
578,420,9.92041522491349,9.87619047619048,998,9.90180360721443
582,417,9.92439862542955,9.87769784172662,999,9.9049049049049
584,415,9.92465753424658,9.87710843373494,999,9.9049049049049
583,415,9.92452830188679,9.87228915662651,998,9.90280561122244
587,412,9.92504258943782,9.87378640776699,999,9.9039039039039
577,421,9.92201039861352,9.8812351543943,998,9.90480961923848
589,409,9.92699490662139,9.87530562347188,998,9.90581162324649
581,417,9.92426850258176,9.87529976019185,998,9.90380761523046
579,420,9.93091537132988,9.87857142857143,999,9.90890890890891
571,427,9.93169877408056,9.87822014051522,998,9.90881763527054
577,421,9.92720970537262,9.88361045130641,998,9.90881763527054
566,433,9.93462897526502,9.89145496535797,999,9.91591591591592
574,425,9.93031358885017,9.89882352941176,999,9.91691691691692
567,432,9.93650793650794,9.90046296296296,999,9.92092092092092
569,429,9.93673110720562,9.8997668997669,998,9.92084168336673
574,424,9.94076655052265,9.8938679245283,998,9.92084168336673
581,416,9.93975903614458,9.88942307692308,997,9.91875626880642
579,420,9.93782383419689,9.88809523809524,999,9.91691691691692
579,418,9.93609671848014,9.88995215311005,997,9.91675025075226
583,416,9.93653516295026,9.88942307692308,999,9.91691691691692
580,418,9.93793103448276,9.89712918660287,998,9.92084168336673
576,421,9.93923611111111,9.8978622327791,997,9.92176529588766
570,427,9.94561403508772,9.89227166276347,997,9.92276830491474
572,427,9.95104895104895,9.88992974238876,999,9.92492492492492
576,423,9.95138888888889,9.90070921985816,999,9.92992992992993
579,419,9.95682210708117,9.89498806682577,998,9.93086172344689
575,424,9.95652173913044,9.89150943396226,999,9.92892892892893
574,425,9.95993031358885,9.88941176470588,999,9.92992992992993
572,426,9.95804195804196,9.89201877934272,998,9.92985971943888
569,429,9.95606326889279,9.88811188811189,998,9.92685370741483
557,440,9.95691202872531,9.89090909090909,997,9.92778335005015
553,446,9.96021699819168,9.88789237668161,999,9.92792792792793
555,442,9.95675675675676,9.88914027149321,997,9.92678034102307
551,447,9.95825771324864,9.8903803131991,998,9.92785571142285
555,444,9.96036036036036,9.88963963963964,999,9.92892892892893
552,447,9.96014492753623,9.89485458612975,999,9.93093093093093
548,449,9.95620437956204,9.89755011135857,997,9.92978936810431
555,444,9.95315315315315,9.89864864864865,999,9.92892892892893
558,441,9.94802867383513,9.90022675736961,999,9.92692692692693
552,447,9.94565217391304,9.90156599552573,999,9.92592592592593
553,446,9.94575045207957,9.89686098654709,999,9.92392392392392
551,448,9.94010889292196,9.90401785714286,999,9.92392392392392
547,452,9.94332723948812,9.89823008849558,999,9.92292292292292
542,457,9.93542435424354,9.90590809628009,999,9.92192192192192
548,451,9.94343065693431,9.90243902439024,999,9.92492492492492
553,445,9.94394213381555,9.90786516853933,998,9.92785571142285
555,444,9.94234234234234,9.91891891891892,999,9.93193193193193
550,449,9.93818181818182,9.91759465478842,999,9.92892892892893
550,449,9.93636363636364,9.92204899777283,999,9.92992992992993
552,447,9.93659420289855,9.9261744966443,999,9.93193193193193
549,450,9.93806921675774,9.92444444444445,999,9.93193193193193
561,437,9.93761140819964,9.92677345537757,998,9.93286573146293
561,437,9.93582887700535,9.92448512585812,998,9.93086172344689
554,444,9.93321299638989,9.92117117117117,998,9.92785571142285
558,440,9.93548387096774,9.92045454545454,998,9.92885771543086
565,434,9.93451327433628,9.92626728110599,999,9.93093093093093
573,425,9.93193717277487,9.93176470588235,998,9.93186372745491
577,422,9.92894280762565,9.93601895734597,999,9.93193193193193
574,425,9.93031358885017,9.93647058823529,999,9.93293293293293
577,420,9.93240901213172,9.94047619047619,997,9.9358074222668
574,425,9.93031358885017,9.93882352941177,999,9.93393393393393
571,428,9.93169877408056,9.95560747663551,999,9.94194194194194
575,424,9.92347826086957,9.95990566037736,999,9.93893893893894
578,421,9.92560553633218,9.95724465558195,999,9.93893893893894
575,421,9.91826086956522,9.95961995249406,996,9.93574297188755
575,424,9.92173913043478,9.95990566037736,999,9.93793793793794
569,430,9.92267135325132,9.95581395348837,999,9.93693693693694
570,429,9.91754385964912,9.95337995337995,999,9.93293293293293
564,434,9.91312056737589,9.95161290322581,998,9.92985971943888
568,430,9.9137323943662,9.94883720930233,998,9.92885771543086
572,426,9.91783216783217,9.95070422535211,998,9.93186372745491
576,421,9.90798611111111,9.94061757719715,997,9.92176529588766
574,424,9.91463414634146,9.94339622641509,998,9.92685370741483
575,424,9.91304347826087,9.94811320754717,999,9.92792792792793
571,428,9.91243432574431,9.94158878504673,999,9.92492492492492
576,423,9.91319444444444,9.95035460992908,999,9.92892892892893
566,433,9.90989399293286,9.94688221709007,999,9.92592592592593
564,434,9.91489361702128,9.94930875576037,998,9.92985971943888
564,433,9.90957446808511,9.94688221709007,997,9.92577733199599
562,436,9.91992882562278,9.95183486238532,998,9.93386773547094
570,429,9.91754385964912,9.94871794871795,999,9.93093093093093
567,432,9.91887125220459,9.94444444444444,999,9.92992992992993
569,428,9.93145869947276,9.94626168224299,997,9.93781344032096
569,428,9.92794376098418,9.94392523364486,997,9.93480441323972
573,426,9.93717277486911,9.94366197183099,999,9.93993993993994
566,430,9.93462897526502,9.94651162790698,996,9.93975903614458
566,432,9.9416961130742,9.94675925925926,998,9.9438877755511
573,425,9.94066317626527,9.94352941176471,998,9.94188376753507
571,425,9.93870402802102,9.93882352941177,996,9.93875502008032
580,418,9.93793103448276,9.93540669856459,998,9.93687374749499
575,424,9.93565217391304,9.93160377358491,999,9.93393393393393
568,431,9.93661971830986,9.92575406032483,999,9.93193193193193
565,432,9.93805309734513,9.92361111111111,997,9.93179538615848
567,432,9.93650793650794,9.9375,999,9.93693693693694
569,428,9.93848857644991,9.93224299065421,997,9.9358074222668
579,420,9.93955094991364,9.92619047619048,999,9.93393393393393
576,420,9.94618055555556,9.92619047619048,996,9.93775100401606
574,425,9.94076655052265,9.92,999,9.93193193193193
576,422,9.94618055555556,9.91232227488152,998,9.93186372745491
574,425,9.94076655052265,9.91058823529412,999,9.92792792792793
580,418,9.9448275862069,9.91866028708134,998,9.93386773547094
568,429,9.9419014084507,9.93006993006993,997,9.93681043129388
572,426,9.94230769230769,9.92957746478873,998,9.93687374749499
564,432,9.94148936170213,9.93518518518519,996,9.93875502008032
561,438,9.94295900178253,9.93835616438356,999,9.94094094094094
559,440,9.94454382826476,9.93863636363636,999,9.94194194194194
558,441,9.94086021505376,9.93877551020408,999,9.93993993993994
558,441,9.94802867383513,9.93424036281179,999,9.94194194194194
558,441,9.94623655913978,9.94104308390023,999,9.94394394394394
564,435,9.95035460992908,9.94712643678161,999,9.94894894894895
555,443,9.94954954954955,9.94582392776524,998,9.94789579158317
564,435,9.95035460992908,9.94712643678161,999,9.94894894894895
557,442,9.94973070017953,9.94796380090498,999,9.94894894894895
566,432,9.95406360424028,9.94444444444444,998,9.9498997995992
556,443,9.95503597122302,9.94808126410835,999,9.95195195195195
562,436,9.96085409252669,9.94495412844037,998,9.95390781563126
561,437,9.96434937611408,9.94736842105263,998,9.95691382765531
564,434,9.96276595744681,9.94930875576037,998,9.95691382765531
567,431,9.96119929453263,9.95591647331787,998,9.95891783567134
570,429,9.96666666666667,9.95104895104895,999,9.95995995995996
575,423,9.96695652173913,9.95271867612293,998,9.96092184368737
578,421,9.9757785467128,9.94774346793349,999,9.96396396396396
577,422,9.97746967071057,9.9478672985782,999,9.96496496496496
578,420,9.97750865051903,9.94285714285714,998,9.96292585170341
575,423,9.97565217391304,9.94326241134752,998,9.96192384769539
586,412,9.97952218430034,9.94174757281553,998,9.96392785571142
588,409,9.97789115646258,9.93887530562347,997,9.96188565697091
583,414,9.97770154373928,9.93719806763285,997,9.96088264794383
574,425,9.97560975609756,9.93411764705882,999,9.95795795795796
578,420,9.97923875432526,9.93571428571429,998,9.96092184368737
575,423,9.97739130434783,9.9290780141844,998,9.95691382765531
581,417,9.98106712564544,9.92805755395683,998,9.95891783567134
570,428,9.98245614035088,9.92523364485981,998,9.95791583166333
574,424,9.97909407665505,9.92452830188679,998,9.95591182364729
557,441,9.9802513464991,9.92517006802721,998,9.95591182364729
561,437,9.97860962566845,9.91990846681922,998,9.95290581162325
540,458,9.97962962962963,9.92576419213974,998,9.95490981963928
534,465,9.9812734082397,9.92903225806452,999,9.95695695695696
527,471,9.98102466793169,9.92781316348195,998,9.95591182364729
517,480,9.98065764023211,9.92708333333333,997,9.95486459378134
518,479,9.98069498069498,9.92901878914405,997,9.95586760280842
516,483,9.97868217054264,9.92753623188406,999,9.95395395395395
503,496,9.98011928429423,9.93145161290323,999,9.95595595595596
510,487,9.98235294117647,9.93223819301848,997,9.95787362086259
508,489,9.98031496062992,9.94069529652352,997,9.96088264794383
509,490,9.98231827111984,9.93877551020408,999,9.96096096096096
509,490,9.9803536345776,9.93877551020408,999,9.95995995995996
502,497,9.9800796812749,9.93158953722334,999,9.95595595595596
512,487,9.98046875,9.93018480492813,999,9.95595595595596
501,498,9.98203592814371,9.93172690763052,999,9.95695695695696
510,488,9.98235294117647,9.92827868852459,998,9.95591182364729
512,487,9.98046875,9.92607802874743,999,9.95395395395395
511,487,9.98434442270059,9.92197125256673,998,9.95390781563126
504,495,9.98412698412698,9.92727272727273,999,9.95595595595596
499,500,9.98196392785571,9.918,999,9.94994994994995
499,499,9.98196392785571,9.91783567134268,998,9.9498997995992
504,495,9.98611111111111,9.91313131313131,999,9.94994994994995
504,493,9.98412698412698,9.90669371196755,997,9.94583751253761
505,493,9.98415841584158,9.90466531440162,998,9.94488977955912
504,495,9.98214285714286,9.8949494949495,999,9.93893893893894
508,491,9.98425196850394,9.89205702647658,999,9.93893893893894
503,496,9.98011928429423,9.89112903225806,999,9.93593593593594
503,495,9.98608349900596,9.89292929292929,998,9.93987975951904
490,507,9.98571428571429,9.89940828402367,997,9.94182547642929
489,509,9.98568507157464,9.89783889980354,998,9.94088176352705
499,498,9.98797595190381,9.90361445783133,997,9.94583751253761
503,496,9.98608349900596,9.90322580645161,999,9.94494494494494
503,496,9.98608349900596,9.8991935483871,999,9.94294294294294
498,501,9.98393574297189,9.91017964071856,999,9.94694694694695
492,507,9.98577235772358,9.90335305719921,999,9.94394394394394
497,502,9.98792756539235,9.90637450199203,999,9.94694694694695
496,502,9.98790322580645,9.90637450199203,998,9.94689378757515
498,500,9.98995983935743,9.91,998,9.9498997995992
494,503,9.9919028340081,9.91650099403578,997,9.95386158475426
485,513,9.99175257731959,9.91423001949318,998,9.95190380761523
480,518,9.99166666666667,9.90540540540541,998,9.94689378757515
483,516,9.98964803312629,9.90697674418605,999,9.94694694694695
483,515,9.98757763975155,9.90485436893204,998,9.94488977955912
490,508,9.98571428571429,9.90944881889764,998,9.94689378757515
487,512,9.98973305954826,9.916015625,999,9.95195195195195
487,511,9.98767967145791,9.91976516634051,998,9.95290581162325
494,505,9.98785425101215,9.91881188118812,999,9.95295295295295
497,500,9.98591549295775,9.92,997,9.95285857572718
500,498,9.984,9.92168674698795,998,9.95290581162325
493,506,9.98580121703854,9.92490118577075,999,9.95495495495495
495,503,9.98383838383838,9.92644135188867,998,9.95490981963928
494,505,9.98785425101215,9.93069306930693,999,9.95895895895896
490,509,9.98775510204082,9.93320235756385,999,9.95995995995996
487,512,9.98562628336756,9.9296875,999,9.95695695695696
488,510,9.98975409836066,9.93137254901961,998,9.95991983967936
476,523,9.99159663865546,9.93499043977056,999,9.96196196196196
471,527,9.99363057324841,9.9449715370019,998,9.96793587174349
465,534,9.99139784946237,9.94194756554307,999,9.96496496496496
472,527,9.99152542372881,9.94686907020873,999,9.96796796796797
466,533,9.99141630901287,9.94559099437148,999,9.96696696696697
473,525,9.98942917547569,9.94666666666667,998,9.96693386773547
478,521,9.98953974895398,9.94625719769674,999,9.96696696696697
476,523,9.98949579831933,9.94837476099426,999,9.96796796796797
472,527,9.98940677966102,9.95445920303605,999,9.97097097097097
473,525,9.98942917547569,9.95428571428571,998,9.97094188376754
464,535,9.98922413793103,9.95700934579439,999,9.97197197197197
467,531,9.98929336188437,9.95480225988701,998,9.97094188376754
462,536,9.98701298701299,9.9589552238806,998,9.97194388777555
456,541,9.98684210526316,9.95748613678373,997,9.97091273821464
451,548,9.98447893569845,9.95802919708029,999,9.96996996996997
458,541,9.98471615720524,9.96118299445471,999,9.97197197197197
461,537,9.9826464208243,9.95716945996276,998,9.9689378757515
465,534,9.98279569892473,9.95505617977528,999,9.96796796796797
459,540,9.98039215686275,9.95,999,9.96396396396396
454,545,9.98237885462555,9.94862385321101,999,9.96396396396396
460,539,9.98260869565217,9.95176252319109,999,9.96596596596597
461,537,9.9826464208243,9.94972067039106,998,9.96492985971944
465,533,9.98709677419355,9.94559099437148,998,9.96492985971944
477,521,9.9853249475891,9.94433781190019,998,9.96392785571142
481,517,9.98752598752599,9.94197292069632,998,9.96392785571142
482,516,9.98547717842324,9.94767441860465,998,9.96593186372746
493,505,9.98377281947262,9.95247524752475,998,9.96793587174349
487,511,9.98357289527721,9.95694716242661,998,9.96993987975952
478,521,9.98117154811716,9.95585412667946,999,9.96796796796797
474,525,9.9873417721519,9.95428571428571,999,9.96996996996997
474,523,9.9831223628692,9.95602294455067,997,9.96890672016048
466,533,9.98283261802575,9.96060037523452,999,9.97097097097097
461,538,9.98481561822126,9.95910780669145,999,9.97097097097097
467,531,9.98929336188437,9.95480225988701,998,9.97094188376754
460,539,9.99130434782609,9.95176252319109,999,9.96996996996997
461,538,9.99349240780911,9.95353159851301,999,9.97197197197197
465,533,9.99354838709677,9.95497185741088,998,9.97294589178357
476,523,9.9936974789916,9.95028680688337,999,9.97097097097097
482,516,9.99792531120332,9.95348837209302,998,9.9749498997996
488,511,9.99590163934426,9.95303326810176,999,9.97397397397397
479,520,9.99791231732777,9.94807692307692,999,9.97197197197197
482,516,9.99792531120332,9.94961240310078,998,9.97294589178357
482,517,9.99792531120332,9.9458413926499,999,9.97097097097097
486,513,9.99794238683128,9.94541910331384,999,9.97097097097097
485,513,9.9979381443299,9.94541910331384,998,9.97094188376754
498,501,9.99799196787149,9.94411177644711,999,9.97097097097097
492,505,10.0,9.94257425742574,997,9.97091273821464
499,500,10.0,9.94,999,9.96996996996997
494,503,10.0,9.95029821073559,997,9.97492477432297
500,499,10.0,9.94789579158317,999,9.97397397397397
495,503,10.0,9.94433399602386,998,9.97194388777555
506,493,10.0,9.947261663286,999,9.97397397397397
499,499,10.0,9.94589178356713,998,9.97294589178357
496,503,10.0,9.94433399602386,999,9.97197197197197
494,504,10.0,9.94444444444444,998,9.97194388777555
493,505,10.0,9.94257425742574,998,9.97094188376754
492,505,10.0,9.94257425742574,997,9.97091273821464
493,506,10.0,9.94861660079051,999,9.97397397397397
496,503,10.0,9.95029821073559,999,9.97497497497497
494,505,10.0,9.95841584158416,999,9.97897897897898
494,504,10.0,9.96428571428571,998,9.98196392785571
490,509,10.0,9.96267190569745,999,9.98098098098098
485,511,10.0,9.96086105675147,996,9.97991967871486
488,510,10.0,9.96470588235294,998,9.98196392785571
492,506,10.0,9.96837944664032,998,9.98396793587174
490,507,10.0,9.96646942800789,997,9.98294884653962
501,496,10.0,9.96975806451613,997,9.98495486459378
501,498,10.0,9.9718875502008,999,9.98598598598599
500,498,10.0,9.97590361445783,998,9.98797595190381
495,503,10.0,9.97813121272366,998,9.98897795591182
505,494,10.0,9.97570850202429,999,9.98798798798799
495,502,10.0,9.97808764940239,997,9.98896690070211
494,503,10.0,9.9741550695825,997,9.98696088264794
500,498,10.0,9.97389558232932,998,9.98697394789579
497,501,10.0,9.97604790419162,998,9.98797595190381
499,499,10.0,9.97394789579158,998,9.98697394789579
492,507,10.0,9.97633136094675,999,9.98798798798799
490,508,10.0,9.97244094488189,998,9.98597194388778
496,503,10.0,9.97216699801193,999,9.98598598598599
492,507,10.0,9.97041420118343,999,9.98498498498498
500,498,10.0,9.9718875502008,998,9.98597194388778
500,499,10.0,9.97595190380762,999,9.98798798798799
506,492,10.0,9.97560975609756,998,9.98797595190381
504,495,10.0,9.97575757575758,999,9.98798798798799
509,490,10.0,9.97551020408163,999,9.98798798798799
506,493,10.0,9.973630831643,999,9.98698698698699
512,487,10.0,9.97535934291581,999,9.98798798798799
515,483,10.0,9.97515527950311,998,9.98797595190381
535,463,10.0,9.98056155507559,998,9.99098196392786
535,463,10.0,9.98272138228942,998,9.99198396793587
550,449,10.0,9.98663697104677,999,9.99399399399399
546,452,10.0,9.98672566371681,998,9.9939879759519
549,450,10.0,9.98888888888889,999,9.99499499499499
538,461,10.0,9.98698481561822,999,9.99399399399399
545,454,10.0,9.98678414096916,999,9.99399399399399
538,461,10.0,9.98698481561822,999,9.99399399399399
537,462,10.0,9.98484848484848,999,9.99299299299299
538,461,10.0,9.98698481561822,999,9.99399399399399
541,458,10.0,9.98471615720524,999,9.99299299299299
528,469,10.0,9.98507462686567,997,9.99297893681043
531,468,10.0,9.98931623931624,999,9.99499499499499
523,475,10.0,9.98947368421053,998,9.99498997995992
532,467,10.0,9.98929336188437,999,9.99499499499499
525,474,10.0,9.9873417721519,999,9.99399399399399
526,473,10.0,9.98942917547569,999,9.99499499499499
520,479,10.0,9.9874739039666,999,9.99399399399399
524,474,10.0,9.9873417721519,998,9.9939879759519
515,483,10.0,9.98343685300207,998,9.99198396793587
520,478,10.0,9.98744769874477,998,9.9939879759519
521,477,10.0,9.9853249475891,998,9.99298597194389
519,478,10.0,9.98535564853557,997,9.99297893681043
517,478,10.0,9.98535564853557,995,9.9929648241206
522,477,10.0,9.9874213836478,999,9.99399399399399
527,470,10.0,9.98723404255319,997,9.99398194583751
521,477,10.0,9.9874213836478,998,9.9939879759519
515,483,10.0,9.98757763975155,998,9.9939879759519
510,489,10.0,9.98568507157464,999,9.99299299299299
503,495,10.0,9.98383838383838,998,9.99198396793587
505,493,10.0,9.98782961460446,998,9.9939879759519
501,497,10.0,9.98993963782696,998,9.99498997995992
510,489,10.0,9.98977505112475,999,9.99499499499499
510,489,10.0,9.98977505112475,999,9.99499499499499
511,488,10.0,9.99180327868852,999,9.995995995996
502,496,10.0,9.99193548387097,998,9.99599198396794
506,492,10.0,9.99186991869919,998,9.99599198396794
505,493,10.0,9.99188640973631,998,9.99599198396794
510,488,10.0,9.99180327868852,998,9.99599198396794
511,487,10.0,9.9917864476386,998,9.99599198396794
511,488,10.0,9.99180327868852,999,9.995995995996
506,493,10.0,9.99391480730223,999,9.996996996997
501,496,10.0,9.99395161290323,997,9.99699097291876
503,496,10.0,9.99395161290323,999,9.996996996997
493,504,10.0,9.99404761904762,997,9.99699097291876
490,508,10.0,9.99409448818898,998,9.99699398797595
485,514,10.0,9.99221789883268,999,9.995995995996
481,518,10.0,9.99227799227799,999,9.995995995996
480,519,10.0,9.99421965317919,999,9.996996996997
481,518,10.0,9.99034749034749,999,9.99499499499499
480,518,10.0,9.99227799227799,998,9.99599198396794
477,520,10.0,9.99038461538461,997,9.99498495486459
484,514,10.0,9.98832684824903,998,9.9939879759519
486,512,10.0,9.990234375,998,9.99498997995992
482,516,10.0,9.99031007751938,998,9.99498997995992
473,524,10.0,9.99045801526718,997,9.99498495486459
481,517,10.0,9.98839458413926,998,9.9939879759519
476,523,10.0,9.99043977055449,999,9.99499499499499
481,517,10.0,9.99032882011605,998,9.99498997995992
478,520,10.0,9.98846153846154,998,9.9939879759519
474,524,10.0,9.99045801526718,998,9.99498997995992
477,522,10.0,9.98850574712644,999,9.99399399399399
474,525,10.0,9.99047619047619,999,9.99499499499499
468,531,10.0,9.98870056497175,999,9.99399399399399
469,530,10.0,9.98867924528302,999,9.99399399399399
470,529,10.0,9.98676748582231,999,9.99299299299299
471,526,10.0,9.98859315589354,997,9.99398194583751
470,529,10.0,9.99054820415879,999,9.99499499499499
469,529,10.0,9.99054820415879,998,9.99498997995992
465,531,10.0,9.98870056497175,996,9.99397590361446
467,532,10.0,9.98684210526316,999,9.99299299299299
468,531,10.0,9.984934086629,999,9.99199199199199
465,534,10.0,9.98314606741573,999,9.99099099099099
458,541,10.0,9.98706099815157,999,9.99299299299299
466,532,10.0,9.98684210526316,998,9.99298597194389
471,527,10.0,9.98671726755218,998,9.99298597194389
464,533,10.0,9.98499061913696,997,9.99197592778335
471,527,10.0,9.98671726755218,998,9.99298597194389
460,538,10.0,9.98327137546468,998,9.99098196392786
466,533,10.0,9.98499061913696,999,9.99199199199199
468,531,10.0,9.984934086629,999,9.99199199199199
475,524,10.0,9.98473282442748,999,9.99199199199199
471,527,10.0,9.98481973434535,998,9.99198396793587
463,536,10.0,9.98880597014925,999,9.99399399399399
468,531,10.0,9.98870056497175,999,9.99399399399399
466,531,10.0,9.984934086629,997,9.99197592778335
469,527,10.0,9.98481973434535,996,9.99196787148594
463,535,10.0,9.98317757009346,998,9.99098196392786
464,535,10.0,9.97943925233645,999,9.98898898898899
464,535,10.0,9.97943925233645,999,9.98898898898899
453,545,10.0,9.98348623853211,998,9.99098196392786
446,552,10.0,9.98369565217391,998,9.99098196392786
445,554,10.0,9.98194945848375,999,9.98998998998999
441,557,10.0,9.98204667863555,998,9.98997995991984
445,553,10.0,9.98191681735985,998,9.98997995991984
442,556,10.0,9.98021582733813,998,9.98897795591182
448,551,10.0,9.98366606170599,999,9.99099099099099
449,550,10.0,9.98181818181818,999,9.98998998998999
447,552,10.0,9.98007246376812,999,9.98898898898899
452,547,10.0,9.98354661791591,999,9.99099099099099
451,548,10.0,9.98540145985401,999,9.99199199199199
457,540,10.0,9.98518518518519,997,9.99197592778335
451,547,10.0,9.9872029250457,998,9.99298597194389
451,548,10.0,9.98722627737226,999,9.99299299299299
448,550,10.0,9.98909090909091,998,9.9939879759519
454,544,10.0,9.98713235294118,998,9.99298597194389
454,544,10.0,9.98713235294118,998,9.99298597194389
455,543,10.0,9.98710865561694,998,9.99298597194389
464,532,10.0,9.98872180451128,996,9.99397590361446
463,536,10.0,9.98880597014925,999,9.99399399399399
465,533,10.0,9.9906191369606,998,9.99498997995992
470,528,10.0,9.98863636363636,998,9.9939879759519
467,532,10.0,9.98684210526316,999,9.99299299299299
466,533,10.0,9.98499061913696,999,9.99199199199199
468,531,10.0,9.98305084745763,999,9.99099099099099
465,533,10.0,9.98311444652908,998,9.99098196392786
465,534,10.0,9.98501872659176,999,9.99199199199199
451,546,10.0,9.98534798534799,997,9.99197592778335
461,538,10.0,9.98698884758364,999,9.99299299299299
454,545,10.0,9.98348623853211,999,9.99099099099099
454,545,10.0,9.98348623853211,999,9.99099099099099
448,551,10.0,9.98185117967332,999,9.98998998998999
464,535,10.0,9.98130841121495,999,9.98998998998999
456,542,10.0,9.97970479704797,998,9.98897795591182
462,537,10.0,9.97951582867784,999,9.98898898898899
460,538,10.0,9.9814126394052,998,9.98997995991984
467,532,10.0,9.98496240601504,999,9.99199199199199
455,542,10.0,9.98708487084871,997,9.99297893681043
443,555,10.0,9.98558558558559,998,9.99198396793587
439,560,10.0,9.9875,999,9.99299299299299
438,561,10.0,9.98573975044563,999,9.99199199199199
442,557,10.0,9.98922800718133,999,9.99399399399399
440,559,10.0,9.98747763864043,999,9.99299299299299
438,561,10.0,9.98752228163993,999,9.99299299299299
444,555,10.0,9.98738738738739,999,9.99299299299299
446,553,10.0,9.9873417721519,999,9.99299299299299
451,547,10.0,9.9872029250457,998,9.99298597194389
450,549,10.0,9.98178506375228,999,9.98998998998999
450,549,10.0,9.98178506375228,999,9.98998998998999
458,540,10.0,9.97592592592593,998,9.98697394789579
456,542,10.0,9.9760147601476,998,9.98697394789579
461,538,10.0,9.97211895910781,999,9.98498498498498
466,532,10.0,9.9718045112782,998,9.98496993987976
