forward_num,reverse_num,forward_rate,reverse_rate,organism_num,organism_rate
50,50,5.5,5.5,100,5.5
67,68,5.85074626865672,5.79411764705882,135,5.82222222222222
81,82,6.11111111111111,6.03658536585366,163,6.07361963190184
101,98,6.1980198019802,6.1734693877551,199,6.18592964824121
125,124,6.44,6.53225806451613,249,6.4859437751004
150,157,6.61333333333333,6.68152866242038,307,6.64820846905537
194,205,7.02061855670103,6.98536585365854,399,7.00250626566416
247,244,7.06477732793522,7.21311475409836,491,7.13849287169043
325,312,7.36923076923077,7.45833333333333,637,7.41287284144427
395,420,7.55696202531646,7.56666666666667,815,7.56196319018405
482,516,7.70539419087137,7.77713178294574,998,7.74248496993988
492,507,7.70325203252033,7.74753451676529,999,7.72572572572573
476,523,7.70168067226891,7.80497131931166,999,7.75575575575576
486,512,7.67078189300411,7.849609375,998,7.7625250501002
475,523,7.65684210526316,7.84703632887189,998,7.7565130260521
469,530,7.73347547974414,7.85471698113208,999,7.7977977977978
469,530,7.82515991471215,7.83207547169811,999,7.82882882882883
469,530,7.86780383795309,7.82452830188679,999,7.84484484484484
469,530,7.91684434968017,7.88867924528302,999,7.9019019019019
477,521,7.93920335429769,7.92898272552783,998,7.93386773547094
471,526,7.95116772823779,8.03422053231939,997,7.99498495486459
479,520,7.97077244258873,8.08269230769231,999,8.02902902902903
475,523,7.94736842105263,8.07839388145315,998,8.01603206412826
485,513,7.96288659793814,8.14424951267057,998,8.0561122244489
483,514,7.93995859213251,8.12645914396887,997,8.03610832497492
485,512,8.00412371134021,8.20703125,997,8.10832497492477
487,512,8.04312114989733,8.197265625,999,8.12212212212212
477,522,8.10272536687631,8.2088122605364,999,8.15815815815816
492,507,8.13414634146342,8.23076923076923,999,8.18318318318318
484,515,8.20247933884298,8.24854368932039,999,8.22622622622623
481,518,8.27858627858628,8.27992277992278,999,8.27927927927928
495,503,8.24848484848485,8.32604373757455,998,8.2875751503006
488,510,8.21106557377049,8.34901960784314,998,8.28156312625251
490,509,8.30204081632653,8.36345776031434,999,8.33333333333333
477,522,8.28930817610063,8.38697318007663,999,8.34034034034034
474,524,8.31434599156118,8.39312977099237,998,8.35571142284569
473,526,8.29809725158562,8.42205323193916,999,8.36336336336336
475,524,8.31157894736842,8.3969465648855,999,8.35635635635636
465,534,8.34623655913978,8.38389513108614,999,8.36636636636637
473,524,8.31501057082452,8.45419847328244,997,8.38816449348044
474,525,8.38607594936709,8.52952380952381,999,8.46146146146146
484,515,8.38223140495868,8.53203883495146,999,8.45945945945946
485,513,8.37525773195876,8.54191033138402,998,8.46092184368737
489,509,8.42126789366053,8.54420432220039,998,8.48396793587174
491,506,8.45213849287169,8.55928853754941,997,8.50651955867603
498,501,8.49799196787149,8.5249500998004,999,8.51151151151151
493,506,8.52535496957404,8.59683794466403,999,8.56156156156156
505,494,8.53861386138614,8.61538461538461,999,8.57657657657658
486,513,8.56378600823045,8.62183235867446,999,8.59359359359359
493,506,8.54158215010142,8.65415019762846,999,8.5985985985986
488,509,8.55532786885246,8.69351669941061,997,8.6258776328987
492,507,8.60975609756098,8.66666666666667,999,8.63863863863864
502,496,8.58167330677291,8.6875,998,8.63426853707415
498,501,8.62650602409639,8.73053892215569,999,8.67867867867868
493,505,8.62474645030426,8.73663366336634,998,8.6813627254509
492,507,8.64430894308943,8.7810650887574,999,8.71371371371371
493,506,8.65111561866126,8.81620553359684,999,8.73473473473473
496,502,8.6633064516129,8.79482071713147,998,8.72945891783567
482,516,8.67219917012448,8.8062015503876,998,8.74148296593186
478,520,8.69037656903766,8.78076923076923,998,8.7374749498998
482,516,8.70954356846473,8.83139534883721,998,8.77254509018036
470,529,8.75744680851064,8.82986767485822,999,8.7957957957958
470,527,8.76595744680851,8.86717267552182,997,8.81945837512538
468,531,8.76923076923077,8.86252354048964,999,8.81881881881882
466,532,8.7725321888412,8.82706766917293,998,8.80160320641283
463,535,8.80129589632829,8.86355140186916,998,8.83466933867735
478,521,8.82217573221757,8.87907869481766,999,8.85185185185185
483,516,8.80331262939959,8.91666666666667,999,8.86186186186186
488,510,8.81762295081967,8.91960784313726,998,8.86973947895792
489,509,8.84049079754601,8.91159135559921,998,8.87675350701403
501,498,8.84231536926148,8.89558232931727,999,8.86886886886887
485,514,8.83505154639175,8.9124513618677,999,8.87487487487487
491,507,8.83095723014257,8.86193293885602,998,8.84669338677355
499,499,8.81563126252505,8.85971943887776,998,8.8376753507014
500,499,8.83,8.82364729458918,999,8.82682682682683
501,498,8.83233532934132,8.84738955823293,999,8.83983983983984
505,492,8.81782178217822,8.84552845528455,997,8.83149448345035
505,494,8.80792079207921,8.87246963562753,999,8.83983983983984
504,495,8.8015873015873,8.84848484848485,999,8.82482482482482
512,486,8.826171875,8.88477366255144,998,8.85470941883768
517,479,8.84139264990329,8.90187891440501,996,8.87048192771084
512,487,8.859375,8.90554414784394,999,8.88188188188188
518,480,8.84169884169884,8.91875,998,8.87875751503006
513,485,8.82651072124756,8.91752577319588,998,8.87074148296593
512,487,8.81640625,8.91991786447639,999,8.86686686686687
518,481,8.82046332046332,8.93970893970894,999,8.87787787787788
516,483,8.82945736434108,8.97722567287785,999,8.9009009009009
522,477,8.82950191570881,9.0272536687631,999,8.92392392392392
506,491,8.84189723320158,9.0142566191446,997,8.92678034102307
500,496,8.854,9.02217741935484,996,8.93775100401606
498,499,8.83132530120482,9.0501002004008,997,8.94082246740221
505,491,8.87326732673267,9.05906313645621,996,8.964859437751
499,500,8.8496993987976,9.1,999,8.97497497497497
500,499,8.872,9.12424849699399,999,8.997997997998
493,506,8.87018255578093,9.13241106719368,999,9.003003003003
494,504,8.85627530364373,9.12301587301587,998,8.99098196392786
478,520,8.84309623430962,9.10576923076923,998,8.97995991983968
482,517,8.87551867219917,9.08510638297872,999,8.98398398398398
475,523,8.91578947368421,9.09177820267686,998,9.00801603206413
491,507,8.93686354378819,9.11439842209073,998,9.02705410821643
492,506,8.94105691056911,9.13241106719368,998,9.03807615230461
494,504,8.98785425101215,9.11706349206349,998,9.05310621242485
498,501,8.9718875502008,9.12574850299401,999,9.04904904904905
497,502,8.99195171026157,9.10557768924303,999,9.04904904904905
498,499,8.99799196787149,9.1062124248497,997,9.05215646940822
498,500,8.99799196787149,9.09,998,9.04408817635271
496,502,8.9758064516129,9.09760956175299,998,9.03707414829659
500,499,8.986,9.11623246492986,999,9.05105105105105
499,500,8.9939879759519,9.136,999,9.06506506506507
495,502,9.0040404040404,9.16334661354582,997,9.08425275827482
503,496,9.00596421471173,9.13104838709677,999,9.06806806806807
501,498,8.9940119760479,9.12650602409639,999,9.06006006006006
497,502,9.01207243460765,9.12749003984064,999,9.07007007007007
491,506,9.04073319755601,9.13833992094862,997,9.09027081243731
489,509,9.06952965235174,9.11984282907662,998,9.09519038076152
490,508,9.08571428571429,9.12992125984252,998,9.10821643286573
492,506,9.11382113821138,9.14229249011858,998,9.12825651302605
488,510,9.08811475409836,9.10980392156863,998,9.09919839679359
479,518,9.13987473903967,9.12741312741313,997,9.13340020060181
481,518,9.15800415800416,9.11389961389961,999,9.13513513513514
471,528,9.15711252653928,9.12121212121212,999,9.13813813813814
459,537,9.13943355119826,9.11731843575419,996,9.12751004016064
457,542,9.14660831509847,9.07564575645756,999,9.10810810810811
460,539,9.15869565217391,9.07235621521336,999,9.11211211211211
453,546,9.15894039735099,9.06410256410256,999,9.10710710710711
459,540,9.15032679738562,9.06296296296296,999,9.1031031031031
449,550,9.11581291759465,9.05636363636364,999,9.08308308308308
464,534,9.11853448275862,9.04868913857678,998,9.0811623246493
460,538,9.12608695652174,9.08364312267658,998,9.10320641282565
466,533,9.14163090128755,9.08067542213884,999,9.10910910910911
470,529,9.12127659574468,9.08128544423441,999,9.1001001001001
473,526,9.14376321353066,9.11406844106464,999,9.12812812812813
471,528,9.13163481953291,9.1344696969697,999,9.13313313313313
470,529,9.07872340425532,9.15500945179584,999,9.11911911911912
460,539,9.07608695652174,9.15027829313544,999,9.11611611611612
463,535,9.07343412526998,9.16822429906542,998,9.12424849699399
451,547,9.06651884700665,9.17367458866545,998,9.125250501002
451,547,9.05986696230599,9.15356489945155,998,9.11122244488978
451,547,9.0509977827051,9.18281535648994,998,9.12324649298597
445,553,9.05842696629214,9.16455696202532,998,9.11723446893788
435,564,9.0367816091954,9.17553191489362,999,9.11511511511512
429,570,9.02564102564103,9.18947368421053,999,9.11911911911912
423,575,9.04728132387707,9.17913043478261,998,9.12324649298597
428,571,9.01168224299065,9.18563922942207,999,9.11111111111111
414,585,9.05072463768116,9.22051282051282,999,9.15015015015015
406,593,9.05665024630542,9.19730185497471,999,9.14014014014014
402,597,9.0547263681592,9.22445561139028,999,9.15615615615616
386,610,9.05958549222798,9.20327868852459,996,9.14759036144578
385,614,9.04935064935065,9.19869706840391,999,9.14114114114114
380,618,9.08684210526316,9.18932038834951,998,9.1503006012024
367,631,9.1008174386921,9.16640253565769,998,9.14228456913828
378,621,9.12433862433863,9.19001610305958,999,9.16516516516517
378,620,9.15343915343915,9.18870967741936,998,9.17535070140281
389,609,9.10282776349614,9.19211822660099,998,9.15731462925852
391,607,9.1074168797954,9.18121911037891,998,9.15230460921844
393,604,9.13486005089059,9.1705298013245,997,9.15646940822467
392,607,9.09948979591837,9.18616144975288,999,9.15215215215215
387,609,9.08785529715762,9.21674876847291,996,9.16666666666667
394,605,9.13197969543147,9.19669421487603,999,9.17117117117117
391,607,9.16624040920716,9.20593080724876,998,9.19038076152305
393,606,9.18575063613232,9.21287128712871,999,9.2022022022022
390,609,9.16666666666667,9.22660098522167,999,9.2032032032032
393,606,9.1704834605598,9.21947194719472,999,9.2002002002002
386,612,9.18134715025907,9.22058823529412,998,9.20541082164329
393,606,9.18575063613232,9.21947194719472,999,9.20620620620621
394,604,9.15736040609137,9.20198675496689,998,9.18436873747495
393,604,9.16284987277354,9.21192052980132,997,9.1925777331996
394,604,9.17258883248731,9.17880794701987,998,9.17635270541082
394,604,9.20812182741117,9.19205298013245,998,9.19839679358717
393,606,9.22137404580153,9.1980198019802,999,9.20720720720721
398,600,9.24120603015075,9.17,998,9.19839679358717
398,601,9.28140703517588,9.17304492512479,999,9.21621621621622
401,596,9.28927680798005,9.1761744966443,997,9.22166499498496
396,603,9.26767676767677,9.19734660033168,999,9.22522522522523
402,595,9.28109452736318,9.18487394957983,997,9.22367101303912
402,596,9.25621890547264,9.16778523489933,998,9.20340681362725
403,595,9.26550868486352,9.16302521008403,998,9.20440881763527
399,599,9.24812030075188,9.20367278797997,998,9.22144288577154
396,603,9.23989898989899,9.19900497512438,999,9.21521521521522
392,607,9.23214285714286,9.20098846787479,999,9.21321321321321
403,596,9.23325062034739,9.21644295302013,999,9.22322322322322
396,603,9.20707070707071,9.24709784411277,999,9.23123123123123
391,607,9.23017902813299,9.26194398682043,998,9.24949899799599
384,615,9.22395833333333,9.25528455284553,999,9.24324324324324
393,606,9.23664122137404,9.28052805280528,999,9.26326326326326
378,621,9.22486772486772,9.28180354267311,999,9.26026026026026
374,625,9.22994652406417,9.2736,999,9.25725725725726
369,630,9.22764227642277,9.24920634920635,999,9.24124124124124
381,617,9.21522309711286,9.28200972447326,998,9.2565130260521
373,625,9.22252010723861,9.2832,998,9.26052104208417
377,621,9.22811671087533,9.28985507246377,998,9.26653306613226
377,622,9.25198938992042,9.28778135048232,999,9.27427427427427
373,623,9.24664879356568,9.29695024077047,996,9.2781124497992
374,625,9.24064171122995,9.28,999,9.26526526526527
366,630,9.2568306010929,9.29206349206349,996,9.27911646586345
373,626,9.30831099195711,9.30511182108626,999,9.30630630630631
381,618,9.31496062992126,9.29773462783172,999,9.3043043043043
378,621,9.2962962962963,9.28824476650564,999,9.29129129129129
377,620,9.30769230769231,9.30806451612903,997,9.30792377131394
378,621,9.29365079365079,9.31239935587762,999,9.30530530530531
388,611,9.28092783505155,9.34533551554828,999,9.32032032032032
383,616,9.28198433420365,9.35064935064935,999,9.32432432432432
389,609,9.30334190231362,9.3431855500821,998,9.32765531062124
393,606,9.28753180661578,9.34323432343234,999,9.32132132132132
386,613,9.27979274611399,9.33605220228385,999,9.31431431431431
383,616,9.27937336814621,9.34415584415584,999,9.31931931931932
378,620,9.26719576719577,9.35806451612903,998,9.32364729458918
375,624,9.27466666666667,9.36698717948718,999,9.33233233233233
382,616,9.28795811518325,9.38798701298701,998,9.3496993987976
376,621,9.28989361702128,9.39291465378422,997,9.35406218655968
379,620,9.27704485488127,9.38225806451613,999,9.34234234234234
373,626,9.30026809651475,9.39936102236422,999,9.36236236236236
381,615,9.32283464566929,9.39674796747967,996,9.36847389558233
392,606,9.31632653061224,9.3976897689769,998,9.36573146292585
399,600,9.32080200501253,9.4,999,9.36836836836837
401,597,9.3216957605985,9.39698492462312,998,9.36673346693387
399,599,9.33333333333333,9.36727879799666,998,9.35370741482966
400,596,9.3475,9.36744966442953,996,9.35943775100402
393,605,9.33587786259542,9.37190082644628,998,9.35771543086172
393,604,9.35623409669211,9.38245033112583,997,9.37211634904714
397,602,9.34760705289673,9.38538205980066,999,9.37037037037037
396,602,9.34090909090909,9.39867109634551,998,9.37575150300601
395,604,9.35696202531646,9.42384105960265,999,9.3973973973974
393,606,9.36895674300254,9.41254125412541,999,9.3953953953954
387,611,9.36950904392765,9.40589198036007,998,9.39178356713427
375,624,9.37333333333333,9.41025641025641,999,9.3963963963964
368,629,9.37771739130435,9.42289348171701,997,9.4062186559679
362,636,9.36740331491713,9.42767295597484,998,9.40581162324649
357,640,9.34453781512605,9.4359375,997,9.40320962888666
358,641,9.36871508379888,9.45397815912636,999,9.42342342342342
349,648,9.37822349570201,9.4537037037037,997,9.42728184553661
339,660,9.36873156342183,9.4530303030303,999,9.42442442442442
335,664,9.38208955223881,9.44728915662651,999,9.42542542542543
333,666,9.39339339339339,9.45345345345345,999,9.43343343343343
332,667,9.41867469879518,9.46026986506747,999,9.44644644644645
338,660,9.43786982248521,9.46818181818182,998,9.45791583166333
353,643,9.45609065155807,9.45256609642302,996,9.45381526104418
361,637,9.45983379501385,9.41130298273155,998,9.42885771543086
369,628,9.46612466124661,9.41082802547771,997,9.43129388164493
372,627,9.47043010752688,9.42424242424242,999,9.44144144144144
374,625,9.4572192513369,9.424,999,9.43643643643644
374,623,9.47058823529412,9.41573033707865,997,9.43630892678034
369,629,9.46883468834688,9.42289348171701,998,9.43987975951904
364,633,9.45604395604396,9.45497630331753,997,9.45536609829488
362,636,9.46685082872928,9.47012578616352,998,9.4689378757515
364,635,9.4478021978022,9.48188976377953,999,9.46946946946947
360,638,9.46944444444444,9.49059561128527,998,9.48296593186373
361,637,9.45983379501385,9.50863422291994,998,9.49098196392786
355,642,9.45352112676056,9.51713395638629,997,9.49448345035105
351,648,9.47293447293447,9.52314814814815,999,9.50550550550551
354,644,9.46610169491525,9.50776397515528,998,9.49298597194389
345,654,9.46086956521739,9.52140672782875,999,9.5005005005005
338,661,9.4585798816568,9.5249621785174,999,9.5025025025025
325,673,9.45538461538461,9.52005943536404,998,9.49899799599198
318,681,9.45911949685535,9.52129221732746,999,9.5015015015015
316,681,9.42088607594937,9.53303964757709,997,9.4974924774323
322,677,9.41925465838509,9.54652880354505,999,9.50550550550551
322,676,9.40062111801242,9.55325443786982,998,9.50400801603206
317,679,9.39747634069401,9.5419734904271,996,9.49598393574297
310,689,9.39032258064516,9.54136429608128,999,9.49449449449449
314,684,9.39171974522293,9.5233918128655,998,9.48196392785571
310,688,9.37741935483871,9.52325581395349,998,9.47795591182365
304,695,9.38486842105263,9.5568345323741,999,9.5045045045045
304,693,9.39802631578947,9.55844155844156,997,9.50952858575727
311,686,9.41800643086817,9.57142857142857,997,9.52357071213641
313,685,9.41533546325879,9.56058394160584,998,9.51503006012024
306,691,9.42483660130719,9.55861070911722,997,9.51755265797392
302,696,9.4205298013245,9.56896551724138,998,9.52404809619238
305,694,9.43934426229508,9.54755043227666,999,9.51451451451451
293,706,9.39931740614334,9.55807365439093,999,9.51151151151151
296,703,9.40878378378378,9.56756756756757,999,9.52052052052052
297,700,9.42424242424242,9.55714285714286,997,9.51755265797392
298,700,9.44295302013423,9.56285714285714,998,9.52705410821643
303,695,9.44884488448845,9.58992805755396,998,9.54709418837675
308,690,9.46753246753247,9.58550724637681,998,9.54909819639279
318,681,9.4685534591195,9.59471365638766,999,9.55455455455455
317,680,9.45741324921136,9.58676470588235,997,9.5456369107322
315,684,9.44761904761905,9.59502923976608,999,9.54854854854855
322,677,9.44099378881988,9.59379615952733,999,9.54454454454454
317,682,9.4794952681388,9.58651026392962,999,9.55255255255255
324,675,9.48148148148148,9.59703703703704,999,9.55955955955956
320,677,9.471875,9.59231905465288,997,9.55366098294885
323,675,9.43653250773994,9.60740740740741,998,9.55210420841683
333,665,9.46246246246246,9.60451127819549,998,9.55711422845691
321,678,9.46728971962617,9.59587020648967,999,9.55455455455455
326,672,9.47239263803681,9.58482142857143,998,9.54809619238477
327,670,9.46177370030581,9.58208955223881,997,9.54262788365095
317,682,9.4794952681388,9.59237536656891,999,9.55655655655656
321,678,9.48286604361371,9.58849557522124,999,9.55455455455455
319,679,9.50470219435737,9.58762886597938,998,9.56112224448898
316,683,9.49683544303798,9.60761346998536,999,9.57257257257257
314,685,9.5031847133758,9.6043795620438,999,9.57257257257257
309,690,9.49514563106796,9.60724637681159,999,9.57257257257257
317,682,9.48264984227129,9.6099706744868,999,9.56956956956957
316,680,9.4873417721519,9.6,996,9.56425702811245
304,695,9.48355263157895,9.6158273381295,999,9.57557557557558
303,696,9.48184818481848,9.6264367816092,999,9.58258258258258
288,709,9.48263888888889,9.62905500705219,997,9.58676028084253
281,716,9.47330960854092,9.63268156424581,997,9.58776328986961
276,723,9.48550724637681,9.63070539419087,999,9.59059059059059
286,711,9.47552447552447,9.61603375527426,997,9.57572718154463
276,723,9.45652173913044,9.63900414937759,999,9.58858858858859
279,720,9.46594982078853,9.63333333333333,999,9.58658658658659
282,717,9.45035460992908,9.6513249651325,999,9.59459459459459
285,714,9.48421052631579,9.65546218487395,999,9.60660660660661
284,715,9.46478873239437,9.65594405594406,999,9.6016016016016
292,707,9.44520547945205,9.65346534653465,999,9.59259259259259
294,704,9.46258503401361,9.67613636363636,998,9.61322645290581
301,698,9.4485049833887,9.67478510028653,999,9.60660660660661
302,697,9.45695364238411,9.67144906743185,999,9.60660660660661
301,697,9.43521594684385,9.66571018651363,998,9.59619238476954
306,692,9.41503267973856,9.66329479768786,998,9.5871743486974
309,690,9.43689320388349,9.67536231884058,999,9.6016016016016
312,686,9.43269230769231,9.6734693877551,998,9.59819639278557
320,679,9.465625,9.67304860088365,999,9.60660660660661
329,669,9.46504559270517,9.67414050822123,998,9.60521042084168
328,671,9.49390243902439,9.70193740685544,999,9.63363363363363
336,663,9.48809523809524,9.69230769230769,999,9.62362362362362
331,668,9.4773413897281,9.69011976047904,999,9.61961961961962
331,668,9.46827794561934,9.6811377245509,999,9.61061061061061
344,655,9.46802325581395,9.70076335877863,999,9.62062062062062
342,656,9.47076023391813,9.70274390243902,998,9.62324649298597
339,660,9.49557522123894,9.69393939393939,999,9.62662662662663
348,651,9.49425287356322,9.69431643625192,999,9.62462462462462
340,659,9.47647058823529,9.69650986342944,999,9.62162162162162
349,650,9.50429799426934,9.69538461538462,999,9.62862862862863
341,658,9.48680351906158,9.68693009118541,999,9.61861861861862
344,654,9.48255813953488,9.66207951070336,998,9.6002004008016
330,669,9.46666666666667,9.68609865470852,999,9.61361361361361
338,661,9.47041420118343,9.68229954614221,999,9.61061061061061
337,662,9.47181008902077,9.68429003021148,999,9.61261261261261
329,669,9.49848024316109,9.68011958146487,998,9.62024048096192
317,681,9.4794952681388,9.68869309838473,998,9.62224448897796
319,678,9.49216300940439,9.69469026548673,997,9.62988966900702
310,689,9.45806451612903,9.69230769230769,999,9.61961961961962
318,678,9.47169811320755,9.70058997050148,996,9.62751004016064
312,687,9.47435897435897,9.69723435225619,999,9.62762762762763
319,679,9.5141065830721,9.70692194403535,998,9.64529058116232
316,682,9.5,9.70234604105572,998,9.63827655310621
322,677,9.55900621118012,9.70753323485967,999,9.65965965965966
331,668,9.54984894259819,9.7125748502994,999,9.65865865865866
339,659,9.54867256637168,9.71775417298938,998,9.66032064128257
338,659,9.57100591715976,9.72685887708649,997,9.6740220661986
342,655,9.55555555555556,9.73435114503817,997,9.67301905717151
341,657,9.56598240469208,9.72754946727549,998,9.67234468937876
340,659,9.59117647058824,9.72685887708649,999,9.68068068068068
344,655,9.58720930232558,9.72671755725191,999,9.67867867867868
345,654,9.58260869565217,9.73241590214067,999,9.68068068068068
348,651,9.58045977011494,9.72657450076805,999,9.67567567567568
344,653,9.58720930232558,9.73660030627871,997,9.68505516549649
360,638,9.58333333333333,9.74608150470219,998,9.687374749499
356,643,9.57303370786517,9.75738724727838,999,9.69169169169169
358,638,9.57262569832402,9.75391849529781,996,9.68875502008032
352,646,9.57670454545454,9.76625386996904,998,9.69939879759519
358,641,9.58379888268156,9.77067082683307,999,9.7037037037037
356,642,9.57022471910112,9.76791277258567,998,9.69739478957916
350,647,9.57714285714286,9.7789799072643,997,9.70812437311936
347,652,9.56772334293948,9.76687116564417,999,9.6976976976977
346,653,9.58092485549133,9.78407350689127,999,9.71371371371371
337,660,9.56973293768546,9.77424242424242,997,9.70511534603811
343,655,9.58309037900875,9.78625954198473,998,9.71643286573146
340,658,9.59411764705882,9.78115501519757,998,9.71743486973948
334,664,9.60479041916168,9.77861445783133,998,9.72044088176353
339,659,9.59882005899705,9.77845220030349,998,9.71743486973948
337,662,9.59050445103858,9.77039274924471,999,9.70970970970971
338,661,9.6094674556213,9.76701966717095,999,9.71371371371371
330,668,9.58181818181818,9.75898203592814,998,9.70040080160321
333,665,9.58558558558559,9.75488721804511,998,9.69839679358717
337,661,9.56676557863502,9.75945537065053,998,9.69438877755511
332,666,9.54819277108434,9.75825825825826,998,9.68837675350701
332,666,9.56626506024096,9.75525525525526,998,9.69238476953908
333,665,9.56456456456456,9.77293233082707,998,9.70340681362725
336,662,9.57440476190476,9.77341389728097,998,9.7064128256513
324,675,9.58024691358025,9.77777777777778,999,9.71371371371371
335,662,9.56417910447761,9.77945619335348,997,9.70712136409228
331,667,9.56495468277946,9.78860569715143,998,9.71442885771543
332,667,9.55421686746988,9.79310344827586,999,9.71371371371371
323,675,9.56346749226006,9.8,998,9.72344689378757
316,679,9.57278481012658,9.79970544918999,995,9.72763819095477
314,684,9.56369426751592,9.80555555555556,998,9.72945891783567
311,688,9.57556270096463,9.79796511627907,999,9.72872872872873
312,686,9.56410256410256,9.8134110787172,998,9.73547094188377
317,682,9.54258675078864,9.82697947214076,999,9.73673673673674
320,679,9.528125,9.83946980854197,999,9.73973973973974
317,682,9.54889589905363,9.841642228739,999,9.74874874874875
307,692,9.55700325732899,9.85260115606936,999,9.76176176176176
314,682,9.57006369426752,9.8533724340176,996,9.7640562248996
305,693,9.59672131147541,9.85858585858586,998,9.77855711422846
316,682,9.62025316455696,9.85190615835777,998,9.77855711422846
318,680,9.61320754716981,9.85588235294118,998,9.77855711422846
316,683,9.63924050632911,9.85505124450952,999,9.78678678678679
319,680,9.63322884012539,9.84264705882353,999,9.77577577577578
311,687,9.62379421221865,9.85007278020379,998,9.77955911823647
314,685,9.64331210191083,9.85401459854015,999,9.78778778778779
306,691,9.64052287581699,9.85672937771346,997,9.79037111334002
307,692,9.64495114006515,9.85260115606936,999,9.78878878878879
305,694,9.63606557377049,9.84149855907781,999,9.77877877877878
310,688,9.64516129032258,9.84447674418605,998,9.78256513026052
302,697,9.67549668874172,9.84648493543759,999,9.79479479479479
296,703,9.64527027027027,9.85490753911806,999,9.79279279279279
289,708,9.65051903114187,9.85310734463277,997,9.79438314944835
286,713,9.63636363636364,9.84011220196354,999,9.78178178178178
296,702,9.62837837837838,9.85327635327635,998,9.78657314629259
292,707,9.61643835616438,9.85148514851485,999,9.78278278278278
290,709,9.62413793103448,9.85190409026798,999,9.78578578578579
279,719,9.63799283154122,9.84561891515994,998,9.7875751503006
289,710,9.63667820069204,9.83802816901408,999,9.77977977977978
283,715,9.64310954063604,9.84195804195804,998,9.78557114228457
290,707,9.64827586206897,9.84582743988685,997,9.78836509528586
294,703,9.63945578231293,9.83926031294452,997,9.78034102306921
295,704,9.63050847457627,9.84943181818182,999,9.78478478478478
290,709,9.60344827586207,9.8392101551481,999,9.77077077077077
286,712,9.61888111888112,9.83848314606742,998,9.77555110220441
283,715,9.62897526501767,9.83076923076923,998,9.77354709418838
277,722,9.62454873646209,9.83518005540166,999,9.77677677677678
286,712,9.62587412587413,9.83707865168539,998,9.77655310621243
285,712,9.62105263157895,9.83286516853933,997,9.77231695085256
290,708,9.63103448275862,9.83474576271187,998,9.77555110220441
288,711,9.62847222222222,9.83544303797468,999,9.77577577577578
288,711,9.63541666666667,9.83263009845288,999,9.77577577577578
285,712,9.6140350877193,9.82162921348315,997,9.76228686058175
282,717,9.62056737588652,9.82008368200837,999,9.76376376376376
277,721,9.61371841155235,9.81969486823856,998,9.7625250501002
282,717,9.6241134751773,9.81171548117155,999,9.75875875875876
286,711,9.60839160839161,9.81012658227848,997,9.75225677031093
284,715,9.60915492957746,9.80419580419581,999,9.74874874874875
287,711,9.5993031358885,9.80309423347398,998,9.74448897795591
298,701,9.61073825503356,9.80599144079886,999,9.74774774774775
304,695,9.58881578947368,9.81870503597122,999,9.74874874874875
309,688,9.58576051779935,9.80668604651163,997,9.7382146439318
316,681,9.59810126582278,9.80763582966226,997,9.74122367101304
313,686,9.60702875399361,9.8134110787172,999,9.74874874874875
309,690,9.60194174757282,9.79855072463768,999,9.73773773773774
307,691,9.57654723127036,9.80752532561505,998,9.73647294589178
306,692,9.59803921568627,9.80491329479769,998,9.74148296593186
303,696,9.59075907590759,9.80747126436782,999,9.74174174174174
303,696,9.5973597359736,9.81896551724138,999,9.75175175175175
297,702,9.6026936026936,9.82051282051282,999,9.75575575575576
297,702,9.59259259259259,9.82051282051282,999,9.75275275275275
288,711,9.57986111111111,9.81997187060478,999,9.75075075075075
280,717,9.59285714285714,9.83124128312413,997,9.76429287863591
272,726,9.58088235294118,9.82782369146006,998,9.76052104208417
271,724,9.59778597785978,9.83149171270718,995,9.7678391959799
272,724,9.61029411764706,9.82458563535912,996,9.76606425702811
272,727,9.58823529411765,9.82530949105915,999,9.76076076076076
271,727,9.5830258302583,9.81292984869326,998,9.75050100200401
274,723,9.57299270072993,9.8118948824343,997,9.74623871614845
276,723,9.56159420289855,9.82157676348548,999,9.74974974974975
284,715,9.57394366197183,9.82937062937063,999,9.75675675675676
283,715,9.58303886925795,9.83216783216783,998,9.76152304609218
287,711,9.58536585365854,9.83544303797468,998,9.76352705410822
277,721,9.5812274368231,9.82801664355062,998,9.75951903807615
276,722,9.56884057971014,9.83656509695291,998,9.7625250501002
272,726,9.58823529411765,9.83195592286501,998,9.76553106212425
279,719,9.58781362007169,9.82336578581363,998,9.75751503006012
279,720,9.59139784946237,9.83472222222222,999,9.76676676676677
270,729,9.57407407407407,9.82578875171468,999,9.75775775775776
271,728,9.54981549815498,9.82142857142857,999,9.74774774774775
264,735,9.56439393939394,9.81360544217687,999,9.74774774774775
262,736,9.5381679389313,9.79891304347826,998,9.73046092184369
254,744,9.53937007874016,9.78897849462366,998,9.72545090180361
256,743,9.5625,9.79542395693136,999,9.73573573573574
251,746,9.55378486055777,9.79490616621984,997,9.73420260782347
241,757,9.56846473029046,9.8110964332893,998,9.75250501002004
241,758,9.53941908713693,9.79947229551451,999,9.73673673673674
236,763,9.55508474576271,9.78899082568807,999,9.73373373373373
236,763,9.58898305084746,9.77457404980341,999,9.73073073073073
238,761,9.5672268907563,9.77792378449409,999,9.72772772772773
236,762,9.59745762711864,9.77952755905512,998,9.73647294589178
236,762,9.57627118644068,9.79658792650919,998,9.74448897795591
232,767,9.55603448275862,9.79661016949153,999,9.74074074074074
236,763,9.5593220338983,9.79292267365662,999,9.73773773773774
239,760,9.51882845188284,9.79473684210526,999,9.72872872872873
242,756,9.54132231404959,9.8015873015873,998,9.73847695390782
241,757,9.54771784232365,9.7886393659181,998,9.73046092184369
243,756,9.55144032921811,9.8015873015873,999,9.74074074074074
244,754,9.55327868852459,9.81034482758621,998,9.74749498997996
246,753,9.49593495934959,9.81009296148738,999,9.73273273273273
241,756,9.57261410788382,9.82142857142857,997,9.76128385155466
240,759,9.59166666666667,9.80632411067194,999,9.75475475475475
240,759,9.6,9.81818181818182,999,9.76576576576577
242,756,9.61157024793388,9.81349206349206,998,9.76452905811623
240,758,9.58333333333333,9.81266490765172,998,9.75751503006012
243,756,9.5843621399177,9.82275132275132,999,9.76476476476476
247,750,9.60323886639676,9.82533333333333,997,9.7703109327984
249,750,9.59036144578313,9.82266666666667,999,9.76476476476476
255,744,9.59607843137255,9.83602150537634,999,9.77477477477477
255,743,9.59607843137255,9.8492597577389,998,9.78456913827655
252,747,9.63492063492063,9.83534136546185,999,9.78478478478478
254,743,9.63779527559055,9.83849259757739,997,9.78736208625878
259,739,9.66023166023166,9.83355886332882,998,9.78857715430862
251,747,9.68127490039841,9.82597054886211,998,9.78957915831663
254,745,9.68503937007874,9.83221476510067,999,9.79479479479479
248,751,9.67338709677419,9.83621837549933,999,9.7957957957958
247,749,9.65991902834008,9.826435246996,996,9.785140562249
251,748,9.63745019920319,9.83021390374332,999,9.78178178178178
258,741,9.65116279069767,9.81241565452092,999,9.77077077077077
251,748,9.63346613545817,9.82219251336898,999,9.77477477477477
249,749,9.61847389558233,9.81308411214953,998,9.76452905811623
243,755,9.60905349794239,9.79867549668874,998,9.75250501002004
245,753,9.6,9.80345285524568,998,9.75350701402806
249,749,9.58232931726908,9.7890520694259,998,9.7374749498998
244,755,9.56967213114754,9.80529801324503,999,9.74774774774775
255,743,9.57647058823529,9.81157469717362,998,9.75150300601202
254,744,9.57086614173228,9.81586021505376,998,9.75350701402806
260,739,9.55769230769231,9.81732070365359,999,9.74974974974975
259,738,9.55598455598456,9.81029810298103,997,9.74423269809428
258,741,9.55038759689922,9.81646423751687,999,9.74774774774775
257,741,9.54474708171206,9.8191632928475,998,9.74849699398798
255,743,9.56470588235294,9.82637954239569,998,9.75951903807615
258,741,9.56201550387597,9.82860998650472,999,9.75975975975976
256,741,9.578125,9.82726045883941,997,9.76328986960883
260,739,9.55384615384615,9.8254397834912,999,9.75475475475475
257,741,9.56031128404669,9.83535762483131,998,9.76452905811623
256,741,9.54296875,9.83130904183536,997,9.75727181544634
254,743,9.52755905511811,9.83445491251682,997,9.75626880641926
250,748,9.548,9.84090909090909,998,9.76753507014028
255,742,9.55686274509804,9.83962264150943,997,9.76730190571715
257,742,9.57587548638132,9.83827493261455,999,9.77077077077077
255,743,9.6,9.83849259757739,998,9.77755511022044
257,739,9.60311284046693,9.84303112313938,996,9.78112449799197
253,745,9.61264822134387,9.83221476510067,998,9.77655310621243
251,748,9.59362549800797,9.82085561497326,999,9.76376376376376
249,750,9.60642570281125,9.82266666666667,999,9.76876876876877
241,758,9.62240663900415,9.82189973614776,999,9.77377377377377
235,764,9.60425531914894,9.81151832460733,999,9.76276276276276
226,772,9.61504424778761,9.80958549222798,998,9.76553106212425
222,776,9.6036036036036,9.81701030927835,998,9.76953907815631
220,778,9.60454545454546,9.80077120822622,998,9.75751503006012
210,788,9.6047619047619,9.80964467005076,998,9.76653306613226
209,789,9.56937799043062,9.79214195183777,998,9.74549098196393
207,791,9.58454106280193,9.80404551201011,998,9.75851703406814
211,786,9.56398104265403,9.80407124681934,997,9.75325977933801
209,790,9.55980861244019,9.80253164556962,999,9.75175175175175
221,778,9.57013574660633,9.79305912596401,999,9.74374374374374
221,777,9.56108597285068,9.7966537966538,998,9.74448897795591
212,787,9.58490566037736,9.79669631512071,999,9.75175175175175
209,790,9.55023923444976,9.81139240506329,999,9.75675675675676
210,789,9.59523809523809,9.81622306717364,999,9.76976976976977
209,790,9.55980861244019,9.80506329113924,999,9.75375375375375
221,775,9.57013574660633,9.80774193548387,996,9.75502008032129
217,779,9.5668202764977,9.81386392811297,996,9.76004016064257
221,777,9.55656108597285,9.81724581724582,998,9.75951903807615
223,776,9.56502242152466,9.81443298969072,999,9.75875875875876
212,786,9.54245283018868,9.81933842239186,998,9.76052104208417
201,798,9.50746268656716,9.81203007518797,999,9.75075075075075
204,794,9.5343137254902,9.81108312342569,998,9.75450901803607
191,808,9.49214659685864,9.81311881188119,999,9.75175175175175
195,804,9.49230769230769,9.81218905472637,999,9.74974974974975
191,807,9.5130890052356,9.81288723667906,998,9.75551102204409
194,805,9.49484536082474,9.8111801242236,999,9.74974974974975
195,804,9.51282051282051,9.81094527363184,999,9.75275275275275
192,807,9.53125,9.81908302354399,999,9.76376376376376
190,807,9.57368421052632,9.817843866171,997,9.77131394182548
192,805,9.546875,9.81987577639751,997,9.76730190571715
187,812,9.54545454545454,9.83004926108374,999,9.77677677677678
185,813,9.54054054054054,9.8290282902829,998,9.77555110220441
187,812,9.55080213903743,9.83620689655172,999,9.78278278278278
178,821,9.53932584269663,9.83434835566382,999,9.78178178178178
181,818,9.56353591160221,9.83374083129584,999,9.78478478478478
182,817,9.57142857142857,9.83108935128519,999,9.78378378378378
188,811,9.55851063829787,9.82860665844636,999,9.77777777777778
186,813,9.55913978494624,9.83271832718327,999,9.78178178178178
180,819,9.57222222222222,9.84004884004884,999,9.79179179179179
183,816,9.56830601092896,9.84558823529412,999,9.79479479479479
189,809,9.61375661375661,9.8442521631644,998,9.80060120240481
188,811,9.60106382978723,9.84833538840937,999,9.8018018018018
193,806,9.60103626943005,9.84739454094293,999,9.7997997997998
193,806,9.60621761658031,9.8424317617866,999,9.7967967967968
187,809,9.59893048128342,9.84054388133498,996,9.79518072289157
189,810,9.62962962962963,9.8358024691358,999,9.7967967967968
191,807,9.61780104712042,9.84014869888476,998,9.79759519038076
198,800,9.63131313131313,9.84375,998,9.80160320641283
192,807,9.640625,9.8364312267658,999,9.7987987987988
192,807,9.671875,9.84138785625774,999,9.80880880880881
188,810,9.67553191489362,9.82962962962963,998,9.80060120240481
196,803,9.68877551020408,9.8318804483188,999,9.8038038038038
187,812,9.71122994652406,9.83251231527094,999,9.80980980980981
193,806,9.72538860103627,9.83746898263027,999,9.81581581581582
191,807,9.7434554973822,9.83767038413879,998,9.81963927855711
193,806,9.74611398963731,9.82630272952854,999,9.81081081081081
193,806,9.73575129533679,9.82754342431762,999,9.80980980980981
188,811,9.72872340425532,9.82614056720099,999,9.80780780780781
184,813,9.72282608695652,9.83025830258303,997,9.81043129388165
185,814,9.71351351351351,9.83660933660934,999,9.81381381381381
189,807,9.68253968253968,9.84138785625774,996,9.81124497991968
183,816,9.69398907103825,9.84313725490196,999,9.81581581581582
184,813,9.66847826086956,9.84747847478475,997,9.81444332998997
183,814,9.6448087431694,9.84643734643735,997,9.80942828485456
187,812,9.61497326203209,9.84605911330049,999,9.8028028028028
187,811,9.59893048128342,9.86436498150432,998,9.81462925851703
184,813,9.60326086956522,9.86223862238622,997,9.81444332998997
187,812,9.5668449197861,9.86206896551724,999,9.80680680680681
184,815,9.57065217391304,9.86625766871166,999,9.81181181181181
186,812,9.56989247311828,9.85344827586207,998,9.80060120240481
181,816,9.59668508287293,9.85661764705882,997,9.80942828485456
181,815,9.62983425414365,9.85644171779141,996,9.81526104417671
178,821,9.57865168539326,9.84409257003654,999,9.7967967967968
181,817,9.60220994475138,9.84700122399021,998,9.80260521042084
175,821,9.59428571428571,9.84165651644336,996,9.79819277108434
174,825,9.60344827586207,9.84363636363636,999,9.8018018018018
176,821,9.59659090909091,9.84774665042631,997,9.80341023069208
164,835,9.58536585365854,9.85508982035928,999,9.81081081081081
162,836,9.58641975308642,9.84928229665072,998,9.80661322645291
163,836,9.57668711656442,9.84808612440191,999,9.8038038038038
166,833,9.55421686746988,9.85354141656663,999,9.8038038038038
163,836,9.52147239263804,9.85287081339713,999,9.7987987987988
160,838,9.53125,9.85441527446301,998,9.80260521042084
161,838,9.54037267080745,9.8508353221957,999,9.8008008008008
156,841,9.53205128205128,9.85612366230678,997,9.80541624874624
151,848,9.48344370860927,9.85731132075472,999,9.8008008008008
145,854,9.51034482758621,9.86065573770492,999,9.80980980980981
140,859,9.52857142857143,9.85681024447031,999,9.81081081081081
146,853,9.50684931506849,9.85580304806565,999,9.8048048048048
143,854,9.53146853146853,9.85480093676815,997,9.80842527582748
145,853,9.53793103448276,9.8546307151231,998,9.80861723446894
143,855,9.58741258741259,9.83976608187134,998,9.80360721442886
147,850,9.59183673469388,9.83764705882353,997,9.80140421263791
145,854,9.5448275862069,9.83723653395785,999,9.79479479479479
144,855,9.54861111111111,9.83157894736842,999,9.79079079079079
142,855,9.52816901408451,9.83742690058479,997,9.79338014042126
145,854,9.48965517241379,9.83723653395785,999,9.78678678678679
140,857,9.47142857142857,9.84480746791132,997,9.79237713139418
148,851,9.44594594594595,9.84136310223267,999,9.78278278278278
144,854,9.44444444444444,9.83606557377049,998,9.77955911823647
147,852,9.46938775510204,9.84154929577465,999,9.78678678678679
150,849,9.48,9.82921083627797,999,9.77677677677678
146,851,9.47945205479452,9.8331374853114,997,9.78134403209629
152,845,9.48684210526316,9.83195266272189,997,9.77933801404213
145,853,9.47586206896552,9.82883939038687,998,9.77755511022044
134,863,9.47014925373134,9.82850521436848,997,9.78034102306921
133,864,9.41353383458647,9.8287037037037,997,9.77331995987964
130,867,9.41538461538462,9.84083044982699,997,9.78535606820461
128,870,9.3828125,9.8448275862069,998,9.78557114228457
126,873,9.42063492063492,9.84306987399771,999,9.78978978978979
115,884,9.39130434782609,9.85067873303167,999,9.7977977977978
115,884,9.37391304347826,9.85294117647059,999,9.7977977977978
115,884,9.39130434782609,9.85972850678733,999,9.80580580580581
119,879,9.43697478991597,9.8646188850967,998,9.81362725450902
120,879,9.38333333333333,9.85551763367463,999,9.7987987987988
119,879,9.43697478991597,9.85893060295791,998,9.80861723446894
121,878,9.4297520661157,9.8496583143508,999,9.7987987987988
118,881,9.46610169491525,9.84903518728717,999,9.8038038038038
122,876,9.45901639344262,9.84817351598173,998,9.80060120240481
125,874,9.456,9.83752860411899,999,9.78978978978979
125,874,9.456,9.83981693363844,999,9.79179179179179
125,873,9.448,9.83161512027491,998,9.78356713426854
130,868,9.43076923076923,9.83064516129032,998,9.77855711422846
131,868,9.48091603053435,9.8352534562212,999,9.78878878878879
133,866,9.46616541353383,9.82332563510393,999,9.77577577577578
134,865,9.49253731343284,9.82890173410405,999,9.78378378378378
140,859,9.50714285714286,9.82305005820722,999,9.77877877877878
132,864,9.48484848484848,9.82523148148148,996,9.78012048192771
139,860,9.52517985611511,9.82790697674419,999,9.78578578578579
140,859,9.50714285714286,9.84051222351572,999,9.79379379379379
142,857,9.53521126760563,9.84830805134189,999,9.8038038038038
130,869,9.5,9.84695051783659,999,9.8018018018018
130,869,9.53846153846154,9.8457997698504,999,9.80580580580581
123,876,9.48780487804878,9.84931506849315,999,9.8048048048048
124,874,9.49193548387097,9.84782608695652,998,9.80360721442886
123,875,9.45528455284553,9.85714285714286,998,9.80761523046092
120,879,9.51666666666667,9.86120591581343,999,9.81981981981982
115,882,9.48695652173913,9.86507936507937,997,9.82146439317954
116,883,9.53448275862069,9.86296715741789,999,9.82482482482482
109,890,9.55045871559633,9.85842696629213,999,9.82482482482482
112,886,9.54464285714286,9.8589164785553,998,9.82364729458918
111,888,9.55855855855856,9.86936936936937,999,9.83483483483483
104,894,9.55769230769231,9.87136465324385,998,9.83867735470942
101,897,9.63366336633663,9.87848383500557,998,9.85370741482966
95,904,9.67368421052632,9.87389380530973,999,9.85485485485485
102,897,9.67647058823529,9.87736900780379,999,9.85685685685686
106,893,9.65094339622642,9.87793952967525,999,9.85385385385385
112,887,9.67857142857143,9.88049605411499,999,9.85785785785786
116,882,9.64655172413793,9.88888888888889,998,9.86072144288577
125,874,9.656,9.88901601830664,999,9.85985985985986
128,868,9.6328125,9.8905529953917,996,9.8574297188755
132,866,9.65909090909091,9.89607390300231,998,9.86472945891784
133,864,9.65413533834587,9.89583333333333,997,9.86359077231695
135,863,9.68148148148148,9.9026651216686,998,9.87274549098196
140,859,9.65714285714286,9.90919674039581,999,9.87387387387387
147,851,9.6734693877551,9.90599294947121,998,9.87174348697395
139,859,9.68345323741007,9.90919674039581,998,9.87775551102204
141,858,9.66666666666667,9.91025641025641,999,9.87587587587588
145,854,9.67586206896552,9.90749414519906,999,9.87387387387387
142,855,9.6830985915493,9.90760233918129,997,9.87562688064193
138,859,9.67391304347826,9.90337601862631,997,9.8716148445336
143,856,9.65034965034965,9.9018691588785,999,9.86586586586587
137,861,9.64233576642336,9.89663182346109,998,9.86172344689379
139,860,9.67625899280575,9.90116279069767,999,9.86986986986987
136,861,9.66176470588235,9.90940766550523,997,9.87562688064193
136,863,9.66176470588235,9.9026651216686,999,9.86986986986987
140,859,9.64285714285714,9.90570430733411,999,9.86886886886887
145,851,9.66896551724138,9.90364277320799,996,9.86947791164659
151,847,9.67549668874172,9.90672963400236,998,9.87174348697395
149,849,9.70469798657718,9.90106007067138,998,9.87174348697395
157,842,9.70700636942675,9.89667458432304,999,9.86686686686687
161,838,9.75776397515528,9.89737470167064,999,9.87487487487487
163,836,9.7361963190184,9.89952153110048,999,9.87287287287287
160,839,9.75625,9.9046483909416,999,9.88088088088088
166,833,9.7710843373494,9.90516206482593,999,9.88288288288288
167,831,9.74251497005988,9.90373044524669,998,9.87675350701403
167,831,9.72455089820359,9.90854392298436,998,9.87775551102204
167,831,9.7065868263473,9.90132370637786,998,9.8687374749499
163,834,9.7361963190184,9.8968824940048,997,9.87061183550652
157,838,9.74522292993631,9.89618138424821,995,9.87236180904523
162,837,9.75925925925926,9.90083632019116,999,9.87787787787788
165,834,9.76969696969697,9.90407673860911,999,9.88188188188188
167,832,9.80239520958084,9.90625,999,9.88888888888889
171,828,9.8187134502924,9.91666666666667,999,9.8998998998999
170,829,9.82352941176471,9.92038600723764,999,9.9039039039039
171,827,9.81286549707602,9.92140266021765,998,9.90280561122244
170,827,9.81764705882353,9.92382103990326,997,9.90571715145436
172,827,9.80813953488372,9.92986698911729,999,9.90890890890891
177,822,9.79661016949153,9.93430656934307,999,9.90990990990991
171,828,9.7953216374269,9.93357487922705,999,9.90990990990991
179,820,9.7877094972067,9.94024390243902,999,9.91291291291291
163,836,9.76687116564417,9.94258373205742,999,9.91391391391391
169,830,9.76331360946746,9.94096385542169,999,9.91091091091091
163,836,9.74233128834356,9.94258373205742,999,9.90990990990991
168,829,9.74404761904762,9.94089264173703,997,9.90772316950853
167,831,9.73652694610778,9.94464500601685,998,9.90981963927856
171,828,9.75438596491228,9.94082125603865,999,9.90890890890891
164,834,9.73780487804878,9.93405275779376,998,9.90180360721443
169,829,9.75147928994083,9.93244873341375,998,9.90180360721443
167,830,9.73652694610778,9.92530120481928,997,9.89368104312939
164,835,9.71341463414634,9.92215568862276,999,9.88788788788789
171,828,9.71929824561403,9.91666666666667,999,9.88288288288288
171,828,9.71345029239766,9.91545893719807,999,9.88088088088088
179,819,9.72067039106145,9.91941391941392,998,9.88376753507014
172,826,9.7093023255814,9.92009685230024,998,9.88376753507014
172,827,9.7093023255814,9.92140266021765,999,9.88488488488488
166,831,9.70481927710843,9.9193742478941,997,9.88365095285858
167,830,9.7125748502994,9.92168674698795,997,9.88665997993982
169,829,9.68639053254438,9.92641737032569,998,9.88577154308617
172,827,9.7093023255814,9.92623941958887,999,9.88888888888889
167,832,9.72455089820359,9.93028846153846,999,9.8958958958959
164,835,9.71951219512195,9.92694610778443,999,9.89289289289289
165,834,9.6969696969697,9.92925659472422,999,9.89089089089089
172,827,9.68604651162791,9.9310761789601,999,9.88888888888889
173,824,9.72254335260116,9.93082524271845,997,9.89468405215647
166,833,9.74698795180723,9.93037214885954,999,9.8998998998999
171,827,9.72514619883041,9.92503022974607,998,9.89078156312625
176,823,9.73863636363636,9.92345078979344,999,9.89089089089089
176,823,9.71022727272727,9.92466585662211,999,9.88688688688689
175,824,9.73714285714286,9.91990291262136,999,9.88788788788789
176,823,9.74431818181818,9.91616038882139,999,9.88588588588589
181,816,9.72375690607735,9.91666666666667,997,9.88164493480441
180,819,9.75555555555556,9.91697191697192,999,9.88788788788789
181,818,9.75138121546961,9.91687041564792,999,9.88688688688689
182,816,9.73626373626374,9.91299019607843,998,9.88076152304609
174,825,9.74137931034483,9.91636363636364,999,9.88588588588589
169,830,9.73372781065089,9.91325301204819,999,9.88288288288288
164,834,9.75,9.9220623501199,998,9.8937875751503
164,835,9.76829268292683,9.92215568862276,999,9.8968968968969
170,829,9.75294117647059,9.92279855247286,999,9.89389389389389
170,829,9.75294117647059,9.92400482509047,999,9.89489489489489
168,831,9.75,9.92418772563177,999,9.89489489489489
174,824,9.7183908045977,9.92233009708738,998,9.88677354709419
179,820,9.73184357541899,9.92560975609756,999,9.89089089089089
178,819,9.68539325842697,9.92429792429792,997,9.88164493480441
177,822,9.66666666666667,9.9294403892944,999,9.88288288288288
184,815,9.68478260869565,9.93374233128834,999,9.88788788788789
182,817,9.67582417582418,9.937576499388,999,9.88988988988989
181,818,9.67403314917127,9.93398533007335,999,9.88688688688689
179,818,9.67039106145251,9.93765281173594,997,9.88966900702106
183,815,9.66666666666667,9.93865030674847,998,9.88877755511022
186,813,9.68279569892473,9.93357933579336,999,9.88688688688689
193,806,9.70466321243523,9.93796526054591,999,9.89289289289289
194,805,9.75257731958763,9.94285714285714,999,9.90590590590591
194,804,9.75257731958763,9.93781094527363,998,9.90180360721443
196,803,9.75,9.93648816936488,999,9.8998998998999
191,807,9.76439790575916,9.93556381660471,998,9.90280561122244
202,795,9.76237623762376,9.93836477987421,997,9.90270812437312
203,795,9.76354679802956,9.93459119496855,998,9.8997995991984
201,796,9.76119402985075,9.93592964824121,997,9.90070210631896
198,799,9.75757575757576,9.93992490613267,997,9.9037111334002
195,804,9.75897435897436,9.93781094527363,999,9.9029029029029
189,809,9.77777777777778,9.94066749072929,998,9.90981963927856
184,815,9.77717391304348,9.9398773006135,999,9.90990990990991
189,808,9.79365079365079,9.94306930693069,997,9.91474423269809
182,814,9.76923076923077,9.93857493857494,996,9.90763052208835
179,820,9.78212290502793,9.93780487804878,999,9.90990990990991
176,822,9.77272727272727,9.94160583941606,998,9.91182364729459
180,819,9.79444444444444,9.93894993894994,999,9.91291291291291
175,823,9.78857142857143,9.9453219927096,998,9.91783567134268
179,817,9.7877094972067,9.94002447980416,996,9.91265060240964
180,818,9.78333333333333,9.94254278728606,998,9.91382765531062
185,813,9.77837837837838,9.9409594095941,998,9.91082164328657
183,816,9.78688524590164,9.93627450980392,999,9.90890890890891
187,810,9.78609625668449,9.93950617283951,997,9.91073219658977
188,811,9.79255319148936,9.9383477188656,999,9.91091091091091
187,812,9.80213903743316,9.9371921182266,999,9.91191191191191
194,804,9.79381443298969,9.94154228855721,998,9.9128256513026
194,805,9.79381443298969,9.93664596273292,999,9.90890890890891
198,801,9.8030303030303,9.93258426966292,999,9.90690690690691
194,804,9.81958762886598,9.93283582089552,998,9.91082164328657
198,800,9.82828282828283,9.93375,998,9.9128256513026
195,804,9.81538461538462,9.93407960199005,999,9.91091091091091
202,797,9.81188118811881,9.93601003764115,999,9.91091091091091
199,797,9.80904522613065,9.9435382685069,996,9.91666666666667
206,792,9.81067961165049,9.9469696969697,998,9.9188376753507
205,793,9.80487804878049,9.94199243379571,998,9.91382765531062
209,790,9.80861244019139,9.94303797468354,999,9.91491491491491
209,790,9.79425837320574,9.94050632911392,999,9.90990990990991
209,789,9.79425837320574,9.93789607097592,998,9.90781563126252
203,795,9.79310344827586,9.93962264150943,998,9.90981963927856
214,784,9.79439252336449,9.93494897959184,998,9.90480961923848
212,787,9.80188679245283,9.94536213468869,999,9.91491491491491
217,780,9.79723502304148,9.94487179487179,997,9.91273821464393
210,788,9.8,9.94289340101523,998,9.9128256513026
215,784,9.8093023255814,9.94005102040816,999,9.91191191191191
213,786,9.79342723004695,9.94274809160305,999,9.91091091091091
213,785,9.80281690140845,9.94522292993631,998,9.91482965931864
211,787,9.80094786729858,9.94155019059721,998,9.91182364729459
209,790,9.78947368421053,9.94303797468354,999,9.91091091091091
211,788,9.79620853080569,9.94543147208122,999,9.91391391391391
212,785,9.7877358490566,9.94649681528662,997,9.91273821464393
210,789,9.78571428571429,9.94423320659062,999,9.91091091091091
210,786,9.80952380952381,9.94274809160305,996,9.91465863453815
212,786,9.81132075471698,9.94020356234097,998,9.9128256513026
215,783,9.8093023255814,9.93614303959131,998,9.90881763527054
211,787,9.81516587677725,9.93646759847522,998,9.91082164328657
212,783,9.81603773584906,9.93231162196679,995,9.90753768844221
209,790,9.83253588516746,9.93291139240506,999,9.91191191191191
217,781,9.85714285714286,9.93213828425096,998,9.91583166332665
214,784,9.85981308411215,9.93239795918367,998,9.91683366733467
222,777,9.86036036036036,9.93564993564994,999,9.91891891891892
227,772,9.85462555066079,9.93782383419689,999,9.91891891891892
239,760,9.87029288702929,9.94342105263158,999,9.92592592592593
224,775,9.85267857142857,9.94322580645161,999,9.92292292292292
237,762,9.86497890295359,9.94356955380577,999,9.92492492492492
237,762,9.86919831223629,9.94356955380577,999,9.92592592592593
238,761,9.85714285714286,9.94218134034166,999,9.92192192192192
237,762,9.85232067510549,9.94094488188976,999,9.91991991991992
249,750,9.8433734939759,9.944,999,9.91891891891892
249,750,9.82329317269076,9.94666666666667,999,9.91591591591592
250,747,9.844,9.94912985274431,997,9.92276830491474
250,748,9.84,9.95053475935829,998,9.92284569138276
250,748,9.836,9.96122994652406,998,9.92985971943888
249,750,9.81526104417671,9.96,999,9.92392392392392
248,751,9.81854838709677,9.96138482023968,999,9.92592592592593
256,742,9.81640625,9.95822102425876,998,9.92184368737475
257,742,9.81712062256809,9.96361185983828,999,9.92592592592593
254,745,9.81496062992126,9.96107382550336,999,9.92392392392392
253,746,9.82213438735178,9.9597855227882,999,9.92492492492492
252,745,9.82936507936508,9.96241610738255,997,9.92878635907723
252,746,9.82539682539683,9.96112600536193,998,9.92685370741483
260,739,9.82692307692308,9.96211096075778,999,9.92692692692693
256,743,9.81640625,9.96096904441454,999,9.92392392392392
262,737,9.80916030534351,9.95929443690638,999,9.91991991991992
254,745,9.80314960629921,9.95704697986577,999,9.91791791791792
261,738,9.81609195402299,9.9579945799458,999,9.92092092092092
259,740,9.80694980694981,9.95675675675676,999,9.91791791791792
259,740,9.82239382239382,9.9527027027027,999,9.91891891891892
252,745,9.82539682539683,9.9489932885906,997,9.91775325977934
249,749,9.83935742971888,9.94659546061415,998,9.91983967935872
247,751,9.82186234817814,9.95073235685752,998,9.9188376753507
256,743,9.82421875,9.95154777927322,999,9.91891891891892
263,736,9.82889733840304,9.95244565217391,999,9.91991991991992
269,730,9.82527881040892,9.95342465753425,999,9.91891891891892
266,733,9.83082706766917,9.95361527967258,999,9.92092092092092
261,737,9.81226053639847,9.94979647218453,998,9.91382765531062
254,743,9.81889763779528,9.95020188425303,997,9.91675025075226
254,744,9.81102362204724,9.95430107526882,998,9.91783567134268
258,739,9.82170542635659,9.95263870094723,997,9.91875626880642
254,745,9.81889763779528,9.95167785234899,999,9.91791791791792
259,738,9.83783783783784,9.95257452574526,997,9.92276830491474
266,733,9.84586466165413,9.95225102319236,999,9.92392392392392
268,729,9.84701492537313,9.94787379972565,997,9.92076228686058
266,729,9.84586466165413,9.95061728395062,995,9.92261306532663
267,732,9.84644194756554,9.94945355191257,999,9.92192192192192
261,738,9.83908045977011,9.94579945799458,999,9.91791791791792
259,740,9.83397683397683,9.94459459459459,999,9.91591591591592
257,742,9.8443579766537,9.94878706199461,999,9.92192192192192
256,741,9.83984375,9.94736842105263,997,9.9197592778335
266,733,9.83082706766917,9.94679399727149,999,9.91591591591592
260,737,9.82692307692308,9.94843962008141,997,9.91675025075226
272,727,9.81985294117647,9.95048143053645,999,9.91491491491491
274,725,9.81386861313869,9.95034482758621,999,9.91291291291291
291,708,9.8213058419244,9.95338983050847,999,9.91491491491491
286,713,9.82867132867133,9.96072931276297,999,9.92292292292292
290,706,9.81379310344828,9.95750708215297,996,9.91566265060241
288,709,9.81597222222222,9.96050775740479,997,9.91875626880642
295,704,9.81016949152542,9.96022727272727,999,9.91591591591592
287,711,9.79790940766551,9.9592123769339,998,9.9128256513026
291,706,9.81443298969072,9.95892351274787,997,9.91675025075226
298,701,9.81879194630872,9.96291012838802,999,9.91991991991992
292,707,9.82191780821918,9.96322489391796,999,9.92192192192192
298,700,9.81208053691275,9.96142857142857,998,9.91683366733467
298,700,9.80201342281879,9.96142857142857,998,9.91382765531062
301,697,9.80730897009967,9.96269727403156,998,9.91583166332665
305,693,9.8,9.96248196248196,998,9.9128256513026
301,695,9.7906976744186,9.96834532374101,996,9.91465863453815
302,697,9.81788079470199,9.96843615494979,999,9.92292292292292
293,706,9.82252559726962,9.96883852691218,999,9.92592592592593
289,710,9.80622837370242,9.97183098591549,999,9.92392392392392
293,706,9.81911262798635,9.97167138810198,999,9.92692692692693
293,706,9.82935153583618,9.97308781869688,999,9.93093093093093
291,706,9.8213058419244,9.97450424929179,997,9.92978936810431
299,698,9.82608695652174,9.97707736389685,997,9.93179538615848
302,697,9.82781456953642,9.97847919655667,999,9.93293293293293
299,700,9.81939799331104,9.97571428571429,999,9.92892892892893
301,698,9.82059800664452,9.9756446991404,999,9.92892892892893
308,689,9.82142857142857,9.97532656023222,997,9.92778335005015
302,696,9.83774834437086,9.97701149425287,998,9.93486973947896
305,694,9.85245901639344,9.97550432276657,999,9.93793793793794
303,694,9.85148514851485,9.97406340057637,997,9.93681043129388
309,687,9.85760517799353,9.97379912663756,996,9.93775100401606
312,686,9.86217948717949,9.97667638483965,998,9.94088176352705
316,683,9.86075949367089,9.97657393850659,999,9.93993993993994
318,680,9.87735849056604,9.97794117647059,998,9.94589178356713
317,681,9.87381703470032,9.97797356828194,998,9.94488977955912
323,676,9.86996904024768,9.97781065088757,999,9.94294294294294
321,678,9.86915887850467,9.97492625368732,999,9.94094094094094
317,681,9.86750788643533,9.97356828193833,998,9.93987975951904
316,681,9.86708860759494,9.97503671071953,997,9.94082246740221
317,682,9.86435331230284,9.97360703812317,999,9.93893893893894
321,678,9.85669781931464,9.97787610619469,999,9.93893893893894
315,684,9.85714285714286,9.9766081871345,999,9.93893893893894
311,687,9.83922829581994,9.97379912663756,998,9.93186372745491
313,686,9.8370607028754,9.97521865889213,999,9.93193193193193
310,689,9.83548387096774,9.97532656023222,999,9.93193193193193
308,690,9.82792207792208,9.97826086956522,998,9.93186372745491
307,692,9.81758957654723,9.97976878612717,999,9.92992992992993
322,677,9.8167701863354,9.98375184638109,999,9.92992992992993
320,677,9.80625,9.98375184638109,997,9.92678034102307
323,676,9.82043343653251,9.98372781065089,999,9.93093093093093
320,678,9.815625,9.98525073746313,998,9.93086172344689
335,664,9.82686567164179,9.98343373493976,999,9.93093093093093
340,658,9.83235294117647,9.98784194528875,998,9.93486973947896
351,648,9.83475783475783,9.98456790123457,999,9.93193193193193
347,652,9.83861671469741,9.9861963190184,999,9.93493493493493
355,643,9.84225352112676,9.99222395023328,998,9.93887775551102
356,642,9.83707865168539,9.99221183800623,998,9.93687374749499
362,636,9.84254143646409,9.99056603773585,998,9.93687374749499
365,634,9.83835616438356,9.99053627760252,999,9.93493493493493
372,627,9.83602150537634,9.98883572567783,999,9.93193193193193
370,628,9.84054054054054,9.98885350318471,998,9.93386773547094
368,631,9.85326086956522,9.98890649762282,999,9.93893893893894
363,636,9.85950413223141,9.9874213836478,999,9.94094094094094
365,634,9.86575342465753,9.98422712933754,999,9.94094094094094
358,641,9.87709497206704,9.98283931357254,999,9.94494494494494
355,644,9.88732394366197,9.97981366459627,999,9.94694694694695
349,650,9.87679083094556,9.98153846153846,999,9.94494494494494
346,653,9.89306358381503,9.97856049004594,999,9.94894894894895
343,655,9.89212827988338,9.97709923664122,998,9.94789579158317
341,658,9.89149560117302,9.97872340425532,999,9.94894894894895
338,660,9.8905325443787,9.97878787878788,998,9.94889779559118
342,656,9.89181286549708,9.97865853658537,998,9.94889779559118
338,660,9.89940828402367,9.97727272727273,998,9.95090180360721
340,658,9.89705882352941,9.97568389057751,998,9.94889779559118
347,652,9.88760806916427,9.97699386503067,999,9.94594594594595
358,641,9.88268156424581,9.97659906396256,999,9.94294294294294
352,647,9.87784090909091,9.97990726429675,999,9.94394394394394
358,639,9.89385474860335,9.97965571205008,997,9.94884653961886
357,641,9.89355742296919,9.98127925117005,998,9.9498997995992
355,641,9.89859154929577,9.97971918876755,996,9.95080321285141
352,646,9.89772727272727,9.98142414860681,998,9.95190380761523
357,641,9.89075630252101,9.98283931357254,998,9.9498997995992
366,632,9.88524590163934,9.98417721518987,998,9.94789579158317
369,630,9.88346883468835,9.98571428571429,999,9.94794794794795
370,628,9.8945945945946,9.98885350318471,998,9.95390781563126
361,637,9.88919667590028,9.9905808477237,998,9.95390781563126
358,640,9.89664804469274,9.9921875,998,9.95791583166333
355,644,9.88450704225352,9.99223602484472,999,9.95395395395395
355,644,9.89577464788732,9.99378881987578,999,9.95895895895896
357,642,9.88795518207283,9.99376947040498,999,9.95595595595596
354,644,9.88700564971751,9.99223602484472,998,9.95490981963928
351,648,9.88888888888889,9.99228395061728,999,9.95595595595596
351,645,9.88603988603989,9.9922480620155,996,9.95481927710843
342,657,9.88888888888889,9.99391171993912,999,9.95795795795796
340,657,9.88529411764706,9.99391171993912,997,9.95687061183551
346,653,9.88439306358381,9.99693721286371,999,9.95795795795796
350,649,9.87142857142857,9.99691833590139,999,9.95295295295295
342,656,9.86842105263158,9.99695121951219,998,9.95290581162325
359,639,9.87743732590529,9.99687010954617,998,9.95390781563126
348,651,9.87068965517241,9.99692780337942,999,9.95295295295295
346,653,9.8728323699422,9.99693721286371,999,9.95395395395395
340,658,9.87941176470588,9.99696048632219,998,9.95691382765531
335,664,9.88955223880597,9.99698795180723,999,9.96096096096096
326,672,9.89263803680982,9.99702380952381,998,9.96292585170341
334,665,9.89520958083832,9.99699248120301,999,9.96296296296296
334,663,9.88922155688623,9.99849170437406,997,9.96188565697091
325,674,9.89230769230769,9.99851632047478,999,9.96396396396396
326,672,9.90490797546012,9.99851190476191,998,9.96793587174349
323,674,9.90092879256966,9.99851632047478,997,9.96690070210632
322,676,9.90683229813665,9.99852071005917,998,9.9689378757515
318,680,9.90880503144654,9.99852941176471,998,9.96993987975952
324,673,9.91358024691358,9.99851411589896,997,9.97091273821464
327,672,9.90214067278287,9.99851190476191,999,9.96696696696697
328,671,9.90243902439024,9.99850968703428,999,9.96696696696697
327,672,9.8960244648318,9.99851190476191,999,9.96496496496496
336,661,9.90476190476191,9.99848714069592,997,9.96690070210632
338,660,9.89644970414201,9.9969696969697,998,9.96292585170341
351,648,9.8974358974359,9.99845679012346,999,9.96296296296296
344,655,9.88372093023256,9.99847328244275,999,9.95895895895896
347,652,9.88184438040346,9.99846625766871,999,9.95795795795796
345,654,9.88695652173913,9.99847094801223,999,9.95995995995996
347,652,9.88760806916427,9.99846625766871,999,9.95995995995996
350,649,9.89142857142857,9.99845916795069,999,9.96096096096096
352,647,9.89204545454546,10.0,999,9.96196196196196
