forward_num,reverse_num,forward_rate,reverse_rate,organism_num,organism_rate
5,5,5.0,5.0,10,5.0
5,5,5.0,5.0,10,5.0
6,7,5.5,5.42857142857143,13,5.46153846153846
9,11,5.66666666666667,5.54545454545455,20,5.6
12,14,5.5,5.42857142857143,26,5.46153846153846
16,20,5.875,5.7,36,5.77777777777778
30,34,6.06666666666667,5.94117647058824,64,6.0
40,48,5.9,5.75,88,5.81818181818182
60,68,6.06666666666667,5.94117647058824,128,6.0
108,124,6.33333333333333,6.16129032258065,232,6.24137931034483
108,122,6.33333333333333,6.16393442622951,230,6.24347826086957
216,244,6.33333333333333,6.16393442622951,460,6.24347826086957
408,431,6.49019607843137,6.38747099767981,839,6.43742550655542
423,479,6.39716312056738,6.21503131524008,902,6.30044345898004
477,522,6.45702306079665,6.36015325670498,999,6.40640640640641
482,517,6.45435684647303,6.38104448742747,999,6.41641641641642
458,541,6.47816593886463,6.41589648798521,999,6.44444444444444
472,527,6.47245762711864,6.4326375711575,999,6.45145145145145
463,536,6.50107991360691,6.42910447761194,999,6.46246246246246
450,549,6.50888888888889,6.4408014571949,999,6.47147147147147
453,546,6.48344370860927,6.42857142857143,999,6.45345345345345
459,540,6.49891067538126,6.42407407407407,999,6.45845845845846
456,543,6.45614035087719,6.39779005524862,999,6.42442442442442
434,565,6.49078341013825,6.42477876106195,999,6.45345345345345
445,554,6.49438202247191,6.46389891696751,999,6.47747747747748
446,553,6.5067264573991,6.44665461121157,999,6.47347347347347
437,562,6.48741418764302,6.41103202846975,999,6.44444444444444
431,568,6.51276102088167,6.4419014084507,999,6.47247247247247
434,565,6.52764976958525,6.4212389380531,999,6.46746746746747
439,560,6.52847380410023,6.44107142857143,999,6.47947947947948
448,551,6.52678571428571,6.44101633393829,999,6.47947947947948
448,551,6.49776785714286,6.43375680580762,999,6.46246246246246
436,563,6.5045871559633,6.41918294849023,999,6.45645645645646
434,565,6.51382488479263,6.41238938053097,999,6.45645645645646
441,558,6.50340136054422,6.43189964157706,999,6.46346346346346
441,558,6.52380952380952,6.39068100358423,999,6.44944944944945
441,558,6.5578231292517,6.37634408602151,999,6.45645645645646
436,563,6.55275229357798,6.39609236234458,999,6.46446446446446
429,570,6.54079254079254,6.39473684210526,999,6.45745745745746
415,584,6.55421686746988,6.4041095890411,999,6.46646646646647
407,592,6.53316953316953,6.40371621621622,999,6.45645645645646
408,591,6.54411764705882,6.43147208121827,999,6.47747747747748
412,587,6.52912621359223,6.40715502555366,999,6.45745745745746
419,580,6.53937947494033,6.41034482758621,999,6.46446446446446
415,584,6.54216867469879,6.40753424657534,999,6.46346346346346
426,573,6.53521126760563,6.39092495636998,999,6.45245245245245
436,563,6.52293577981651,6.39609236234458,999,6.45145145145145
432,567,6.5462962962963,6.41269841269841,999,6.47047047047047
429,570,6.54079254079254,6.45614035087719,999,6.49249249249249
417,582,6.54676258992806,6.42439862542955,999,6.47547547547548
414,585,6.57246376811594,6.44786324786325,999,6.4994994994995
409,590,6.55745721271394,6.44237288135593,999,6.48948948948949
412,587,6.55825242718447,6.43100511073254,999,6.48348348348348
419,580,6.55608591885442,6.45862068965517,999,6.4994994994995
416,583,6.55288461538461,6.45626072041166,999,6.4964964964965
406,593,6.54679802955665,6.44013490725126,999,6.48348348348348
398,601,6.56532663316583,6.43594009983361,999,6.48748748748749
409,590,6.55012224938875,6.44915254237288,999,6.49049049049049
406,593,6.55172413793103,6.45868465430017,999,6.4964964964965
417,582,6.54916067146283,6.4639175257732,999,6.4994994994995
415,584,6.54698795180723,6.48116438356164,999,6.50850850850851
431,568,6.53132250580046,6.46830985915493,999,6.4954954954955
435,564,6.52183908045977,6.4822695035461,999,6.4994994994995
438,561,6.5365296803653,6.48841354723708,999,6.50950950950951
426,573,6.52582159624413,6.5130890052356,999,6.51851851851852
427,572,6.53629976580796,6.49125874125874,999,6.51051051051051
427,572,6.55035128805621,6.50699300699301,999,6.52552552552553
423,576,6.53900709219858,6.52604166666667,999,6.53153153153153
418,581,6.56459330143541,6.50946643717728,999,6.53253253253253
419,580,6.59665871121718,6.51034482758621,999,6.54654654654655
427,572,6.62060889929742,6.53671328671329,999,6.57257257257257
420,579,6.61666666666667,6.53022452504318,999,6.56656656656657
422,577,6.6042654028436,6.52686308492201,999,6.55955955955956
419,580,6.6109785202864,6.50172413793103,999,6.54754754754755
436,563,6.62844036697248,6.5044404973357,999,6.55855855855856
425,574,6.63764705882353,6.51219512195122,999,6.56556556556557
412,587,6.65776699029126,6.50255536626917,999,6.56656656656657
413,586,6.66101694915254,6.47269624573379,999,6.55055055055055
410,589,6.65853658536585,6.48387096774194,999,6.55555555555556
416,583,6.65384615384615,6.49571183533448,999,6.56156156156156
422,577,6.64454976303318,6.46620450606586,999,6.54154154154154
427,572,6.63231850117096,6.46328671328671,999,6.53553553553554
415,584,6.66024096385542,6.4486301369863,999,6.53653653653654
419,580,6.64677804295943,6.43275862068965,999,6.52252252252252
413,586,6.64164648910412,6.44027303754266,999,6.52352352352352
407,592,6.63390663390663,6.43918918918919,999,6.51851851851852
405,594,6.64444444444444,6.42929292929293,999,6.51651651651652
414,585,6.63526570048309,6.43760683760684,999,6.51951951951952
420,579,6.63095238095238,6.45768566493955,999,6.53053053053053
415,584,6.63855421686747,6.48116438356164,999,6.54654654654655
411,588,6.60340632603406,6.49659863945578,999,6.54054054054054
413,586,6.61743341404358,6.49317406143345,999,6.54454454454454
406,593,6.60344827586207,6.47386172006745,999,6.52652652652653
411,588,6.60827250608273,6.47448979591837,999,6.52952952952953
412,587,6.59223300970874,6.47870528109029,999,6.52552552552553
415,584,6.58795180722892,6.50856164383562,999,6.54154154154154
412,587,6.57281553398058,6.51277683134583,999,6.53753753753754
415,584,6.5710843373494,6.51883561643836,999,6.54054054054054
427,572,6.56674473067916,6.51923076923077,999,6.53953953953954
423,576,6.57210401891253,6.53472222222222,999,6.55055055055055
421,578,6.56769596199525,6.55017301038062,999,6.55755755755756
418,581,6.5622009569378,6.54216867469879,999,6.55055055055055
427,572,6.58548009367682,6.55244755244755,999,6.56656656656657
412,587,6.57766990291262,6.54173764906303,999,6.55655655655656
417,582,6.55875299760192,6.54123711340206,999,6.54854854854855
426,573,6.52582159624413,6.54624781849913,999,6.53753753753754
430,569,6.53720930232558,6.54481546572935,999,6.54154154154154
439,560,6.51708428246014,6.56071428571429,999,6.54154154154154
431,568,6.50116009280742,6.57394366197183,999,6.54254254254254
429,570,6.47086247086247,6.56666666666667,999,6.52552552552553
436,563,6.47706422018349,6.57904085257549,999,6.53453453453453
438,561,6.48401826484018,6.59536541889483,999,6.54654654654655
440,559,6.46818181818182,6.6046511627907,999,6.54454454454454
437,562,6.46224256292906,6.59074733096085,999,6.53453453453453
430,569,6.46279069767442,6.61335676625659,999,6.54854854854855
439,560,6.46697038724374,6.60535714285714,999,6.54454454454454
438,561,6.46118721461187,6.58645276292335,999,6.53153153153153
441,558,6.48299319727891,6.56810035842294,999,6.53053053053053
446,553,6.45515695067265,6.57866184448463,999,6.52352352352352
444,555,6.44369369369369,6.58738738738739,999,6.52352352352352
443,556,6.45146726862303,6.58812949640288,999,6.52752752752753
441,558,6.41950113378685,6.59498207885305,999,6.51751751751752
444,555,6.43693693693694,6.60900900900901,999,6.53253253253253
443,556,6.44018058690745,6.60431654676259,999,6.53153153153153
451,548,6.45454545454545,6.61861313868613,999,6.54454454454454
462,537,6.42857142857143,6.63687150837989,999,6.54054054054054
459,540,6.42047930283224,6.61481481481481,999,6.52552552552553
472,527,6.44279661016949,6.60151802656546,999,6.52652652652653
466,533,6.43776824034335,6.63039399624765,999,6.54054054054054
471,528,6.43312101910828,6.62689393939394,999,6.53553553553554
473,526,6.41649048625793,6.60836501901141,999,6.51751751751752
484,515,6.46074380165289,6.58252427184466,999,6.52352352352352
476,523,6.46218487394958,6.5755258126195,999,6.52152152152152
478,521,6.46652719665272,6.58349328214971,999,6.52752752752753
485,514,6.49484536082474,6.59727626459144,999,6.54754754754755
483,516,6.49689440993789,6.57945736434108,999,6.53953953953954
481,518,6.48856548856549,6.59266409266409,999,6.54254254254254
473,526,6.51585623678647,6.56463878326996,999,6.54154154154154
470,529,6.49787234042553,6.56899810964083,999,6.53553553553554
463,536,6.46868250539957,6.57276119402985,999,6.52452452452452
475,524,6.45684210526316,6.55343511450382,999,6.50750750750751
480,519,6.47916666666667,6.52793834296724,999,6.5045045045045
474,525,6.45569620253165,6.53142857142857,999,6.4954954954955
486,513,6.45884773662551,6.53801169590643,999,6.4994994994995
486,513,6.47325102880658,6.55750487329435,999,6.51651651651652
500,499,6.48,6.55310621242485,999,6.51651651651652
496,503,6.47379032258065,6.49304174950298,999,6.48348348348348
501,498,6.4690618762475,6.5140562248996,999,6.49149149149149
503,496,6.48111332007952,6.55040322580645,999,6.51551551551552
492,507,6.46747967479675,6.55818540433925,999,6.51351351351351
497,502,6.4748490945674,6.53784860557769,999,6.50650650650651
508,491,6.48622047244094,6.56415478615071,999,6.52452452452452
508,491,6.49015748031496,6.53360488798371,999,6.51151151151151
492,507,6.47357723577236,6.55226824457594,999,6.51351351351351
489,510,6.43967280163599,6.55882352941176,999,6.5005005005005
486,513,6.48971193415638,6.56140350877193,999,6.52652652652653
484,515,6.51239669421488,6.58834951456311,999,6.55155155155155
481,518,6.4989604989605,6.59459459459459,999,6.54854854854855
475,524,6.49473684210526,6.61068702290076,999,6.55555555555556
479,520,6.53027139874739,6.61730769230769,999,6.57557557557558
480,519,6.52708333333333,6.62042389210019,999,6.57557557557558
488,511,6.53483606557377,6.64774951076321,999,6.59259259259259
483,516,6.53623188405797,6.67054263565892,999,6.60560560560561
476,523,6.52941176470588,6.66921606118547,999,6.6026026026026
465,534,6.53333333333333,6.69101123595506,999,6.61761761761762
470,529,6.53404255319149,6.68809073724008,999,6.61561561561562
470,529,6.51276595744681,6.67485822306238,999,6.5985985985986
461,538,6.52060737527115,6.67843866171004,999,6.60560560560561
445,554,6.52584269662921,6.67328519855596,999,6.60760760760761
435,564,6.52183908045977,6.67375886524823,999,6.60760760760761
442,557,6.49773755656109,6.67684021543986,999,6.5975975975976
449,550,6.50779510022272,6.67636363636364,999,6.6006006006006
431,568,6.49419953596288,6.69894366197183,999,6.61061061061061
437,562,6.48741418764302,6.69750889679715,999,6.60560560560561
440,559,6.50454545454545,6.70661896243292,999,6.61761761761762
442,557,6.49547511312217,6.71095152603232,999,6.61561561561562
439,560,6.53530751708428,6.70178571428571,999,6.62862862862863
432,567,6.51157407407407,6.6984126984127,999,6.61761761761762
433,566,6.51270207852194,6.70671378091873,999,6.62262262262262
428,571,6.51635514018692,6.7092819614711,999,6.62662662662663
430,569,6.51395348837209,6.701230228471,999,6.62062062062062
429,570,6.53379953379953,6.7,999,6.62862862862863
430,569,6.53720930232558,6.71177504393673,999,6.63663663663664
436,563,6.54357798165138,6.71758436944938,999,6.64164164164164
435,564,6.52413793103448,6.70921985815603,999,6.62862862862863
445,554,6.52359550561798,6.73285198555957,999,6.63963963963964
437,562,6.52402745995423,6.73487544483986,999,6.64264264264264
427,572,6.53395784543325,6.73251748251748,999,6.64764764764765
420,579,6.51904761904762,6.72020725388601,999,6.63563563563564
429,570,6.52447552447552,6.74385964912281,999,6.64964964964965
425,574,6.52,6.75261324041812,999,6.65365365365365
416,583,6.53365384615385,6.75128644939966,999,6.66066066066066
405,594,6.56049382716049,6.77272727272727,999,6.68668668668669
406,593,6.51231527093596,6.79258010118044,999,6.67867867867868
416,583,6.49759615384615,6.79073756432247,999,6.66866866866867
420,579,6.51190476190476,6.78756476683938,999,6.67167167167167
424,575,6.49056603773585,6.79652173913043,999,6.66666666666667
409,590,6.50122249388753,6.82372881355932,999,6.69169169169169
408,591,6.53921568627451,6.80541455160744,999,6.6966966966967
413,586,6.57142857142857,6.80546075085324,999,6.70870870870871
414,585,6.57971014492754,6.82051282051282,999,6.72072072072072
402,597,6.60696517412935,6.81909547738693,999,6.73373373373373
407,592,6.58968058968059,6.82094594594595,999,6.72672672672673
405,594,6.61481481481481,6.81986531986532,999,6.73673673673674
409,590,6.63080684596577,6.8135593220339,999,6.73873873873874
407,592,6.63636363636364,6.80067567567568,999,6.73373373373373
402,597,6.65671641791045,6.80904522613065,999,6.74774774774775
385,614,6.66753246753247,6.78990228013029,999,6.74274274274274
388,611,6.67010309278351,6.79050736497545,999,6.74374374374374
384,615,6.67447916666667,6.80650406504065,999,6.75575575575576
377,622,6.6631299734748,6.78617363344051,999,6.73973973973974
384,615,6.63020833333333,6.79186991869919,999,6.72972972972973
384,615,6.66927083333333,6.8,999,6.74974974974975
371,628,6.66307277628032,6.80254777070064,999,6.75075075075075
368,631,6.67391304347826,6.78446909667195,999,6.74374374374374
369,630,6.67750677506775,6.79365079365079,999,6.75075075075075
365,634,6.66849315068493,6.801261829653,999,6.75275275275275
369,630,6.68563685636856,6.7968253968254,999,6.75575575575576
372,627,6.67741935483871,6.8133971291866,999,6.76276276276276
374,625,6.67647058823529,6.808,999,6.75875875875876
379,620,6.67282321899736,6.81935483870968,999,6.76376376376376
376,623,6.65691489361702,6.82182985553772,999,6.75975975975976
367,632,6.67302452316076,6.80537974683544,999,6.75675675675676
370,629,6.68648648648649,6.79968203497615,999,6.75775775775776
370,629,6.68648648648649,6.79491255961844,999,6.75475475475475
354,645,6.65819209039548,6.8031007751938,999,6.75175175175175
352,647,6.65625,6.80216383307573,999,6.75075075075075
355,644,6.65915492957746,6.80745341614907,999,6.75475475475475
355,644,6.68169014084507,6.78105590062112,999,6.74574574574575
354,645,6.71186440677966,6.7968992248062,999,6.76676676676677
346,653,6.6907514450867,6.79938744257274,999,6.76176176176176
344,655,6.68895348837209,6.80610687022901,999,6.76576576576577
346,653,6.6907514450867,6.81470137825421,999,6.77177177177177
345,654,6.69855072463768,6.81498470948012,999,6.77477477477477
360,639,6.69722222222222,6.81533646322379,999,6.77277277277277
353,646,6.71671388101983,6.81424148606811,999,6.77977977977978
340,659,6.72352941176471,6.81638846737481,999,6.78478478478478
330,669,6.70606060606061,6.8101644245142,999,6.77577577577578
331,668,6.69486404833837,6.81586826347305,999,6.77577577577578
320,679,6.66875,6.80854197349043,999,6.76376376376376
325,674,6.67692307692308,6.80415430267062,999,6.76276276276276
330,669,6.67272727272727,6.80418535127055,999,6.76076076076076
348,651,6.67816091954023,6.80337941628264,999,6.75975975975976
343,656,6.67930029154519,6.82317073170732,999,6.77377377377377
358,641,6.68994413407821,6.80811232449298,999,6.76576576576577
349,650,6.6647564469914,6.81384615384615,999,6.76176176176176
340,659,6.66470588235294,6.82397572078907,999,6.76976976976977
341,658,6.66568914956012,6.82218844984802,999,6.76876876876877
351,648,6.66381766381766,6.80864197530864,999,6.75775775775776
363,636,6.69146005509642,6.81918238993711,999,6.77277277277277
354,645,6.71468926553672,6.83720930232558,999,6.79379379379379
362,637,6.70718232044199,6.83359497645212,999,6.78778778778779
365,634,6.69315068493151,6.84384858044164,999,6.78878878878879
360,639,6.67222222222222,6.84820031298905,999,6.78478478478478
358,641,6.6927374301676,6.84243369734789,999,6.78878878878879
356,643,6.67696629213483,6.84292379471229,999,6.78378378378378
362,637,6.68232044198895,6.85243328100471,999,6.79079079079079
370,629,6.67837837837838,6.86327503974563,999,6.79479479479479
366,633,6.67213114754098,6.86571879936809,999,6.79479479479479
356,643,6.6685393258427,6.86158631415241,999,6.79279279279279
343,656,6.64723032069971,6.86432926829268,999,6.78978978978979
346,653,6.64450867052023,6.86370597243492,999,6.78778778778779
356,643,6.65168539325843,6.8646967340591,999,6.78878878878879
351,648,6.66381766381766,6.87654320987654,999,6.8018018018018
347,652,6.65994236311239,6.88957055214724,999,6.80980980980981
344,655,6.6656976744186,6.89007633587786,999,6.81281281281281
348,651,6.65804597701149,6.89093701996928,999,6.80980980980981
344,655,6.67151162790698,6.89312977099237,999,6.81681681681682
353,646,6.67705382436261,6.88854489164087,999,6.81381381381381
353,646,6.68838526912181,6.88854489164087,999,6.81781781781782
349,650,6.68481375358166,6.89692307692308,999,6.82282282282282
362,637,6.6767955801105,6.89167974882261,999,6.81381381381381
360,639,6.68055555555556,6.89984350547731,999,6.82082082082082
356,643,6.6685393258427,6.89113530326594,999,6.81181181181181
355,644,6.66478873239437,6.89130434782609,999,6.81081081081081
356,643,6.65449438202247,6.900466562986,999,6.81281281281281
351,648,6.64957264957265,6.89814814814815,999,6.81081081081081
344,655,6.6453488372093,6.90076335877863,999,6.81281281281281
349,650,6.64469914040115,6.91076923076923,999,6.81781781781782
353,646,6.65722379603399,6.91176470588235,999,6.82182182182182
358,641,6.67597765363128,6.91263650546022,999,6.82782782782783
362,637,6.70165745856354,6.90894819466248,999,6.83383383383383
362,637,6.69337016574586,6.90580847723705,999,6.82882882882883
358,641,6.68435754189944,6.89859594383775,999,6.82182182182182
356,643,6.67977528089888,6.89891135303266,999,6.82082082082082
356,643,6.68539325842697,6.88802488335925,999,6.81581581581582
358,641,6.67877094972067,6.88299531981279,999,6.80980980980981
359,640,6.67966573816156,6.884375,999,6.81081081081081
349,650,6.68481375358166,6.88615384615385,999,6.81581581581582
350,649,6.66,6.87981510015408,999,6.8028028028028
340,659,6.64117647058824,6.87101669195751,999,6.79279279279279
345,654,6.64347826086957,6.87155963302752,999,6.79279279279279
333,666,6.64564564564565,6.87087087087087,999,6.7957957957958
335,664,6.66567164179104,6.88704819277108,999,6.81281281281281
342,657,6.65497076023392,6.88584474885845,999,6.80680680680681
345,654,6.66376811594203,6.88073394495413,999,6.80580580580581
353,646,6.67988668555241,6.87770897832817,999,6.80780780780781
350,649,6.68571428571429,6.884437596302,999,6.81481481481481
352,647,6.6875,6.87635239567233,999,6.80980980980981
353,646,6.68838526912181,6.88235294117647,999,6.81381381381381
357,642,6.6890756302521,6.88785046728972,999,6.81681681681682
355,644,6.69577464788732,6.88354037267081,999,6.81681681681682
358,641,6.69832402234637,6.8814352574103,999,6.81581581581582
364,635,6.70879120879121,6.88188976377953,999,6.81881881881882
371,628,6.71159029649596,6.88694267515924,999,6.82182182182182
368,631,6.71467391304348,6.8811410459588,999,6.81981981981982
367,632,6.73024523160763,6.88449367088608,999,6.82782782782783
368,631,6.74728260869565,6.87955625990491,999,6.83083083083083
372,627,6.74462365591398,6.87719298245614,999,6.82782782782783
367,632,6.74114441416894,6.87816455696202,999,6.82782782782783
370,629,6.75945945945946,6.87440381558029,999,6.83183183183183
365,634,6.75068493150685,6.86908517350158,999,6.82582582582583
358,641,6.74860335195531,6.86583463338534,999,6.82382382382382
362,637,6.74309392265193,6.87755102040816,999,6.82882882882883
356,643,6.74438202247191,6.88646967340591,999,6.83583583583584
360,639,6.74444444444444,6.87793427230047,999,6.82982982982983
363,636,6.74380165289256,6.87264150943396,999,6.82582582582583
366,633,6.73770491803279,6.86729857819905,999,6.81981981981982
377,622,6.73740053050398,6.86334405144695,999,6.81581581581582
384,615,6.74479166666667,6.86666666666667,999,6.81981981981982
389,610,6.73778920308483,6.86229508196721,999,6.81381381381381
389,610,6.73007712082262,6.8672131147541,999,6.81381381381381
398,601,6.72110552763819,6.85690515806988,999,6.8028028028028
400,599,6.7125,6.85141903171953,999,6.7957957957958
410,589,6.70487804878049,6.8471986417657,999,6.78878878878879
412,587,6.72087378640777,6.85008517887564,999,6.7967967967968
402,597,6.71393034825871,6.86264656616415,999,6.8028028028028
400,599,6.71,6.86143572621035,999,6.8008008008008
399,600,6.71679197994987,6.86333333333333,999,6.8048048048048
401,598,6.69576059850374,6.8628762541806,999,6.7957957957958
405,594,6.69876543209877,6.87205387205387,999,6.8018018018018
408,591,6.69607843137255,6.86971235194585,999,6.7987987987988
404,595,6.68069306930693,6.86554621848739,999,6.79079079079079
399,600,6.69172932330827,6.87333333333333,999,6.8008008008008
404,595,6.69059405940594,6.86890756302521,999,6.7967967967968
401,598,6.71072319201995,6.87625418060201,999,6.80980980980981
396,603,6.71212121212121,6.86567164179105,999,6.8048048048048
405,594,6.70864197530864,6.87710437710438,999,6.80880880880881
407,592,6.69287469287469,6.87331081081081,999,6.7997997997998
402,597,6.70646766169154,6.86934673366834,999,6.8038038038038
377,622,6.71618037135279,6.87459807073955,999,6.81481481481481
385,614,6.71948051948052,6.88436482084691,999,6.82082082082082
374,625,6.71657754010695,6.8896,999,6.82482482482482
369,630,6.71815718157182,6.89365079365079,999,6.82882882882883
381,618,6.71128608923885,6.89320388349515,999,6.82382382382382
376,623,6.72074468085106,6.89566613162119,999,6.82982982982983
384,615,6.7265625,6.88780487804878,999,6.82582582582583
380,619,6.71052631578947,6.88045234248788,999,6.81581581581582
378,621,6.71428571428571,6.88083735909823,999,6.81781781781782
381,618,6.71653543307087,6.88187702265372,999,6.81881881881882
386,613,6.72020725388601,6.88417618270799,999,6.82082082082082
386,613,6.73834196891192,6.87928221859706,999,6.82482482482482
380,619,6.72368421052632,6.88045234248788,999,6.82082082082082
387,612,6.71317829457364,6.88398692810458,999,6.81781781781782
390,609,6.71794871794872,6.88998357963875,999,6.82282282282282
378,621,6.72751322751323,6.87600644122383,999,6.81981981981982
378,621,6.72222222222222,6.87761674718196,999,6.81881881881882
387,612,6.7312661498708,6.86764705882353,999,6.81481481481481
399,600,6.7218045112782,6.86166666666667,999,6.80580580580581
387,612,6.71576227390181,6.86764705882353,999,6.80880880880881
383,616,6.74151436031332,6.86688311688312,999,6.81881881881882
380,619,6.73947368421053,6.86591276252019,999,6.81781781781782
380,619,6.74473684210526,6.8610662358643,999,6.81681681681682
380,619,6.75263157894737,6.8626817447496,999,6.82082082082082
378,621,6.75132275132275,6.85346215780998,999,6.81481481481481
376,623,6.75531914893617,6.86356340288925,999,6.82282282282282
385,614,6.75844155844156,6.85667752442997,999,6.81881881881882
391,608,6.74680306905371,6.86677631578947,999,6.81981981981982
386,613,6.74870466321244,6.86460032626427,999,6.81981981981982
386,613,6.75906735751295,6.86133768352365,999,6.82182182182182
385,614,6.74805194805195,6.8599348534202,999,6.81681681681682
388,611,6.74484536082474,6.8657937806874,999,6.81881881881882
391,608,6.72634271099744,6.86677631578947,999,6.81181181181181
384,615,6.71875,6.87479674796748,999,6.81481481481481
382,617,6.71989528795812,6.86547811993517,999,6.80980980980981
387,612,6.71317829457364,6.86601307189542,999,6.80680680680681
381,618,6.72965879265092,6.86084142394822,999,6.81081081081081
391,608,6.73657289002558,6.85690789473684,999,6.80980980980981
385,614,6.74285714285714,6.86319218241042,999,6.81681681681682
383,616,6.74412532637076,6.86525974025974,999,6.81881881881882
387,612,6.74677002583979,6.88398692810458,999,6.83083083083083
388,611,6.74484536082474,6.8772504091653,999,6.82582582582583
382,617,6.73298429319372,6.87034035656402,999,6.81781781781782
378,621,6.73280423280423,6.87278582930757,999,6.81981981981982
385,614,6.72467532467532,6.87622149837134,999,6.81781781781782
387,612,6.7235142118863,6.87908496732026,999,6.81881881881882
383,616,6.72845953002611,6.87987012987013,999,6.82182182182182
386,613,6.71502590673575,6.87438825448613,999,6.81281281281281
392,607,6.70918367346939,6.87973640856672,999,6.81281281281281
390,609,6.72051282051282,6.8735632183908,999,6.81381381381381
377,622,6.71618037135279,6.87942122186495,999,6.81781781781782
374,625,6.70588235294118,6.8768,999,6.81281281281281
388,611,6.70876288659794,6.87888707037643,999,6.81281281281281
384,615,6.70572916666667,6.8780487804878,999,6.81181181181181
384,615,6.69791666666667,6.86829268292683,999,6.8028028028028
379,620,6.70976253298153,6.86935483870968,999,6.80880880880881
377,622,6.68965517241379,6.86655948553055,999,6.7997997997998
371,628,6.69272237196765,6.85350318471338,999,6.79379379379379
376,623,6.68882978723404,6.85714285714286,999,6.79379379379379
369,630,6.68292682926829,6.86031746031746,999,6.79479479479479
375,624,6.66933333333333,6.85576923076923,999,6.78578578578579
373,626,6.67560321715818,6.85782747603834,999,6.78978978978979
382,617,6.67277486910995,6.87196110210697,999,6.7957957957958
366,633,6.66939890710383,6.87519747235387,999,6.7997997997998
359,640,6.66295264623955,6.8796875,999,6.8018018018018
356,643,6.66292134831461,6.88024883359254,999,6.8028028028028
340,659,6.64411764705882,6.88163884673748,999,6.8008008008008
350,649,6.64285714285714,6.87827426810478,999,6.7957957957958
348,651,6.63505747126437,6.88172043010753,999,6.7957957957958
356,643,6.6376404494382,6.87247278382582,999,6.78878878878879
354,645,6.63276836158192,6.86821705426357,999,6.78478478478478
354,645,6.61581920903955,6.87441860465116,999,6.78278278278278
351,648,6.61823361823362,6.86574074074074,999,6.77877877877878
339,660,6.62241887905605,6.86666666666667,999,6.78378378378378
341,658,6.61290322580645,6.85714285714286,999,6.77377377377377
345,654,6.61449275362319,6.86238532110092,999,6.77677677677678
351,648,6.6011396011396,6.86728395061728,999,6.77377377377377
359,640,6.59610027855153,6.8734375,999,6.77377377377377
357,642,6.58823529411765,6.86760124610592,999,6.76776776776777
351,648,6.58974358974359,6.86574074074074,999,6.76876876876877
358,641,6.60335195530726,6.86427457098284,999,6.77077077077077
360,639,6.58888888888889,6.87793427230047,999,6.77377377377377
358,641,6.58659217877095,6.87519500780031,999,6.77177177177177
356,643,6.57303370786517,6.87247278382582,999,6.76576576576577
354,645,6.56497175141243,6.87441860465116,999,6.76476476476476
359,640,6.55153203342618,6.871875,999,6.75675675675676
360,639,6.55,6.86384976525822,999,6.75075075075075
363,636,6.55371900826446,6.86320754716981,999,6.75075075075075
380,619,6.56315789473684,6.859450726979,999,6.74674674674675
367,632,6.5558583106267,6.85917721518987,999,6.74774774774775
362,637,6.56353591160221,6.85557299843014,999,6.74974974974975
363,636,6.5702479338843,6.86792452830189,999,6.75975975975976
376,623,6.57978723404255,6.87319422150883,999,6.76276276276276
376,623,6.56648936170213,6.86356340288925,999,6.75175175175175
373,626,6.57372654155496,6.86741214057508,999,6.75775775775776
375,624,6.57066666666667,6.86698717948718,999,6.75575575575576
357,642,6.55742296918767,6.86915887850467,999,6.75775775775776
353,646,6.56373937677054,6.86687306501548,999,6.75975975975976
357,642,6.56862745098039,6.86604361370717,999,6.75975975975976
351,648,6.58974358974359,6.8641975308642,999,6.76776776776777
357,642,6.59383753501401,6.86292834890966,999,6.76676676676677
366,633,6.59289617486339,6.8609794628752,999,6.76276276276276
364,635,6.59340659340659,6.86614173228346,999,6.76676676676677
360,639,6.6,6.8622848200313,999,6.76776776776777
355,644,6.59154929577465,6.85869565217391,999,6.76376376376376
360,639,6.58888888888889,6.85602503912363,999,6.75975975975976
350,649,6.58571428571429,6.86286594761171,999,6.76576576576577
357,642,6.58263305322129,6.87071651090343,999,6.76776776776777
360,639,6.58333333333333,6.8716744913928,999,6.76776776776777
373,626,6.58981233243968,6.86741214057508,999,6.76376376376376
373,626,6.58176943699732,6.86261980830671,999,6.75775775775776
377,622,6.59151193633952,6.85852090032154,999,6.75775775775776
377,622,6.59416445623342,6.85852090032154,999,6.75875875875876
370,629,6.56486486486487,6.85214626391097,999,6.74574574574575
381,618,6.56955380577428,6.8462783171521,999,6.74074074074074
389,610,6.55012853470437,6.83934426229508,999,6.72672672672673
395,604,6.52405063291139,6.83278145695364,999,6.71071071071071
392,607,6.52295918367347,6.83196046128501,999,6.71071071071071
400,599,6.525,6.82136894824708,999,6.7027027027027
400,599,6.54,6.82971619365609,999,6.71371371371371
399,600,6.531328320802,6.83,999,6.71071071071071
403,596,6.54590570719603,6.82718120805369,999,6.71371371371371
402,597,6.53980099502488,6.81909547738693,999,6.70670670670671
395,604,6.50632911392405,6.81456953642384,999,6.69269269269269
393,606,6.49618320610687,6.81023102310231,999,6.68668668668669
405,594,6.4962962962963,6.80639730639731,999,6.68068068068068
390,609,6.50512820512821,6.8128078817734,999,6.69269269269269
396,603,6.51262626262626,6.81426202321725,999,6.69469469469469
399,600,6.51378446115288,6.815,999,6.69469469469469
401,598,6.50124688279302,6.80936454849498,999,6.68568568568569
404,595,6.50247524752475,6.81008403361345,999,6.68568568568569
409,590,6.50122249388753,6.8135593220339,999,6.68568568568569
412,587,6.47815533980583,6.81942078364566,999,6.67867867867868
414,585,6.47584541062802,6.81196581196581,999,6.67267267267267
414,585,6.49275362318841,6.81196581196581,999,6.67967967967968
410,589,6.49512195121951,6.80305602716469,999,6.67667667667668
412,587,6.48058252427184,6.80408858603066,999,6.67067067067067
409,590,6.47677261613692,6.80847457627119,999,6.67267267267267
411,588,6.4647201946472,6.81462585034014,999,6.67067067067067
403,596,6.46401985111663,6.81040268456376,999,6.67067067067067
407,592,6.46928746928747,6.80912162162162,999,6.67067067067067
420,579,6.47857142857143,6.81001727115717,999,6.67067067067067
420,579,6.5,6.81692573402418,999,6.68368368368368
420,579,6.48571428571429,6.81174438687392,999,6.67467467467467
414,585,6.5024154589372,6.8034188034188,999,6.67867867867868
416,583,6.49278846153846,6.80617495711835,999,6.67567567567568
415,584,6.48915662650602,6.80308219178082,999,6.67267267267267
417,582,6.48201438848921,6.80584192439863,999,6.67067067067067
409,590,6.47677261613692,6.8,999,6.66766766766767
410,589,6.49268292682927,6.80135823429542,999,6.67467467467467
407,592,6.47911547911548,6.80236486486486,999,6.67067067067067
405,594,6.49382716049383,6.7962962962963,999,6.67367367367367
393,606,6.49618320610687,6.7986798679868,999,6.67967967967968
398,601,6.48492462311558,6.7936772046589,999,6.67067067067067
399,600,6.4937343358396,6.795,999,6.67467467467467
403,596,6.50124069478908,6.80201342281879,999,6.68068068068068
387,612,6.51162790697674,6.81535947712418,999,6.6976976976977
386,613,6.53108808290155,6.81566068515498,999,6.70570570570571
381,618,6.53543307086614,6.81391585760518,999,6.70770770770771
390,609,6.53333333333333,6.81444991789819,999,6.7047047047047
393,606,6.51908396946565,6.82178217821782,999,6.7027027027027
387,612,6.52713178294574,6.8218954248366,999,6.70770770770771
390,609,6.51794871794872,6.82758620689655,999,6.70670670670671
397,602,6.53652392947103,6.82059800664452,999,6.70770770770771
401,598,6.5211970074813,6.81605351170569,999,6.6976976976977
396,603,6.52272727272727,6.82421227197347,999,6.7047047047047
394,605,6.5253807106599,6.81157024793388,999,6.6986986986987
405,594,6.51604938271605,6.81649831649832,999,6.69469469469469
403,596,6.52853598014888,6.81543624161074,999,6.6996996996997
406,593,6.49507389162562,6.81956155143339,999,6.68768768768769
404,595,6.49009900990099,6.81344537815126,999,6.68268268268268
391,608,6.51150895140665,6.80592105263158,999,6.69069069069069
401,598,6.51870324189526,6.80602006688963,999,6.69069069069069
391,608,6.52173913043478,6.80592105263158,999,6.69469469469469
401,598,6.50623441396509,6.79933110367893,999,6.68168168168168
400,599,6.5075,6.80467445742905,999,6.68568568568569
403,596,6.50620347394541,6.80536912751678,999,6.68468468468468
400,599,6.495,6.80634390651085,999,6.68168168168168
399,600,6.50125313283208,6.81166666666667,999,6.68768768768769
406,593,6.49753694581281,6.81618887015177,999,6.68668668668669
406,593,6.49507389162562,6.81112984822934,999,6.68268268268268
398,601,6.51507537688442,6.80366056572379,999,6.68868868868869
397,602,6.52392947103275,6.80564784053156,999,6.69369369369369
396,603,6.52525252525253,6.81260364842454,999,6.6986986986987
394,605,6.5253807106599,6.81157024793388,999,6.6986986986987
388,611,6.5360824742268,6.80523731587561,999,6.7007007007007
385,614,6.52727272727273,6.81921824104235,999,6.70670670670671
387,612,6.53229974160207,6.81209150326797,999,6.7037037037037
375,624,6.53066666666667,6.80929487179487,999,6.7047047047047
363,636,6.54820936639118,6.81446540880503,999,6.71771771771772
368,631,6.52989130434783,6.80982567353407,999,6.70670670670671
370,629,6.55135135135135,6.82193958664547,999,6.72172172172172
365,634,6.54520547945206,6.8186119873817,999,6.71871871871872
362,637,6.54696132596685,6.81946624803768,999,6.72072072072072
367,632,6.55858310626703,6.81012658227848,999,6.71771771771772
360,639,6.56388888888889,6.80438184663537,999,6.71771771771772
366,633,6.5655737704918,6.80410742496051,999,6.71671671671672
370,629,6.56486486486487,6.80763116057234,999,6.71771771771772
371,628,6.59838274932615,6.80414012738853,999,6.72772772772773
360,639,6.6,6.80125195618153,999,6.72872872872873
367,632,6.60217983651226,6.80063291139241,999,6.72772772772773
368,631,6.60054347826087,6.79239302694136,999,6.72172172172172
375,624,6.616,6.79967948717949,999,6.73073073073073
383,616,6.59791122715405,6.81331168831169,999,6.73073073073073
391,608,6.59846547314578,6.8125,999,6.72872872872873
398,601,6.58542713567839,6.82029950083195,999,6.72672672672673
390,609,6.57179487179487,6.80788177339902,999,6.71571571571572
394,605,6.56852791878173,6.79834710743802,999,6.70770770770771
403,596,6.57816377171216,6.79530201342282,999,6.70770770770771
409,590,6.58435207823961,6.80338983050847,999,6.71371371371371
413,586,6.56416464891041,6.81399317406143,999,6.71071071071071
409,590,6.56968215158924,6.82372881355932,999,6.71971971971972
413,586,6.57627118644068,6.83276450511945,999,6.72672672672673
406,593,6.55418719211823,6.82630691399663,999,6.71571571571572
407,592,6.57248157248157,6.8277027027027,999,6.72372372372372
407,592,6.57739557739558,6.82263513513514,999,6.72272272272272
406,593,6.58866995073892,6.82293423271501,999,6.72772772772773
408,591,6.57107843137255,6.82064297800338,999,6.71871871871872
397,602,6.57430730478589,6.81727574750831,999,6.72072072072072
391,608,6.58567774936061,6.81907894736842,999,6.72772772772773
404,595,6.59158415841584,6.80840336134454,999,6.72072072072072
400,599,6.61,6.80801335559265,999,6.72872872872873
398,601,6.6105527638191,6.82029950083195,999,6.73673673673674
402,597,6.61691542288557,6.81239530988275,999,6.73373373373373
403,596,6.59553349875931,6.82214765100671,999,6.73073073073073
390,609,6.59230769230769,6.81773399014778,999,6.72972972972973
405,594,6.59259259259259,6.81144781144781,999,6.72272272272272
402,597,6.59452736318408,6.80234505862647,999,6.71871871871872
417,582,6.5947242206235,6.80240549828179,999,6.71571571571572
415,584,6.58795180722892,6.80479452054795,999,6.71471471471471
419,580,6.59188544152745,6.80344827586207,999,6.71471471471471
420,579,6.57380952380952,6.80829015544041,999,6.70970970970971
421,578,6.58432304038005,6.81487889273356,999,6.71771771771772
432,567,6.56481481481481,6.81481481481481,999,6.70670670670671
414,585,6.57971014492754,6.8017094017094,999,6.70970970970971
418,581,6.57416267942584,6.81067125645439,999,6.71171171171171
412,587,6.56553398058252,6.80408858603066,999,6.70570570570571
418,581,6.57894736842105,6.81755593803787,999,6.71771771771772
426,573,6.5868544600939,6.80802792321117,999,6.71371371371371
420,579,6.59523809523809,6.79447322970639,999,6.71071071071071
425,574,6.59529411764706,6.79616724738676,999,6.71071071071071
429,570,6.6037296037296,6.77894736842105,999,6.7037037037037
442,557,6.59049773755656,6.78096947935368,999,6.6966966966967
444,555,6.57882882882883,6.77657657657658,999,6.68868868868869
454,545,6.57488986784141,6.7743119266055,999,6.68368368368368
441,558,6.58049886621315,6.7741935483871,999,6.68868868868869
453,546,6.58057395143488,6.78754578754579,999,6.69369369369369
449,550,6.58797327394209,6.78181818181818,999,6.69469469469469
439,560,6.59908883826879,6.78392857142857,999,6.7027027027027
437,562,6.59496567505721,6.78825622775801,999,6.7037037037037
435,564,6.6,6.79078014184397,999,6.70770770770771
448,551,6.61160714285714,6.78765880217786,999,6.70870870870871
451,548,6.6119733924612,6.78649635036496,999,6.70770770770771
447,552,6.60850111856823,6.78985507246377,999,6.70870870870871
445,554,6.61123595505618,6.79602888086643,999,6.71371371371371
465,534,6.6258064516129,6.78464419475655,999,6.71071071071071
465,534,6.61935483870968,6.7752808988764,999,6.7027027027027
469,530,6.61407249466951,6.77547169811321,999,6.6996996996997
468,531,6.61965811965812,6.7608286252354,999,6.69469469469469
465,534,6.63225806451613,6.76029962546817,999,6.7007007007007
460,539,6.63695652173913,6.76437847866419,999,6.70570570570571
458,541,6.6353711790393,6.76524953789279,999,6.70570570570571
466,533,6.62017167381974,6.76923076923077,999,6.6996996996997
468,531,6.62606837606838,6.7608286252354,999,6.6976976976977
477,522,6.62054507337526,6.76628352490421,999,6.6966966966967
484,515,6.61363636363636,6.76116504854369,999,6.68968968968969
482,517,6.61203319502075,6.76015473887814,999,6.68868868868869
485,514,6.6020618556701,6.7568093385214,999,6.68168168168168
489,510,6.60122699386503,6.75098039215686,999,6.67767767767768
495,504,6.6020202020202,6.76587301587302,999,6.68468468468468
494,505,6.59514170040486,6.76237623762376,999,6.67967967967968
498,501,6.59437751004016,6.73852295409182,999,6.66666666666667
504,495,6.59325396825397,6.73737373737374,999,6.66466466466466
491,508,6.59266802443992,6.72244094488189,999,6.65865865865866
499,500,6.57715430861723,6.726,999,6.65165165165165
505,494,6.60792079207921,6.7246963562753,999,6.66566566566567
509,490,6.61296660117878,6.73469387755102,999,6.67267267267267
506,493,6.62252964426877,6.73833671399594,999,6.67967967967968
514,485,6.62645914396887,6.7319587628866,999,6.67767767767768
524,475,6.63740458015267,6.74315789473684,999,6.68768768768769
512,487,6.626953125,6.73921971252567,999,6.68168168168168
513,486,6.64327485380117,6.73251028806584,999,6.68668668668669
520,479,6.66153846153846,6.7286012526096,999,6.69369369369369
525,474,6.64952380952381,6.72151898734177,999,6.68368368368368
525,474,6.6552380952381,6.72784810126582,999,6.68968968968969
526,473,6.64638783269962,6.7399577167019,999,6.69069069069069
526,473,6.65589353612167,6.75475687103594,999,6.7027027027027
528,471,6.64962121212121,6.74309978768578,999,6.69369369369369
529,470,6.64650283553875,6.7468085106383,999,6.69369369369369
528,471,6.65151515151515,6.75796178343949,999,6.7017017017017
521,478,6.65642994241843,6.75523012552301,999,6.7037037037037
518,481,6.65830115830116,6.76507276507277,999,6.70970970970971
523,476,6.65965583173996,6.77521008403361,999,6.71471471471471
529,470,6.65595463137996,6.77446808510638,999,6.71171171171171
523,476,6.65200764818356,6.77100840336134,999,6.70870870870871
517,482,6.65377176015474,6.75726141078838,999,6.7037037037037
518,481,6.65057915057915,6.76091476091476,999,6.7037037037037
512,487,6.662109375,6.7700205338809,999,6.71471471471471
516,483,6.66472868217054,6.77846790890269,999,6.71971971971972
531,468,6.65348399246704,6.77564102564103,999,6.71071071071071
519,480,6.67052023121387,6.76875,999,6.71771771771772
530,469,6.66981132075472,6.76972281449893,999,6.71671671671672
540,459,6.67777777777778,6.77342047930283,999,6.72172172172172
545,454,6.67339449541284,6.76211453744493,999,6.71371371371371
540,459,6.67592592592593,6.77995642701525,999,6.72372372372372
539,460,6.67532467532468,6.78478260869565,999,6.72572572572573
537,462,6.68156424581006,6.78571428571429,999,6.72972972972973
530,469,6.67924528301887,6.78464818763326,999,6.72872872872873
533,466,6.68480300187617,6.79184549356223,999,6.73473473473473
527,472,6.68500948766603,6.80084745762712,999,6.73973973973974
526,473,6.69011406844106,6.80338266384778,999,6.74374374374374
527,472,6.69639468690702,6.79449152542373,999,6.74274274274274
528,471,6.68560606060606,6.79405520169851,999,6.73673673673674
529,470,6.6937618147448,6.79787234042553,999,6.74274274274274
516,483,6.69767441860465,6.79089026915114,999,6.74274274274274
510,489,6.71960784313726,6.79754601226994,999,6.75775775775776
511,488,6.71624266144814,6.79098360655738,999,6.75275275275275
507,492,6.71794871794872,6.78455284552845,999,6.75075075075075
500,499,6.712,6.78356713426854,999,6.74774774774775
503,496,6.73359840954274,6.78427419354839,999,6.75875875875876
507,492,6.72978303747534,6.78658536585366,999,6.75775775775776
507,492,6.72781065088757,6.76626016260163,999,6.74674674674675
498,501,6.72088353413655,6.7624750499002,999,6.74174174174174
514,485,6.71984435797665,6.75051546391753,999,6.73473473473473
501,498,6.72654690618762,6.74096385542169,999,6.73373373373373
501,498,6.72255489021956,6.73694779116466,999,6.72972972972973
512,487,6.732421875,6.72484599589322,999,6.72872872872873
505,494,6.71683168316832,6.72064777327935,999,6.71871871871872
508,491,6.71456692913386,6.72301425661914,999,6.71871871871872
507,492,6.71005917159763,6.73780487804878,999,6.72372372372372
502,497,6.71713147410359,6.73440643863179,999,6.72572572572573
502,497,6.71314741035857,6.72434607645875,999,6.71871871871872
504,495,6.70039682539683,6.72525252525253,999,6.71271271271271
493,506,6.69979716024341,6.73715415019763,999,6.71871871871872
504,495,6.69246031746032,6.72525252525253,999,6.70870870870871
502,497,6.69521912350598,6.72635814889336,999,6.71071071071071
505,494,6.69306930693069,6.73886639676113,999,6.71571571571572
515,484,6.68932038834951,6.73347107438016,999,6.71071071071071
507,492,6.68639053254438,6.73577235772358,999,6.71071071071071
522,477,6.68965517241379,6.73375262054507,999,6.71071071071071
521,478,6.69481765834933,6.71966527196653,999,6.70670670670671
515,484,6.69514563106796,6.71900826446281,999,6.70670670670671
516,483,6.68410852713178,6.72670807453416,999,6.7047047047047
523,476,6.68451242829828,6.73109243697479,999,6.70670670670671
518,481,6.7027027027027,6.72141372141372,999,6.71171171171171
512,487,6.70703125,6.72279260780287,999,6.71471471471471
522,477,6.7088122605364,6.72327044025157,999,6.71571571571572
516,483,6.70736434108527,6.72256728778468,999,6.71471471471471
507,492,6.70611439842209,6.72154471544715,999,6.71371371371371
515,484,6.72233009708738,6.72314049586777,999,6.72272272272272
515,484,6.72815533980583,6.71280991735537,999,6.72072072072072
514,485,6.73151750972763,6.71340206185567,999,6.72272272272272
511,488,6.72015655577299,6.71106557377049,999,6.71571571571572
515,484,6.71650485436893,6.70247933884298,999,6.70970970970971
518,481,6.7027027027027,6.71725571725572,999,6.70970970970971
512,487,6.697265625,6.71868583162218,999,6.70770770770771
511,488,6.70645792563601,6.72745901639344,999,6.71671671671672
518,481,6.70849420849421,6.72349272349272,999,6.71571571571572
509,490,6.70726915520629,6.72040816326531,999,6.71371371371371
511,488,6.70058708414873,6.70491803278689,999,6.7027027027027
509,490,6.70726915520629,6.70204081632653,999,6.7047047047047
496,503,6.70161290322581,6.71570576540755,999,6.70870870870871
496,503,6.68951612903226,6.72564612326044,999,6.70770770770771
499,500,6.69338677354709,6.712,999,6.7027027027027
505,494,6.7029702970297,6.71457489878543,999,6.70870870870871
505,494,6.70891089108911,6.70242914979757,999,6.70570570570571
505,494,6.71683168316832,6.69028340080972,999,6.7037037037037
509,490,6.73870333988212,6.69591836734694,999,6.71771771771772
498,501,6.73293172690763,6.69461077844311,999,6.71371371371371
502,497,6.73505976095618,6.70422535211268,999,6.71971971971972
505,494,6.73861386138614,6.7085020242915,999,6.72372372372372
497,502,6.73440643863179,6.70517928286853,999,6.71971971971972
511,488,6.73776908023483,6.69467213114754,999,6.71671671671672
504,495,6.74603174603175,6.69292929292929,999,6.71971971971972
508,491,6.74409448818898,6.68431771894094,999,6.71471471471471
512,487,6.73046875,6.68788501026694,999,6.70970970970971
507,492,6.73767258382643,6.68089430894309,999,6.70970970970971
503,496,6.74353876739563,6.69153225806452,999,6.71771771771772
501,498,6.74251497005988,6.67871485943775,999,6.71071071071071
509,490,6.74656188605108,6.67551020408163,999,6.71171171171171
508,491,6.73425196850394,6.68024439918534,999,6.70770770770771
509,490,6.72888015717092,6.67551020408163,999,6.7027027027027
504,495,6.75,6.68282828282828,999,6.71671671671672
506,493,6.76679841897233,6.69776876267748,999,6.73273273273273
507,492,6.75936883629191,6.69918699186992,999,6.72972972972973
496,503,6.75806451612903,6.70775347912525,999,6.73273273273273
495,504,6.75151515151515,6.72023809523809,999,6.73573573573574
496,503,6.75,6.71769383697813,999,6.73373373373373
501,498,6.74051896207585,6.71686746987952,999,6.72872872872873
509,490,6.74066797642436,6.71836734693878,999,6.72972972972973
509,490,6.74066797642436,6.72040816326531,999,6.73073073073073
509,490,6.74066797642436,6.7265306122449,999,6.73373373373373
517,482,6.74854932301741,6.71576763485477,999,6.73273273273273
510,489,6.74901960784314,6.73006134969325,999,6.73973973973974
528,471,6.72916666666667,6.72186836518047,999,6.72572572572573
518,481,6.72972972972973,6.72557172557173,999,6.72772772772773
515,484,6.73203883495146,6.72520661157025,999,6.72872872872873
516,483,6.73837209302326,6.72670807453416,999,6.73273273273273
517,482,6.74081237911025,6.73858921161826,999,6.73973973973974
529,470,6.74102079395085,6.73191489361702,999,6.73673673673674
521,478,6.74088291746641,6.73640167364017,999,6.73873873873874
527,472,6.74762808349146,6.74576271186441,999,6.74674674674675
524,475,6.74809160305344,6.75157894736842,999,6.74974974974975
524,475,6.76145038167939,6.74947368421053,999,6.75575575575576
526,473,6.75095057034221,6.75264270613108,999,6.75175175175175
519,480,6.7514450867052,6.73958333333333,999,6.74574574574575
523,476,6.74760994263862,6.73319327731092,999,6.74074074074074
527,472,6.74193548387097,6.73516949152542,999,6.73873873873874
542,457,6.7380073800738,6.73960612691466,999,6.73873873873874
542,457,6.74354243542435,6.72866520787746,999,6.73673673673674
548,451,6.73722627737226,6.72949002217295,999,6.73373373373373
542,457,6.74538745387454,6.75492341356674,999,6.74974974974975
543,456,6.75874769797422,6.75438596491228,999,6.75675675675676
542,457,6.77121771217712,6.74835886214442,999,6.76076076076076
537,462,6.76908752327747,6.75974025974026,999,6.76476476476476
530,469,6.77735849056604,6.76545842217484,999,6.77177177177177
534,465,6.79213483146067,6.76989247311828,999,6.78178178178178
530,469,6.79433962264151,6.77825159914712,999,6.78678678678679
525,474,6.7847619047619,6.77004219409283,999,6.77777777777778
533,466,6.77298311444653,6.77467811158798,999,6.77377377377377
541,458,6.76524953789279,6.7882096069869,999,6.77577577577578
548,451,6.76824817518248,6.78935698447894,999,6.77777777777778
543,456,6.76427255985267,6.77850877192982,999,6.77077077077077
540,459,6.75925925925926,6.77995642701525,999,6.76876876876877
539,460,6.74768089053803,6.79130434782609,999,6.76776776776777
550,449,6.75454545454545,6.77951002227172,999,6.76576576576577
551,448,6.75499092558984,6.78348214285714,999,6.76776776776777
548,451,6.75912408759124,6.78492239467849,999,6.77077077077077
551,448,6.7568058076225,6.77455357142857,999,6.76476476476476
554,445,6.76714801444043,6.76179775280899,999,6.76476476476476
558,441,6.76164874551971,6.75963718820862,999,6.76076076076076
558,441,6.74551971326165,6.76643990929705,999,6.75475475475475
560,439,6.75,6.76309794988611,999,6.75575575575576
567,432,6.75132275132275,6.77083333333333,999,6.75975975975976
568,431,6.7306338028169,6.77726218097448,999,6.75075075075075
569,430,6.72759226713532,6.77906976744186,999,6.74974974974975
575,424,6.74608695652174,6.77594339622642,999,6.75875875875876
573,426,6.73821989528796,6.78638497652582,999,6.75875875875876
571,428,6.73905429071804,6.79439252336449,999,6.76276276276276
568,431,6.72887323943662,6.78886310904872,999,6.75475475475475
571,428,6.72854640980736,6.77803738317757,999,6.74974974974975
560,439,6.71607142857143,6.77904328018223,999,6.74374374374374
570,429,6.71052631578947,6.77156177156177,999,6.73673673673674
551,448,6.71143375680581,6.77455357142857,999,6.73973973973974
557,442,6.71095152603232,6.7737556561086,999,6.73873873873874
548,451,6.71715328467153,6.77827050997783,999,6.74474474474474
544,455,6.71507352941176,6.78241758241758,999,6.74574574574575
550,449,6.71636363636364,6.78841870824053,999,6.74874874874875
552,447,6.70108695652174,6.80089485458613,999,6.74574574574575
555,444,6.6972972972973,6.79054054054054,999,6.73873873873874
545,454,6.70275229357798,6.79074889867841,999,6.74274274274274
562,437,6.7135231316726,6.80320366132723,999,6.75275275275275
555,444,6.71711711711712,6.79504504504505,999,6.75175175175175
559,440,6.70483005366726,6.8,999,6.74674674674675
550,449,6.70181818181818,6.80400890868597,999,6.74774774774775
550,449,6.69454545454545,6.81514476614699,999,6.74874874874875
558,441,6.69534050179211,6.8140589569161,999,6.74774774774775
555,444,6.7045045045045,6.81756756756757,999,6.75475475475475
553,446,6.69439421338156,6.81165919282511,999,6.74674674674675
541,458,6.68761552680222,6.80786026200873,999,6.74274274274274
549,450,6.69398907103825,6.80444444444444,999,6.74374374374374
556,443,6.70503597122302,6.82392776523702,999,6.75775775775776
566,433,6.69434628975265,6.8175519630485,999,6.74774774774775
576,423,6.68576388888889,6.81323877068558,999,6.73973973973974
564,435,6.68262411347518,6.81609195402299,999,6.74074074074074
568,431,6.67781690140845,6.81670533642691,999,6.73773773773774
569,430,6.68365553602812,6.81395348837209,999,6.73973973973974
574,425,6.69337979094077,6.81176470588235,999,6.74374374374374
575,424,6.67826086956522,6.81367924528302,999,6.73573573573574
564,435,6.65425531914894,6.81609195402299,999,6.72472472472472
562,437,6.66192170818505,6.81693363844394,999,6.72972972972973
557,442,6.66965888689408,6.81447963800905,999,6.73373373373373
550,449,6.66909090909091,6.80846325167038,999,6.73173173173173
556,443,6.67086330935252,6.79909706546275,999,6.72772772772773
567,432,6.668430335097,6.7962962962963,999,6.72372372372372
559,440,6.67262969588551,6.79318181818182,999,6.72572572572573
562,437,6.66548042704626,6.78489702517162,999,6.71771771771772
558,441,6.67204301075269,6.80045351473923,999,6.72872872872873
558,441,6.66845878136201,6.80498866213152,999,6.72872872872873
554,445,6.65884476534296,6.81348314606742,999,6.72772772772773
561,438,6.66488413547237,6.80593607305936,999,6.72672672672673
555,444,6.66666666666667,6.8018018018018,999,6.72672672672673
548,451,6.66605839416058,6.80044345898004,999,6.72672672672673
551,448,6.67513611615245,6.79241071428571,999,6.72772772772773
551,448,6.69147005444646,6.79017857142857,999,6.73573573573574
544,455,6.69669117647059,6.8021978021978,999,6.74474474474474
543,456,6.69244935543278,6.81140350877193,999,6.74674674674675
545,454,6.69357798165138,6.81497797356828,999,6.74874874874875
542,457,6.70110701107011,6.81400437636762,999,6.75275275275275
537,462,6.70204841713222,6.82683982683983,999,6.75975975975976
544,455,6.69117647058824,6.82857142857143,999,6.75375375375375
543,456,6.69060773480663,6.82894736842105,999,6.75375375375375
549,450,6.68852459016393,6.82666666666667,999,6.75075075075075
536,463,6.69216417910448,6.82721382289417,999,6.75475475475475
548,451,6.69890510948905,6.82039911308204,999,6.75375375375375
550,449,6.70545454545455,6.8173719376392,999,6.75575575575576
544,455,6.70220588235294,6.82197802197802,999,6.75675675675676
549,450,6.67213114754098,6.84222222222222,999,6.74874874874875
542,457,6.67343173431734,6.84463894967177,999,6.75175175175175
541,458,6.66728280961183,6.85371179039301,999,6.75275275275275
537,462,6.65735567970205,6.84848484848485,999,6.74574574574575
545,454,6.65321100917431,6.85022026431718,999,6.74274274274274
540,459,6.68148148148148,6.84531590413943,999,6.75675675675676
538,461,6.68773234200744,6.85032537960954,999,6.76276276276276
528,471,6.68181818181818,6.84925690021231,999,6.76076076076076
524,475,6.68702290076336,6.85473684210526,999,6.76676676676677
523,476,6.69216061185468,6.84663865546218,999,6.76576576576577
523,476,6.68451242829828,6.85714285714286,999,6.76676676676677
530,469,6.67924528301887,6.85501066098081,999,6.76176176176176
536,463,6.69402985074627,6.86609071274298,999,6.77377377377377
531,468,6.67984934086629,6.85897435897436,999,6.76376376376376
527,472,6.6888045540797,6.86228813559322,999,6.77077077077077
520,479,6.67884615384615,6.8643006263048,999,6.76776776776777
524,475,6.67557251908397,6.86315789473684,999,6.76476476476476
531,468,6.67231638418079,6.86111111111111,999,6.76076076076076
535,464,6.67663551401869,6.86853448275862,999,6.76576576576577
525,474,6.67428571428571,6.86708860759494,999,6.76576576576577
514,485,6.66926070038911,6.8639175257732,999,6.76376376376376
504,495,6.66666666666667,6.86464646464646,999,6.76476476476476
500,499,6.676,6.87174348697395,999,6.77377377377377
496,503,6.66733870967742,6.86679920477137,999,6.76776776776777
492,507,6.67479674796748,6.8698224852071,999,6.77377377377377
498,501,6.68674698795181,6.87425149700599,999,6.78078078078078
496,503,6.6875,6.88071570576541,999,6.78478478478478
498,501,6.69277108433735,6.87025948103792,999,6.78178178178178
491,508,6.68431771894094,6.87007874015748,999,6.77877877877878
492,507,6.69918699186992,6.87573964497041,999,6.78878878878879
491,508,6.70061099796334,6.86811023622047,999,6.78578578578579
483,516,6.68530020703934,6.87209302325581,999,6.78178178178178
496,503,6.68145161290323,6.89463220675944,999,6.78878878878879
489,510,6.68916155419223,6.8921568627451,999,6.79279279279279
491,508,6.68839103869654,6.88779527559055,999,6.78978978978979
485,514,6.69690721649485,6.89299610894942,999,6.7977977977978
489,510,6.70143149284254,6.88627450980392,999,6.7957957957958
477,522,6.70440251572327,6.88505747126437,999,6.7987987987988
471,528,6.723991507431,6.88825757575758,999,6.81081081081081
469,530,6.73134328358209,6.88301886792453,999,6.81181181181181
457,542,6.72866520787746,6.87822878228782,999,6.80980980980981
465,534,6.72903225806452,6.87265917602996,999,6.80580580580581
464,535,6.7198275862069,6.87663551401869,999,6.8038038038038
458,541,6.72707423580786,6.86876155268022,999,6.8038038038038
449,550,6.69933184855234,6.86727272727273,999,6.79179179179179
451,548,6.70509977827051,6.87226277372263,999,6.7967967967968
462,537,6.7012987012987,6.8584729981378,999,6.78578578578579
459,540,6.70152505446623,6.86851851851852,999,6.79179179179179
456,543,6.69298245614035,6.87108655616943,999,6.78978978978979
464,535,6.6875,6.86915887850467,999,6.78478478478478
466,533,6.68669527896996,6.85928705440901,999,6.77877877877878
448,551,6.66964285714286,6.86388384754991,999,6.77677677677678
442,557,6.67420814479638,6.86175942549372,999,6.77877877877878
451,548,6.68736141906874,6.85401459854015,999,6.77877877877878
452,547,6.6858407079646,6.85740402193784,999,6.77977977977978
450,549,6.67333333333333,6.8615664845173,999,6.77677677677678
450,549,6.66,6.86703096539162,999,6.77377377377377
440,559,6.64545454545455,6.86940966010733,999,6.77077077077077
439,560,6.63325740318907,6.86964285714286,999,6.76576576576577
456,543,6.6359649122807,6.86187845303867,999,6.75875875875876
456,543,6.625,6.85819521178637,999,6.75175175175175
444,555,6.61936936936937,6.86846846846847,999,6.75775775775776
448,551,6.61383928571429,6.86388384754991,999,6.75175175175175
442,557,6.62669683257919,6.85637342908438,999,6.75475475475475
438,561,6.62785388127854,6.85383244206774,999,6.75475475475475
431,568,6.60324825986079,6.86267605633803,999,6.75075075075075
435,564,6.59540229885057,6.86702127659574,999,6.74874874874875
430,569,6.6,6.85588752196837,999,6.74574574574575
430,569,6.60232558139535,6.85764499121265,999,6.74774774774775
432,567,6.60185185185185,6.86243386243386,999,6.74974974974975
424,575,6.58962264150943,6.86782608695652,999,6.74974974974975
425,574,6.60235294117647,6.86585365853659,999,6.75375375375375
407,592,6.61670761670762,6.86824324324324,999,6.76576576576577
405,594,6.60246913580247,6.86700336700337,999,6.75975975975976
393,606,6.59287531806616,6.86468646864686,999,6.75775775775776
393,606,6.59541984732824,6.85973597359736,999,6.75575575575576
395,604,6.60506329113924,6.86092715231788,999,6.75975975975976
396,603,6.60606060606061,6.86401326699834,999,6.76176176176176
401,598,6.60099750623441,6.86789297658863,999,6.76076076076076
406,593,6.59113300492611,6.8752107925801,999,6.75975975975976
404,595,6.56930693069307,6.86890756302521,999,6.74774774774775
407,592,6.58476658476658,6.86317567567568,999,6.74974974974975
415,584,6.59036144578313,6.86986301369863,999,6.75375375375375
407,592,6.58230958230958,6.86824324324324,999,6.75175175175175
407,592,6.57985257985258,6.875,999,6.75475475475475
413,586,6.59806295399516,6.87372013651877,999,6.75975975975976
410,589,6.60243902439024,6.87096774193548,999,6.76076076076076
404,595,6.60148514851485,6.86890756302521,999,6.76076076076076
404,595,6.58663366336634,6.87058823529412,999,6.75575575575576
404,595,6.57920792079208,6.8672268907563,999,6.75075075075075
417,582,6.58273381294964,6.87628865979381,999,6.75375375375375
408,591,6.58823529411765,6.87817258883249,999,6.75975975975976
399,600,6.59649122807018,6.87833333333333,999,6.76576576576577
401,598,6.59351620947631,6.88628762541806,999,6.76876876876877
395,604,6.59240506329114,6.89735099337748,999,6.77677677677678
404,595,6.58910891089109,6.89915966386555,999,6.77377377377377
411,588,6.59610705596107,6.89285714285714,999,6.77077077077077
401,598,6.59600997506234,6.88628762541806,999,6.76976976976977
406,593,6.58128078817734,6.88532883642496,999,6.76176176176176
417,582,6.5947242206235,6.89347079037801,999,6.76876876876877
419,580,6.58233890214797,6.88448275862069,999,6.75775775775776
426,573,6.58215962441315,6.88307155322862,999,6.75475475475475
425,574,6.57647058823529,6.88327526132404,999,6.75275275275275
425,574,6.57411764705882,6.88327526132404,999,6.75175175175175
428,571,6.58177570093458,6.8861646234676,999,6.75575575575576
435,564,6.57011494252874,6.88652482269504,999,6.74874874874875
429,570,6.57575757575758,6.88421052631579,999,6.75175175175175
434,565,6.57142857142857,6.88849557522124,999,6.75075075075075
429,570,6.57342657342657,6.88771929824561,999,6.75275275275275
428,571,6.5607476635514,6.89492119089317,999,6.75175175175175
420,579,6.57142857142857,6.89637305699482,999,6.75975975975976
428,571,6.56542056074766,6.8984238178634,999,6.75575575575576
418,581,6.5622009569378,6.90189328743546,999,6.75975975975976
423,576,6.54373522458629,6.90104166666667,999,6.74974974974975
417,582,6.55875299760192,6.90721649484536,999,6.76176176176176
415,584,6.55180722891566,6.90582191780822,999,6.75875875875876
415,584,6.53493975903614,6.91438356164384,999,6.75675675675676
418,581,6.53349282296651,6.91910499139415,999,6.75775775775776
424,575,6.53537735849057,6.91826086956522,999,6.75575575575576
434,565,6.536866359447,6.91681415929204,999,6.75175175175175
433,566,6.52886836027714,6.91696113074205,999,6.74874874874875
441,558,6.53741496598639,6.91397849462366,999,6.74774774774775
447,552,6.53691275167785,6.91123188405797,999,6.74374374374374
456,543,6.53289473684211,6.91160220994475,999,6.73873873873874
448,551,6.54464285714286,6.91107078039927,999,6.74674674674675
455,544,6.56483516483516,6.90625,999,6.75075075075075
444,555,6.55630630630631,6.9027027027027,999,6.74874874874875
439,560,6.55353075170843,6.89821428571429,999,6.74674674674675
440,559,6.55681818181818,6.89445438282648,999,6.74574574574575
437,562,6.55148741418764,6.89501779359431,999,6.74474474474474
427,572,6.5480093676815,6.9020979020979,999,6.75075075075075
434,565,6.536866359447,6.90796460176991,999,6.74674674674675
436,563,6.53211009174312,6.90941385435169,999,6.74474474474474
434,565,6.51382488479263,6.90619469026549,999,6.73573573573574
434,565,6.51382488479263,6.90619469026549,999,6.73573573573574
427,572,6.52459016393443,6.90734265734266,999,6.74374374374374
424,575,6.54009433962264,6.9095652173913,999,6.75275275275275
427,572,6.54098360655738,6.91433566433566,999,6.75475475475475
433,566,6.54272517321016,6.91872791519435,999,6.75575575575576
444,555,6.54054054054054,6.91711711711712,999,6.74974974974975
449,550,6.54120267260579,6.91636363636364,999,6.74774774774775
439,560,6.5375854214123,6.92321428571429,999,6.75375375375375
435,564,6.53563218390805,6.92375886524823,999,6.75475475475475
430,569,6.53255813953488,6.91739894551845,999,6.75175175175175
419,580,6.5346062052506,6.92241379310345,999,6.75975975975976
415,584,6.52048192771084,6.9263698630137,999,6.75775775775776
414,585,6.53381642512077,6.92649572649573,999,6.76376376376376
411,588,6.51094890510949,6.92176870748299,999,6.75275275275275
419,580,6.50596658711217,6.92758620689655,999,6.75075075075075
429,570,6.51048951048951,6.91754385964912,999,6.74274274274274
425,574,6.52235294117647,6.91114982578397,999,6.74574574574575
425,574,6.51529411764706,6.91463414634146,999,6.74474474474474
428,571,6.50467289719626,6.91593695271454,999,6.73973973973974
432,567,6.50462962962963,6.91710758377425,999,6.73873873873874
440,559,6.52045454545455,6.91949910554562,999,6.74374374374374
437,562,6.52402745995423,6.91992882562278,999,6.74674674674675
432,567,6.51851851851852,6.91534391534392,999,6.74374374374374
432,567,6.51388888888889,6.91534391534392,999,6.74174174174174
428,571,6.52570093457944,6.91768826619965,999,6.74974974974975
437,562,6.53775743707094,6.91992882562278,999,6.75275275275275
439,560,6.53302961275626,6.92678571428571,999,6.75375375375375
442,557,6.52941176470588,6.92639138240575,999,6.75075075075075
435,564,6.51954022988506,6.93085106382979,999,6.75175175175175
442,557,6.51809954751131,6.92998204667864,999,6.74774774774775
427,572,6.52459016393443,6.92307692307692,999,6.75275275275275
426,573,6.52816901408451,6.92844677137871,999,6.75775775775776
431,568,6.53132250580046,6.93661971830986,999,6.76176176176176
433,566,6.53810623556582,6.93992932862191,999,6.76576576576577
433,566,6.53810623556582,6.9416961130742,999,6.76676676676677
422,577,6.54976303317536,6.94107452339688,999,6.77577577577578
420,579,6.55952380952381,6.95164075993092,999,6.78678678678679
421,578,6.55106888361045,6.95328719723183,999,6.78378378378378
425,574,6.54352941176471,6.94947735191638,999,6.77677677677678
429,570,6.55477855477855,6.95087719298246,999,6.78078078078078
428,571,6.56775700934579,6.95096322241681,999,6.78678678678679
427,572,6.58548009367682,6.94755244755245,999,6.79279279279279
425,574,6.58117647058824,6.94599303135888,999,6.79079079079079
420,579,6.58571428571429,6.9447322970639,999,6.79379379379379
424,575,6.58962264150943,6.94782608695652,999,6.7957957957958
420,579,6.58095238095238,6.95164075993092,999,6.7957957957958
416,583,6.57932692307692,6.95368782161235,999,6.7977977977978
416,583,6.57211538461539,6.95711835334477,999,6.7967967967968
403,596,6.55583126550868,6.95469798657718,999,6.79379379379379
405,594,6.56296296296296,6.95791245791246,999,6.7977977977978
405,594,6.56296296296296,6.95959595959596,999,6.7987987987988
408,591,6.57352941176471,6.96108291032149,999,6.8028028028028
403,596,6.55583126550868,6.96140939597315,999,6.7977977977978
399,600,6.56140350877193,6.96333333333333,999,6.8028028028028
400,599,6.5675,6.96494156928214,999,6.80580580580581
414,585,6.56280193236715,6.96410256410256,999,6.7977977977978
404,595,6.5519801980198,6.96302521008403,999,6.7967967967968
412,587,6.55825242718447,6.95911413969336,999,6.79379379379379
411,588,6.55717761557178,6.95918367346939,999,6.79379379379379
409,590,6.55256723716381,6.95593220338983,999,6.79079079079079
407,592,6.56511056511057,6.95777027027027,999,6.7977977977978
398,601,6.55276381909548,6.96006655574043,999,6.7977977977978
402,597,6.54228855721393,6.96314907872697,999,6.79379379379379
399,600,6.54887218045113,6.96666666666667,999,6.7997997997998
399,600,6.54385964912281,6.965,999,6.7967967967968
414,585,6.55314009661836,6.95897435897436,999,6.79079079079079
410,589,6.55365853658537,6.96095076400679,999,6.79379379379379
410,589,6.55609756097561,6.96264855687606,999,6.7957957957958
403,596,6.54590570719603,6.96308724832215,999,6.79479479479479
411,588,6.52068126520681,6.96258503401361,999,6.78078078078078
407,592,6.53071253071253,6.96283783783784,999,6.78678678678679
405,594,6.51111111111111,6.96632996632997,999,6.78178178178178
412,587,6.52912621359223,6.96763202725724,999,6.78678678678679
415,584,6.53734939759036,6.97602739726027,999,6.79379379379379
423,576,6.52718676122931,6.97395833333333,999,6.78478478478478
414,585,6.50724637681159,6.97094017094017,999,6.77877877877878
414,585,6.5024154589372,6.97094017094017,999,6.77677677677678
412,587,6.5121359223301,6.97444633730835,999,6.78378378378378
420,579,6.50714285714286,6.97754749568221,999,6.77977977977978
423,576,6.49645390070922,6.97916666666667,999,6.77477477477477
417,582,6.5083932853717,6.97766323024055,999,6.78178178178178
419,580,6.51073985680191,6.97586206896552,999,6.78078078078078
414,585,6.50966183574879,6.97435897435897,999,6.78178178178178
421,578,6.50356294536817,6.97058823529412,999,6.77377377377377
438,561,6.51369863013699,6.97147950089127,999,6.77077077077077
440,559,6.50681818181818,6.9695885509839,999,6.76576576576577
452,547,6.51548672566372,6.97257769652651,999,6.76576576576577
430,569,6.51860465116279,6.96836555360281,999,6.77477477477477
438,561,6.51826484018265,6.96791443850267,999,6.77077077077077
431,568,6.51044083526682,6.97535211267606,999,6.77477477477477
430,569,6.51627906976744,6.97188049209139,999,6.77577577577578
435,564,6.51494252873563,6.97340425531915,999,6.77377377377377
441,558,6.51473922902494,6.97670250896057,999,6.77277277277277
450,549,6.51111111111111,6.97632058287796,999,6.76676676676677
442,557,6.51357466063348,6.97845601436266,999,6.77277277277277
445,554,6.50112359550562,6.98014440433213,999,6.76676676676677
431,568,6.50580046403712,6.98591549295775,999,6.77877877877878
433,566,6.50346420323326,6.98586572438163,999,6.77677677677678
419,580,6.50596658711217,6.98620689655172,999,6.78478478478478
417,582,6.48920863309352,6.98625429553265,999,6.77877877877878
411,588,6.49148418491484,6.98639455782313,999,6.78278278278278
421,578,6.49881235154394,6.98615916955017,999,6.78078078078078
430,569,6.48372093023256,6.99121265377856,999,6.77277277277277
431,568,6.49187935034803,6.98943661971831,999,6.77477477477477
420,579,6.48333333333333,6.98963730569948,999,6.77677677677678
416,583,6.47836538461539,6.98970840480274,999,6.77677677677678
429,570,6.46386946386946,6.99298245614035,999,6.76576576576577
432,567,6.46990740740741,6.99470899470899,999,6.76776776776777
439,560,6.49202733485194,6.99464285714286,999,6.77377377377377
421,578,6.48931116389549,6.99480968858131,999,6.78178178178178
417,582,6.47721822541966,6.99484536082474,999,6.77877877877878
423,576,6.49408983451537,6.99479166666667,999,6.78278278278278
407,592,6.47174447174447,6.99493243243243,999,6.78178178178178
410,589,6.47560975609756,6.99320882852292,999,6.78078078078078
409,590,6.46943765281174,6.99152542372881,999,6.77777777777778
413,586,6.46004842615012,6.98976109215017,999,6.77077077077077
411,588,6.44768856447689,6.98809523809524,999,6.76576576576577
414,585,6.45652173913043,6.98803418803419,999,6.76776776776777
421,578,6.45605700712589,6.98961937716263,999,6.76476476476476
422,577,6.45497630331754,6.98786828422877,999,6.76276276276276
426,573,6.45305164319249,6.9912739965096,999,6.76176176176176
418,581,6.44019138755981,6.99139414802065,999,6.76076076076076
426,573,6.44131455399061,6.99301919720768,999,6.75775775775776
430,569,6.45116279069767,6.99472759226714,999,6.76076076076076
419,580,6.46062052505967,6.99655172413793,999,6.77177177177177
415,584,6.46265060240964,6.99657534246575,999,6.77477477477477
415,584,6.44578313253012,6.99657534246575,999,6.76776776776777
418,581,6.46650717703349,6.99827882960413,999,6.77577577577578
411,588,6.45255474452555,6.99829931972789,999,6.77377377377377
422,577,6.44312796208531,6.99653379549393,999,6.76276276276276
428,571,6.43457943925234,6.99824868651489,999,6.75675675675676
422,577,6.44312796208531,6.99826689774697,999,6.76376376376376
420,579,6.45,6.99827288428325,999,6.76776776776777
428,571,6.44158878504673,6.99649737302977,999,6.75875875875876
421,578,6.44418052256532,6.99826989619377,999,6.76476476476476
417,582,6.44364508393285,6.99828178694158,999,6.76676676676677
410,589,6.45853658536585,7.0,999,6.77777777777778
401,598,6.46384039900249,7.0,999,6.78478478478478
404,595,6.46534653465347,7.0,999,6.78378378378378
412,587,6.49514563106796,7.0,999,6.79179179179179
400,599,6.5,7.0,999,6.7997997997998
395,604,6.50126582278481,7.0,999,6.8028028028028
391,608,6.49872122762148,7.0,999,6.8038038038038
394,605,6.49746192893401,7.0,999,6.8018018018018
385,614,6.51428571428571,7.0,999,6.81281281281281
394,605,6.51776649746193,7.0,999,6.80980980980981
404,595,6.53465346534653,7.0,999,6.81181181181181
394,605,6.52791878172589,7.0,999,6.81381381381381
411,588,6.52798053527981,7.0,999,6.80580580580581
408,591,6.53186274509804,7.0,999,6.80880880880881
396,603,6.52272727272727,7.0,999,6.81081081081081
391,608,6.51662404092072,7.0,999,6.81081081081081
392,607,6.50255102040816,7.0,999,6.8048048048048
390,609,6.51025641025641,7.0,999,6.80880880880881
388,611,6.50515463917526,7.0,999,6.80780780780781
389,610,6.50899742930591,7.0,999,6.80880880880881
386,613,6.52072538860104,7.0,999,6.81481481481481
391,608,6.52173913043478,7.0,999,6.81281281281281
392,607,6.51530612244898,7.0,999,6.80980980980981
402,597,6.50995024875622,7.0,999,6.8028028028028
396,603,6.51767676767677,7.0,999,6.80880880880881
397,602,6.52392947103275,7.0,999,6.81081081081081
407,592,6.52088452088452,7.0,999,6.8048048048048
411,588,6.51338199513382,7.0,999,6.7997997997998
414,585,6.52173913043478,7.0,999,6.8018018018018
432,567,6.51388888888889,7.0,999,6.78978978978979
437,562,6.50572082379863,7.0,999,6.78378378378378
440,559,6.51590909090909,7.0,999,6.78678678678679
449,550,6.51002227171492,7.0,999,6.77977977977978
457,542,6.5164113785558,7.0,999,6.77877877877878
454,545,6.52202643171806,7.0,999,6.78278278278278
456,543,6.51754385964912,7.0,999,6.77977977977978
473,526,6.5369978858351,7.0,999,6.78078078078078
477,522,6.54297693920335,7.0,999,6.78178178178178
478,521,6.53974895397489,7.0,999,6.77977977977978
476,523,6.55042016806723,7.0,999,6.78578578578579
479,520,6.55741127348643,7.0,999,6.78778778778779
479,520,6.5615866388309,7.0,999,6.78978978978979
484,515,6.55785123966942,7.0,999,6.78578578578579
499,500,6.56112224448898,7.0,999,6.78078078078078
488,511,6.55327868852459,7.0,999,6.78178178178178
483,516,6.56107660455487,7.0,999,6.78778778778779
481,518,6.56964656964657,7.0,999,6.79279279279279
483,516,6.56107660455487,7.0,999,6.78778778778779
488,511,6.57172131147541,7.0,999,6.79079079079079
491,508,6.57433808553971,7.0,999,6.79079079079079
497,502,6.57344064386318,7.0,999,6.78778778778779
497,502,6.54929577464789,7.0,999,6.77577577577578
500,499,6.546,7.0,999,6.77277277277277
504,495,6.56150793650794,7.0,999,6.77877877877878
509,490,6.55402750491159,7.0,999,6.77277277277277
525,474,6.55047619047619,7.0,999,6.76376376376376
515,484,6.5631067961165,7.0,999,6.77477477477477
527,472,6.55977229601518,7.0,999,6.76776776776777
519,480,6.56647398843931,7.0,999,6.77477477477477
520,479,6.56538461538462,7.0,999,6.77377377377377
516,483,6.5562015503876,7.0,999,6.77077077077077
506,493,6.56719367588933,7.0,999,6.78078078078078
509,490,6.55795677799607,7.0,999,6.77477477477477
491,508,6.56008146639511,7.0,999,6.78378378378378
493,506,6.5659229208925,7.0,999,6.78578578578579
493,506,6.56389452332657,7.0,999,6.78478478478478
494,505,6.56882591093117,7.0,999,6.78678678678679
484,515,6.58057851239669,7.0,999,6.7967967967968
483,516,6.59213250517598,7.0,999,6.8028028028028
477,522,6.59958071278826,7.0,999,6.80880880880881
475,524,6.61263157894737,7.0,999,6.81581581581582
460,539,6.60217391304348,7.0,999,6.81681681681682
464,535,6.62068965517241,7.0,999,6.82382382382382
457,542,6.61925601750547,7.0,999,6.82582582582583
465,534,6.62150537634409,7.0,999,6.82382382382382
467,532,6.61027837259101,7.0,999,6.81781781781782
472,527,6.61016949152542,7.0,999,6.81581581581582
475,524,6.59789473684211,7.0,999,6.80880880880881
472,527,6.61864406779661,7.0,999,6.81981981981982
480,519,6.61458333333333,7.0,999,6.81481481481481
480,519,6.61666666666667,7.0,999,6.81581581581582
468,531,6.62393162393162,7.0,999,6.82382382382382
470,529,6.61914893617021,7.0,999,6.82082082082082
472,527,6.60805084745763,7.0,999,6.81481481481481
470,529,6.61063829787234,7.0,999,6.81681681681682
470,529,6.62127659574468,7.0,999,6.82182182182182
466,533,6.60085836909871,7.0,999,6.81381381381381
474,525,6.59915611814346,7.0,999,6.80980980980981
469,530,6.60341151385928,7.0,999,6.81381381381381
470,529,6.59574468085106,7.0,999,6.80980980980981
466,533,6.59871244635193,7.0,999,6.81281281281281
466,533,6.60300429184549,7.0,999,6.81481481481481
480,519,6.61458333333333,7.0,999,6.81481481481481
471,528,6.61571125265393,7.0,999,6.81881881881882
471,528,6.62208067940552,7.0,999,6.82182182182182
477,522,6.61006289308176,7.0,999,6.81381381381381
481,518,6.58835758835759,7.0,999,6.8018018018018
477,522,6.56394129979036,7.0,999,6.79179179179179
467,532,6.56531049250535,7.0,999,6.7967967967968
473,526,6.56871035940803,7.0,999,6.7957957957958
475,524,6.55578947368421,7.0,999,6.78878878878879
479,520,6.55323590814196,7.0,999,6.78578578578579
483,516,6.55486542443064,7.0,999,6.78478478478478
475,524,6.55368421052632,7.0,999,6.78778778778779
475,524,6.53684210526316,7.0,999,6.77977977977978
477,522,6.53668763102725,7.0,999,6.77877877877878
490,509,6.54285714285714,7.0,999,6.77577577577578
486,513,6.54115226337449,7.0,999,6.77677677677678
482,517,6.54564315352697,7.0,999,6.78078078078078
485,514,6.54639175257732,7.0,999,6.77977977977978
488,511,6.56352459016393,7.0,999,6.78678678678679
485,514,6.55051546391753,7.0,999,6.78178178178178
476,523,6.55042016806723,7.0,999,6.78578578578579
474,525,6.55485232067511,7.0,999,6.78878878878879
467,532,6.53961456102784,7.0,999,6.78478478478478
469,530,6.55863539445629,7.0,999,6.79279279279279
476,523,6.5672268907563,7.0,999,6.79379379379379
474,525,6.57172995780591,7.0,999,6.7967967967968
477,522,6.58071278825996,7.0,999,6.7997997997998
478,521,6.5836820083682,7.0,999,6.8008008008008
467,532,6.56959314775161,7.0,999,6.7987987987988
465,534,6.5505376344086,7.0,999,6.79079079079079
460,539,6.55,7.0,999,6.79279279279279
470,529,6.55531914893617,7.0,999,6.79079079079079
464,535,6.56465517241379,7.0,999,6.7977977977978
464,535,6.56465517241379,7.0,999,6.7977977977978
472,527,6.56779661016949,7.0,999,6.7957957957958
475,524,6.56842105263158,7.0,999,6.79479479479479
482,517,6.5643153526971,7.0,999,6.78978978978979
489,510,6.58691206543967,7.0,999,6.7977977977978
483,516,6.5879917184265,7.0,999,6.8008008008008
481,518,6.59043659043659,7.0,999,6.8028028028028
471,528,6.61146496815287,7.0,999,6.81681681681682
487,512,6.60369609856263,7.0,999,6.80680680680681
479,520,6.60334029227557,7.0,999,6.80980980980981
484,515,6.59917355371901,7.0,999,6.80580580580581
485,514,6.61237113402062,7.0,999,6.81181181181181
476,523,6.62394957983193,7.0,999,6.82082082082082
479,520,6.62004175365345,7.0,999,6.81781781781782
477,522,6.60587002096436,7.0,999,6.81181181181181
475,524,6.62315789473684,7.0,999,6.82082082082082
471,528,6.62632696390658,7.0,999,6.82382382382382
472,527,6.63559322033898,7.0,999,6.82782782782783
483,516,6.63768115942029,7.0,999,6.82482482482482
475,524,6.62105263157895,7.0,999,6.81981981981982
471,528,6.63057324840764,7.0,999,6.82582582582583
473,526,6.6384778012685,7.0,999,6.82882882882883
483,516,6.64182194616977,7.0,999,6.82682682682683
482,517,6.63485477178423,7.0,999,6.82382382382382
486,513,6.64197530864198,7.0,999,6.82582582582583
486,513,6.6522633744856,7.0,999,6.83083083083083
472,527,6.67372881355932,7.0,999,6.84584584584585
489,510,6.67075664621677,7.0,999,6.83883883883884
499,500,6.67134268537074,7.0,999,6.83583583583584
508,491,6.67913385826772,7.0,999,6.83683683683684
503,496,6.67395626242545,7.0,999,6.83583583583584
512,487,6.689453125,7.0,999,6.84084084084084
510,489,6.68823529411765,7.0,999,6.84084084084084
506,493,6.67786561264822,7.0,999,6.83683683683684
506,493,6.68577075098814,7.0,999,6.84084084084084
518,481,6.68532818532818,7.0,999,6.83683683683684
516,483,6.6937984496124,7.0,999,6.84184184184184
517,482,6.69245647969052,7.0,999,6.84084084084084
525,474,6.68952380952381,7.0,999,6.83683683683684
525,474,6.68,7.0,999,6.83183183183183
508,491,6.6751968503937,7.0,999,6.83483483483483
509,490,6.67976424361493,7.0,999,6.83683683683684
513,486,6.67056530214425,7.0,999,6.83083083083083
503,496,6.68389662027833,7.0,999,6.84084084084084
498,501,6.68273092369478,7.0,999,6.84184184184184
506,493,6.68379446640316,7.0,999,6.83983983983984
499,500,6.687374749499,7.0,999,6.84384384384384
496,503,6.69354838709677,7.0,999,6.84784784784785
495,504,6.69090909090909,7.0,999,6.84684684684685
492,507,6.69308943089431,7.0,999,6.84884884884885
496,503,6.67943548387097,7.0,999,6.84084084084084
484,515,6.67768595041322,7.0,999,6.84384384384384
498,501,6.67670682730924,7.0,999,6.83883883883884
500,499,6.684,7.0,999,6.84184184184184
493,506,6.67951318458418,7.0,999,6.84184184184184
496,503,6.67943548387097,7.0,999,6.84084084084084
496,503,6.67540322580645,7.0,999,6.83883883883884
501,498,6.67465069860279,7.0,999,6.83683683683684
511,488,6.67710371819961,7.0,999,6.83483483483483
511,488,6.67906066536204,7.0,999,6.83583583583584
504,495,6.69047619047619,7.0,999,6.84384384384384
502,497,6.70517928286853,7.0,999,6.85185185185185
514,485,6.69455252918288,7.0,999,6.84284284284284
502,497,6.67729083665339,7.0,999,6.83783783783784
501,498,6.69860279441118,7.0,999,6.84884884884885
495,504,6.69292929292929,7.0,999,6.84784784784785
499,500,6.69138276553106,7.0,999,6.84584584584585
509,490,6.69744597249509,7.0,999,6.84584584584585
507,492,6.68441814595661,7.0,999,6.83983983983984
494,505,6.69230769230769,7.0,999,6.84784784784785
495,504,6.68888888888889,7.0,999,6.84584584584585
500,499,6.672,7.0,999,6.83583583583584
497,502,6.67404426559356,7.0,999,6.83783783783784
513,486,6.69005847953216,7.0,999,6.84084084084084
516,483,6.68992248062016,7.0,999,6.83983983983984
517,482,6.68085106382979,7.0,999,6.83483483483483
515,484,6.66019417475728,7.0,999,6.82482482482482
513,486,6.66081871345029,7.0,999,6.82582582582583
513,486,6.65302144249513,7.0,999,6.82182182182182
514,485,6.64785992217899,7.0,999,6.81881881881882
519,480,6.66281310211946,7.0,999,6.82482482482482
503,496,6.66998011928429,7.0,999,6.83383383383383
503,496,6.67196819085487,7.0,999,6.83483483483483
508,491,6.66535433070866,7.0,999,6.82982982982983
507,492,6.66863905325444,7.0,999,6.83183183183183
504,495,6.66071428571429,7.0,999,6.82882882882883
498,501,6.66265060240964,7.0,999,6.83183183183183
505,494,6.66336633663366,7.0,999,6.82982982982983
507,492,6.64891518737673,7.0,999,6.82182182182182
506,493,6.64624505928854,7.0,999,6.82082082082082
507,492,6.61735700197239,7.0,999,6.80580580580581
511,488,6.62818003913894,7.0,999,6.80980980980981
504,495,6.63690476190476,7.0,999,6.81681681681682
511,488,6.64383561643836,7.0,999,6.81781781781782
519,480,6.64739884393064,7.0,999,6.81681681681682
512,487,6.658203125,7.0,999,6.82482482482482
505,494,6.64950495049505,7.0,999,6.82282282282282
506,493,6.6501976284585,7.0,999,6.82282282282282
511,488,6.65166340508806,7.0,999,6.82182182182182
504,495,6.66666666666667,7.0,999,6.83183183183183
501,498,6.6686626746507,7.0,999,6.83383383383383
507,492,6.67652859960552,7.0,999,6.83583583583584
507,492,6.67061143984221,7.0,999,6.83283283283283
509,490,6.67583497053045,7.0,999,6.83483483483483
503,496,6.6779324055666,7.0,999,6.83783783783784
489,510,6.67280163599182,7.0,999,6.83983983983984
477,522,6.68134171907757,7.0,999,6.84784784784785
474,525,6.68565400843882,7.0,999,6.85085085085085
473,526,6.68498942917548,7.0,999,6.85085085085085
474,525,6.68565400843882,7.0,999,6.85085085085085
478,521,6.68828451882845,7.0,999,6.85085085085085
464,535,6.67241379310345,7.0,999,6.84784784784785
457,542,6.66958424507659,7.0,999,6.84884884884885
466,533,6.66309012875536,7.0,999,6.84284284284284
460,539,6.66086956521739,7.0,999,6.84384384384384
455,544,6.66813186813187,7.0,999,6.84884884884885
459,540,6.66448801742919,7.0,999,6.84584584584585
456,543,6.65131578947368,7.0,999,6.84084084084084
450,549,6.65111111111111,7.0,999,6.84284284284284
450,549,6.64666666666667,7.0,999,6.84084084084084
448,551,6.65178571428571,7.0,999,6.84384384384384
453,546,6.66225165562914,7.0,999,6.84684684684685
450,549,6.66666666666667,7.0,999,6.84984984984985
459,540,6.67320261437909,7.0,999,6.84984984984985
462,537,6.67965367965368,7.0,999,6.85185185185185
460,539,6.6695652173913,7.0,999,6.84784784784785
467,532,6.67023554603854,7.0,999,6.84584584584585
470,529,6.66808510638298,7.0,999,6.84384384384384
470,529,6.67659574468085,7.0,999,6.84784784784785
463,536,6.6695464362851,7.0,999,6.84684684684685
468,531,6.66666666666667,7.0,999,6.84384384384384
474,525,6.65822784810127,7.0,999,6.83783783783784
478,521,6.66317991631799,7.0,999,6.83883883883884
473,526,6.66596194503171,7.0,999,6.84184184184184
469,530,6.66524520255864,7.0,999,6.84284284284284
485,514,6.6639175257732,7.0,999,6.83683683683684
483,516,6.68530020703934,7.0,999,6.84784784784785
484,515,6.6900826446281,7.0,999,6.84984984984985
495,504,6.67878787878788,7.0,999,6.84084084084084
490,509,6.6734693877551,7.0,999,6.83983983983984
477,522,6.67295597484277,7.0,999,6.84384384384384
472,527,6.67584745762712,7.0,999,6.84684684684685
466,533,6.67811158798283,7.0,999,6.84984984984985
464,535,6.69396551724138,7.0,999,6.85785785785786
453,546,6.69094922737307,7.0,999,6.85985985985986
463,536,6.69330453563715,7.0,999,6.85785785785786
474,525,6.68143459915612,7.0,999,6.84884884884885
467,532,6.66595289079229,7.0,999,6.84384384384384
471,528,6.6624203821656,7.0,999,6.84084084084084
469,530,6.66950959488273,7.0,999,6.84484484484484
471,528,6.67515923566879,7.0,999,6.84684684684685
469,530,6.66098081023454,7.0,999,6.84084084084084
468,531,6.6517094017094,7.0,999,6.83683683683684
485,514,6.67216494845361,7.0,999,6.84084084084084
487,512,6.6611909650924,7.0,999,6.83483483483483
496,503,6.66129032258065,7.0,999,6.83183183183183
496,503,6.65524193548387,7.0,999,6.82882882882883
490,509,6.66938775510204,7.0,999,6.83783783783784
493,506,6.66125760649087,7.0,999,6.83283283283283
489,510,6.68302658486708,7.0,999,6.84484484484484
496,503,6.66733870967742,7.0,999,6.83483483483483
490,509,6.67142857142857,7.0,999,6.83883883883884
490,509,6.68163265306122,7.0,999,6.84384384384384
485,514,6.68453608247423,7.0,999,6.84684684684685
478,521,6.68200836820084,7.0,999,6.84784784784785
489,510,6.67075664621677,7.0,999,6.83883883883884
486,513,6.67901234567901,7.0,999,6.84384384384384
487,512,6.69815195071869,7.0,999,6.85285285285285
475,524,6.68842105263158,7.0,999,6.85185185185185
478,521,6.67573221757322,7.0,999,6.84484484484484
486,513,6.68724279835391,7.0,999,6.84784784784785
489,510,6.68098159509202,7.0,999,6.84384384384384
493,506,6.68965517241379,7.0,999,6.84684684684685
492,507,6.6849593495935,7.0,999,6.84484484484484
495,504,6.68282828282828,7.0,999,6.84284284284284
497,502,6.67002012072435,7.0,999,6.83583583583584
505,494,6.67326732673267,7.0,999,6.83483483483483
503,496,6.68986083499006,7.0,999,6.84384384384384
519,480,6.6878612716763,7.0,999,6.83783783783784
532,467,6.68609022556391,7.0,999,6.83283283283283
536,463,6.69962686567164,7.0,999,6.83883883883884
531,468,6.70433145009416,7.0,999,6.84284284284284
531,468,6.70433145009416,7.0,999,6.84284284284284
530,469,6.69811320754717,7.0,999,6.83983983983984
528,471,6.69886363636364,7.0,999,6.84084084084084
532,467,6.70676691729323,7.0,999,6.84384384384384
537,462,6.70204841713222,7.0,999,6.83983983983984
528,471,6.70833333333333,7.0,999,6.84584584584585
533,466,6.70731707317073,7.0,999,6.84384384384384
532,467,6.71428571428571,7.0,999,6.84784784784785
531,468,6.70056497175141,7.0,999,6.84084084084084
528,471,6.70265151515152,7.0,999,6.84284284284284
542,457,6.69741697416974,7.0,999,6.83583583583584
536,463,6.6884328358209,7.0,999,6.83283283283283
533,466,6.69043151969981,7.0,999,6.83483483483483
539,460,6.68274582560297,7.0,999,6.82882882882883
533,466,6.67354596622889,7.0,999,6.82582582582583
534,465,6.66479400749064,7.0,999,6.82082082082082
535,464,6.6785046728972,7.0,999,6.82782782782783
539,460,6.66233766233766,7.0,999,6.81781781781782
544,455,6.66544117647059,7.0,999,6.81781781781782
548,451,6.65875912408759,7.0,999,6.81281281281281
546,453,6.67216117216117,7.0,999,6.82082082082082
536,463,6.67537313432836,7.0,999,6.82582582582583
527,472,6.66982922201139,7.0,999,6.82582582582583
527,472,6.66793168880455,7.0,999,6.82482482482482
537,462,6.66294227188082,7.0,999,6.81881881881882
539,460,6.66048237476809,7.0,999,6.81681681681682
537,462,6.66480446927374,7.0,999,6.81981981981982
540,459,6.66111111111111,7.0,999,6.81681681681682
540,459,6.65185185185185,7.0,999,6.81181181181181
536,463,6.65671641791045,7.0,999,6.81581581581582
546,453,6.63369963369963,7.0,999,6.7997997997998
549,450,6.6247723132969,7.0,999,6.79379379379379
553,446,6.62567811934901,7.0,999,6.79279279279279
552,447,6.6304347826087,7.0,999,6.7957957957958
545,454,6.62018348623853,7.0,999,6.79279279279279
538,461,6.61338289962825,7.0,999,6.79179179179179
537,462,6.61266294227188,7.0,999,6.79179179179179
525,474,6.60761904761905,7.0,999,6.79379379379379
523,476,6.60611854684512,7.0,999,6.79379379379379
529,470,6.5992438563327,7.0,999,6.78778778778779
511,488,6.61252446183953,7.0,999,6.8018018018018
505,494,6.61386138613861,7.0,999,6.8048048048048
503,496,6.610337972167,7.0,999,6.8038038038038
517,482,6.60928433268859,7.0,999,6.7977977977978
510,489,6.60980392156863,7.0,999,6.8008008008008
508,491,6.61417322834646,7.0,999,6.8038038038038
514,485,6.60311284046693,7.0,999,6.7957957957958
516,483,6.61046511627907,7.0,999,6.7987987987988
523,476,6.60038240917782,7.0,999,6.79079079079079
524,475,6.61450381679389,7.0,999,6.7977977977978
526,473,6.60836501901141,7.0,999,6.79379379379379
533,466,6.5984990619137,7.0,999,6.78578578578579
534,465,6.5936329588015,7.0,999,6.78278278278278
540,459,6.58888888888889,7.0,999,6.77777777777778
537,462,6.58845437616387,7.0,999,6.77877877877878
541,458,6.59149722735675,7.0,999,6.77877877877878
544,455,6.59742647058824,7.0,999,6.78078078078078
538,461,6.57434944237918,7.0,999,6.77077077077077
547,452,6.57221206581353,7.0,999,6.76576576576577
564,435,6.57269503546099,7.0,999,6.75875875875876
554,445,6.58483754512635,7.0,999,6.76976976976977
561,438,6.57932263814617,7.0,999,6.76376376376376
566,433,6.57950530035336,7.0,999,6.76176176176176
564,435,6.5709219858156,7.0,999,6.75775775775776
565,434,6.5646017699115,7.0,999,6.75375375375375
562,437,6.56049822064057,7.0,999,6.75275275275275
559,440,6.56887298747764,7.0,999,6.75875875875876
558,441,6.5752688172043,7.0,999,6.76276276276276
562,437,6.5711743772242,7.0,999,6.75875875875876
557,442,6.57630161579892,7.0,999,6.76376376376376
563,436,6.59502664298401,7.0,999,6.77177177177177
561,438,6.58288770053476,7.0,999,6.76576576576577
561,438,6.59536541889483,7.0,999,6.77277277277277
565,434,6.6,7.0,999,6.77377377377377
562,437,6.58185053380783,7.0,999,6.76476476476476
560,439,6.5875,7.0,999,6.76876876876877
563,436,6.58792184724689,7.0,999,6.76776776776777
569,430,6.59050966608084,7.0,999,6.76676676676677
551,448,6.58620689655172,7.0,999,6.77177177177177
556,443,6.58992805755396,7.0,999,6.77177177177177
554,445,6.58483754512635,7.0,999,6.76976976976977
559,440,6.57960644007156,7.0,999,6.76476476476476
573,426,6.57242582897033,7.0,999,6.75475475475475
572,427,6.57167832167832,7.0,999,6.75475475475475
578,421,6.57439446366782,7.0,999,6.75375375375375
567,432,6.57495590828924,7.0,999,6.75875875875876
569,430,6.5676625659051,7.0,999,6.75375375375375
573,426,6.57068062827225,7.0,999,6.75375375375375
578,421,6.57612456747405,7.0,999,6.75475475475475
577,422,6.57538994800693,7.0,999,6.75475475475475
576,423,6.57986111111111,7.0,999,6.75775775775776
583,416,6.59005145797599,7.0,999,6.76076076076076
580,419,6.59655172413793,7.0,999,6.76576576576577
583,416,6.60205831903945,7.0,999,6.76776776776777
575,424,6.60347826086957,7.0,999,6.77177177177177
575,424,6.60695652173913,7.0,999,6.77377377377377
566,433,6.60777385159011,7.0,999,6.77777777777778
560,439,6.60714285714286,7.0,999,6.77977977977978
561,438,6.62388591800357,7.0,999,6.78878878878879
555,444,6.62162162162162,7.0,999,6.78978978978979
547,452,6.62340036563071,7.0,999,6.79379379379379
541,458,6.61367837338262,7.0,999,6.79079079079079
542,457,6.60885608856089,7.0,999,6.78778778778779
544,455,6.61397058823529,7.0,999,6.78978978978979
538,461,6.59665427509294,7.0,999,6.78278278278278
541,458,6.59704251386322,7.0,999,6.78178178178178
543,456,6.61510128913444,7.0,999,6.79079079079079
543,456,6.62062615101289,7.0,999,6.79379379379379
531,468,6.61770244821092,7.0,999,6.7967967967968
532,467,6.62593984962406,7.0,999,6.8008008008008
535,464,6.62429906542056,7.0,999,6.7987987987988
542,457,6.61808118081181,7.0,999,6.79279279279279
538,461,6.62267657992565,7.0,999,6.7967967967968
534,465,6.63483146067416,7.0,999,6.8048048048048
536,463,6.6455223880597,7.0,999,6.80980980980981
541,458,6.64879852125693,7.0,999,6.80980980980981
532,467,6.65413533834586,7.0,999,6.81581581581582
529,470,6.65973534971645,7.0,999,6.81981981981982
528,471,6.65151515151515,7.0,999,6.81581581581582
519,480,6.65317919075145,7.0,999,6.81981981981982
514,485,6.65953307392996,7.0,999,6.82482482482482
517,482,6.66537717601547,7.0,999,6.82682682682683
515,484,6.66990291262136,7.0,999,6.82982982982983
515,484,6.66990291262136,7.0,999,6.82982982982983
504,495,6.66071428571429,7.0,999,6.82882882882883
500,499,6.65,7.0,999,6.82482482482482
516,483,6.66085271317829,7.0,999,6.82482482482482
513,486,6.65107212475634,7.0,999,6.82082082082082
506,493,6.6501976284585,7.0,999,6.82282282282282
502,497,6.64741035856574,7.0,999,6.82282282282282
501,498,6.65269461077844,7.0,999,6.82582582582583
517,482,6.64796905222437,7.0,999,6.81781781781782
514,485,6.66731517509728,7.0,999,6.82882882882883
509,490,6.66011787819253,7.0,999,6.82682682682683
508,491,6.64566929133858,7.0,999,6.81981981981982
505,494,6.65742574257426,7.0,999,6.82682682682683
515,484,6.67961165048544,7.0,999,6.83483483483483
508,491,6.68700787401575,7.0,999,6.84084084084084
517,482,6.68665377176016,7.0,999,6.83783783783784
525,474,6.69333333333333,7.0,999,6.83883883883884
531,468,6.68361581920904,7.0,999,6.83183183183183
536,463,6.6865671641791,7.0,999,6.83183183183183
533,466,6.69043151969981,7.0,999,6.83483483483483
535,464,6.68785046728972,7.0,999,6.83283283283283
527,472,6.68500948766603,7.0,999,6.83383383383383
536,463,6.66231343283582,7.0,999,6.81881881881882
543,456,6.66482504604052,7.0,999,6.81781781781782
558,441,6.65770609318996,7.0,999,6.80880880880881
537,462,6.65176908752328,7.0,999,6.81281281281281
549,450,6.66848816029144,7.0,999,6.81781781781782
553,446,6.6745027124774,7.0,999,6.81981981981982
557,442,6.66606822262118,7.0,999,6.81381381381381
559,440,6.68515205724508,7.0,999,6.82382382382382
569,430,6.69420035149385,7.0,999,6.82582582582583
558,441,6.68817204301075,7.0,999,6.82582582582583
548,451,6.69343065693431,7.0,999,6.83183183183183
545,454,6.70825688073394,7.0,999,6.84084084084084
552,447,6.69565217391304,7.0,999,6.83183183183183
548,451,6.68795620437956,7.0,999,6.82882882882883
545,454,6.67889908256881,7.0,999,6.82482482482482
548,451,6.68248175182482,7.0,999,6.82582582582583
544,455,6.68014705882353,7.0,999,6.82582582582583
554,445,6.68772563176895,7.0,999,6.82682682682683
565,434,6.69734513274336,7.0,999,6.82882882882883
559,440,6.69230769230769,7.0,999,6.82782782782783
554,445,6.70036101083033,7.0,999,6.83383383383383
556,443,6.69784172661871,7.0,999,6.83183183183183
552,447,6.68840579710145,7.0,999,6.82782782782783
546,453,6.68864468864469,7.0,999,6.82982982982983
552,447,6.68659420289855,7.0,999,6.82682682682683
546,453,6.69413919413919,7.0,999,6.83283283283283
545,454,6.68256880733945,7.0,999,6.82682682682683
543,456,6.69060773480663,7.0,999,6.83183183183183
537,462,6.70018621973929,7.0,999,6.83883883883884
539,460,6.69387755102041,7.0,999,6.83483483483483
541,458,6.70055452865065,7.0,999,6.83783783783784
545,454,6.71376146788991,7.0,999,6.84384384384384
551,448,6.70780399274047,7.0,999,6.83883883883884
544,455,6.71323529411765,7.0,999,6.84384384384384
537,462,6.70391061452514,7.0,999,6.84084084084084
542,457,6.7029520295203,7.0,999,6.83883883883884
535,464,6.69906542056075,7.0,999,6.83883883883884
533,466,6.69606003752345,7.0,999,6.83783783783784
539,460,6.70871985157699,7.0,999,6.84284284284284
524,475,6.72709923664122,7.0,999,6.85685685685686
528,471,6.71969696969697,7.0,999,6.85185185185185
541,458,6.72458410351202,7.0,999,6.85085085085085
536,463,6.72761194029851,7.0,999,6.85385385385385
545,454,6.73577981651376,7.0,999,6.85585585585586
549,450,6.73588342440801,7.0,999,6.85485485485485
543,456,6.75322283609576,7.0,999,6.86586586586587
545,454,6.74862385321101,7.0,999,6.86286286286286
543,456,6.73664825046041,7.0,999,6.85685685685686
537,462,6.72253258845438,7.0,999,6.85085085085085
536,463,6.72388059701493,7.0,999,6.85185185185185
528,471,6.71780303030303,7.0,999,6.85085085085085
524,475,6.71946564885496,7.0,999,6.85285285285285
524,475,6.73854961832061,7.0,999,6.86286286286286
520,479,6.72884615384615,7.0,999,6.85885885885886
513,486,6.73489278752437,7.0,999,6.86386386386386
509,490,6.72888015717092,7.0,999,6.86186186186186
513,486,6.73489278752437,7.0,999,6.86386386386386
516,483,6.72674418604651,7.0,999,6.85885885885886
516,483,6.72286821705426,7.0,999,6.85685685685686
517,482,6.71953578336557,7.0,999,6.85485485485485
524,475,6.71946564885496,7.0,999,6.85285285285285
530,469,6.72830188679245,7.0,999,6.85585585585586
525,474,6.72,7.0,999,6.85285285285285
536,463,6.72014925373134,7.0,999,6.84984984984985
536,463,6.72761194029851,7.0,999,6.85385385385385
535,464,6.7196261682243,7.0,999,6.84984984984985
531,468,6.72504708097928,7.0,999,6.85385385385385
523,476,6.7131931166348,7.0,999,6.84984984984985
533,466,6.70168855534709,7.0,999,6.84084084084084
527,472,6.6888045540797,7.0,999,6.83583583583584
516,483,6.69767441860465,7.0,999,6.84384384384384
522,477,6.69348659003831,7.0,999,6.83983983983984
534,465,6.71161048689139,7.0,999,6.84584584584585
532,467,6.71428571428571,7.0,999,6.84784784784785
547,452,6.70201096892139,7.0,999,6.83683683683684
540,459,6.7,7.0,999,6.83783783783784
533,466,6.70731707317073,7.0,999,6.84384384384384
531,468,6.70809792843691,7.0,999,6.84484484484484
534,465,6.71161048689139,7.0,999,6.84584584584585
533,466,6.71294559099437,7.0,999,6.84684684684685
518,481,6.70656370656371,7.0,999,6.84784784784785
527,472,6.70398481973435,7.0,999,6.84384384384384
520,479,6.69230769230769,7.0,999,6.83983983983984
521,478,6.68330134357006,7.0,999,6.83483483483483
528,471,6.68560606060606,7.0,999,6.83383383383383
531,468,6.69868173258004,7.0,999,6.83983983983984
535,464,6.71588785046729,7.0,999,6.84784784784785
543,456,6.71823204419889,7.0,999,6.84684684684685
533,466,6.70544090056285,7.0,999,6.84284284284284
526,473,6.69961977186312,7.0,999,6.84184184184184
530,469,6.69811320754717,7.0,999,6.83983983983984
535,464,6.69532710280374,7.0,999,6.83683683683684
535,464,6.70093457943925,7.0,999,6.83983983983984
537,462,6.70763500931099,7.0,999,6.84284284284284
529,470,6.69754253308129,7.0,999,6.83983983983984
535,464,6.69345794392523,7.0,999,6.83583583583584
531,468,6.70244821092279,7.0,999,6.84184184184184
539,460,6.70871985157699,7.0,999,6.84284284284284
536,463,6.71455223880597,7.0,999,6.84684684684685
533,466,6.72232645403377,7.0,999,6.85185185185185
520,479,6.71538461538462,7.0,999,6.85185185185185
523,476,6.717017208413,7.0,999,6.85185185185185
526,473,6.72053231939164,7.0,999,6.85285285285285
517,482,6.74081237911025,7.0,999,6.86586586586587
522,477,6.75287356321839,7.0,999,6.87087087087087
524,475,6.74236641221374,7.0,999,6.86486486486486
525,474,6.75238095238095,7.0,999,6.86986986986987
521,478,6.74280230326296,7.0,999,6.86586586586587
522,477,6.74137931034483,7.0,999,6.86486486486486
509,490,6.7426326129666,7.0,999,6.86886886886887
517,482,6.73694390715667,7.0,999,6.86386386386386
508,491,6.72637795275591,7.0,999,6.86086086086086
519,480,6.7514450867052,7.0,999,6.87087087087087
516,483,6.75193798449612,7.0,999,6.87187187187187
516,483,6.75193798449612,7.0,999,6.87187187187187
518,481,6.76061776061776,7.0,999,6.87587587587588
518,481,6.76640926640927,7.0,999,6.87887887887888
517,482,6.7504835589942,7.0,999,6.87087087087087
522,477,6.75670498084291,7.0,999,6.87287287287287
521,478,6.75047984644914,7.0,999,6.86986986986987
526,473,6.73384030418251,7.0,999,6.85985985985986
522,477,6.73371647509579,7.0,999,6.86086086086086
522,477,6.74137931034483,7.0,999,6.86486486486486
521,478,6.73896353166987,7.0,999,6.86386386386386
528,471,6.73295454545455,7.0,999,6.85885885885886
528,471,6.74621212121212,7.0,999,6.86586586586587
523,476,6.74569789674952,7.0,999,6.86686686686687
516,483,6.7577519379845,7.0,999,6.87487487487487
511,488,6.76516634050881,7.0,999,6.87987987987988
510,489,6.76078431372549,7.0,999,6.87787787787788
508,491,6.75590551181102,7.0,999,6.87587587587588
503,496,6.74950298210736,7.0,999,6.87387387387387
500,499,6.758,7.0,999,6.87887887887888
505,494,6.74653465346535,7.0,999,6.87187187187187
521,478,6.75623800383877,7.0,999,6.87287287287287
507,492,6.7534516765286,7.0,999,6.87487487487487
511,488,6.76320939334638,7.0,999,6.87887887887888
498,501,6.75903614457831,7.0,999,6.87987987987988
492,507,6.77235772357724,7.0,999,6.88788788788789
491,508,6.75763747454175,7.0,999,6.88088088088088
500,499,6.75,7.0,999,6.87487487487487
494,505,6.75506072874494,7.0,999,6.87887887887888
495,504,6.74747474747475,7.0,999,6.87487487487487
497,502,6.75251509054326,7.0,999,6.87687687687688
502,497,6.74701195219123,7.0,999,6.87287287287287
512,487,6.75,7.0,999,6.87187187187187
503,496,6.76143141153081,7.0,999,6.87987987987988
503,496,6.75149105367793,7.0,999,6.87487487487487
500,499,6.754,7.0,999,6.87687687687688
507,492,6.7534516765286,7.0,999,6.87487487487487
513,486,6.76413255360624,7.0,999,6.87887887887888
516,483,6.7577519379845,7.0,999,6.87487487487487
510,489,6.76666666666667,7.0,999,6.88088088088088
507,492,6.75936883629191,7.0,999,6.87787787787788
512,487,6.759765625,7.0,999,6.87687687687688
510,489,6.74901960784314,7.0,999,6.87187187187187
518,481,6.75096525096525,7.0,999,6.87087087087087
526,473,6.76235741444867,7.0,999,6.87487487487487
526,473,6.74904942965779,7.0,999,6.86786786786787
540,459,6.74814814814815,7.0,999,6.86386386386386
548,451,6.73905109489051,7.0,999,6.85685685685686
556,443,6.73561151079137,7.0,999,6.85285285285285
551,448,6.73865698729583,7.0,999,6.85585585585586
549,450,6.73770491803279,7.0,999,6.85585585585586
563,436,6.74067495559503,7.0,999,6.85385385385385
562,437,6.73131672597865,7.0,999,6.84884884884885
565,434,6.72743362831858,7.0,999,6.84584584584585
574,425,6.71951219512195,7.0,999,6.83883883883884
571,428,6.72504378283713,7.0,999,6.84284284284284
572,427,6.72727272727273,7.0,999,6.84384384384384
582,417,6.71993127147766,7.0,999,6.83683683683684
586,413,6.72525597269625,7.0,999,6.83883883883884
579,420,6.72020725388601,7.0,999,6.83783783783784
594,405,6.72558922558923,7.0,999,6.83683683683684
604,395,6.7135761589404,7.0,999,6.82682682682683
596,403,6.70973154362416,7.0,999,6.82682682682683
587,412,6.72231686541738,7.0,999,6.83683683683684
591,408,6.72927241962775,7.0,999,6.83983983983984
594,405,6.73737373737374,7.0,999,6.84384384384384
598,401,6.73745819397993,7.0,999,6.84284284284284
597,402,6.74539363484087,7.0,999,6.84784784784785
600,399,6.73333333333333,7.0,999,6.83983983983984
602,397,6.72425249169435,7.0,999,6.83383383383383
610,389,6.72950819672131,7.0,999,6.83483483483483
612,387,6.73039215686275,7.0,999,6.83483483483483
620,379,6.73225806451613,7.0,999,6.83383383383383
623,376,6.73675762439807,7.0,999,6.83583583583584
630,369,6.72539682539683,7.0,999,6.82682682682683
623,376,6.71589085072231,7.0,999,6.82282282282282
621,378,6.71497584541063,7.0,999,6.82282282282282
626,373,6.72044728434505,7.0,999,6.82482482482482
635,364,6.71338582677165,7.0,999,6.81781781781782
633,366,6.70774091627172,7.0,999,6.81481481481481
624,375,6.71955128205128,7.0,999,6.82482482482482
620,379,6.7241935483871,7.0,999,6.82882882882883
630,369,6.72539682539683,7.0,999,6.82682682682683
637,362,6.72370486656201,7.0,999,6.82382382382382
628,371,6.72611464968153,7.0,999,6.82782782782783
637,362,6.72998430141287,7.0,999,6.82782782782783
622,377,6.72829581993569,7.0,999,6.83083083083083
612,387,6.72385620915033,7.0,999,6.83083083083083
625,374,6.72,7.0,999,6.82482482482482
628,371,6.72133757961783,7.0,999,6.82482482482482
632,367,6.71993670886076,7.0,999,6.82282282282282
622,377,6.72347266881029,7.0,999,6.82782782782783
626,373,6.72204472843451,7.0,999,6.82582582582583
625,374,6.7136,7.0,999,6.82082082082082
612,387,6.72385620915033,7.0,999,6.83083083083083
606,393,6.72607260726073,7.0,999,6.83383383383383
602,397,6.72093023255814,7.0,999,6.83183183183183
601,398,6.72545757071547,7.0,999,6.83483483483483
597,402,6.7319932998325,7.0,999,6.83983983983984
598,401,6.74247491638796,7.0,999,6.84584584584585
586,413,6.7542662116041,7.0,999,6.85585585585586
571,428,6.76532399299475,7.0,999,6.86586586586587
568,431,6.7693661971831,7.0,999,6.86886886886887
573,426,6.760907504363,7.0,999,6.86286286286286
576,423,6.76215277777778,7.0,999,6.86286286286286
574,425,6.76655052264808,7.0,999,6.86586586586587
574,425,6.78745644599303,7.0,999,6.87787787787788
567,432,6.78483245149912,7.0,999,6.87787787787788
565,434,6.79823008849558,7.0,999,6.88588588588589
552,447,6.79528985507246,7.0,999,6.88688688688689
549,450,6.79417122040073,7.0,999,6.88688688688689
549,450,6.80327868852459,7.0,999,6.89189189189189
558,441,6.81541218637993,7.0,999,6.8968968968969
559,440,6.81037567084079,7.0,999,6.89389389389389
545,454,6.81651376146789,7.0,999,6.8998998998999
544,455,6.82904411764706,7.0,999,6.90690690690691
551,448,6.83121597096189,7.0,999,6.90690690690691
552,447,6.82246376811594,7.0,999,6.9019019019019
543,456,6.81767955801105,7.0,999,6.9009009009009
530,469,6.8188679245283,7.0,999,6.9039039039039
529,470,6.83931947069943,7.0,999,6.91491491491491
531,468,6.84934086629002,7.0,999,6.91991991991992
525,474,6.84761904761905,7.0,999,6.91991991991992
536,463,6.85074626865672,7.0,999,6.91991991991992
543,456,6.84898710865562,7.0,999,6.91791791791792
549,450,6.8488160291439,7.0,999,6.91691691691692
550,449,6.85454545454545,7.0,999,6.91991991991992
546,453,6.84981684981685,7.0,999,6.91791791791792
540,459,6.84814814814815,7.0,999,6.91791791791792
545,454,6.84770642201835,7.0,999,6.91691691691692
546,453,6.84798534798535,7.0,999,6.91691691691692
545,454,6.84770642201835,7.0,999,6.91691691691692
542,457,6.8450184501845,7.0,999,6.91591591591592
542,457,6.84132841328413,7.0,999,6.91391391391391
550,449,6.83636363636364,7.0,999,6.90990990990991
561,438,6.83600713012478,7.0,999,6.90790790790791
556,443,6.83812949640288,7.0,999,6.90990990990991
552,447,6.83514492753623,7.0,999,6.90890890890891
548,451,6.83211678832117,7.0,999,6.90790790790791
546,453,6.82967032967033,7.0,999,6.90690690690691
554,445,6.83212996389892,7.0,999,6.90690690690691
555,444,6.82522522522522,7.0,999,6.9029029029029
550,449,6.82545454545455,7.0,999,6.9039039039039
555,444,6.82882882882883,7.0,999,6.9049049049049
559,440,6.83184257602862,7.0,999,6.90590590590591
554,445,6.82310469314079,7.0,999,6.9019019019019
546,453,6.81501831501831,7.0,999,6.8988988988989
540,459,6.80555555555556,7.0,999,6.89489489489489
532,467,6.80451127819549,7.0,999,6.8958958958959
527,472,6.80075901328273,7.0,999,6.89489489489489
524,475,6.79961832061069,7.0,999,6.89489489489489
529,470,6.80151228733459,7.0,999,6.89489489489489
533,466,6.79549718574109,7.0,999,6.89089089089089
532,467,6.79135338345865,7.0,999,6.88888888888889
533,466,6.77673545966229,7.0,999,6.88088088088088
531,468,6.77777777777778,7.0,999,6.88188188188188
535,464,6.76822429906542,7.0,999,6.87587587587588
540,459,6.77592592592593,7.0,999,6.87887887887888
536,463,6.78171641791045,7.0,999,6.88288288288288
548,451,6.78467153284672,7.0,999,6.88188188188188
547,452,6.79159049360146,7.0,999,6.88588588588589
551,448,6.78947368421053,7.0,999,6.88388388388388
552,447,6.79528985507246,7.0,999,6.88688688688689
552,447,6.80434782608696,7.0,999,6.89189189189189
563,436,6.80106571936057,7.0,999,6.88788788788789
561,438,6.80926916221034,7.0,999,6.89289289289289
562,437,6.80604982206406,7.0,999,6.89089089089089
563,436,6.80639431616341,7.0,999,6.89089089089089
579,420,6.80483592400691,7.0,999,6.88688688688689
572,427,6.80594405594406,7.0,999,6.88888888888889
571,428,6.80210157618214,7.0,999,6.88688688688689
560,439,6.81607142857143,7.0,999,6.8968968968969
569,430,6.81019332161687,7.0,999,6.89189189189189
576,423,6.80555555555556,7.0,999,6.88788788788789
582,417,6.81099656357388,7.0,999,6.88988988988989
586,413,6.80204778156997,7.0,999,6.88388388388388
585,414,6.8,7.0,999,6.88288288288288
588,411,6.80272108843537,7.0,999,6.88388388388388
581,418,6.80206540447504,7.0,999,6.88488488488488
594,405,6.7996632996633,7.0,999,6.88088088088088
603,396,6.82255389718076,7.0,999,6.89289289289289
604,395,6.81788079470199,7.0,999,6.88988988988989
606,393,6.81683168316832,7.0,999,6.88888888888889
606,393,6.81023102310231,7.0,999,6.88488488488488
612,387,6.82516339869281,7.0,999,6.89289289289289
618,381,6.81715210355987,7.0,999,6.88688688688689
613,386,6.82544861337684,7.0,999,6.89289289289289
609,390,6.83908045977012,7.0,999,6.9019019019019
606,393,6.83333333333333,7.0,999,6.8988988988989
603,396,6.82752902155887,7.0,999,6.8958958958959
604,395,6.81456953642384,7.0,999,6.88788788788789
613,386,6.82055464926591,7.0,999,6.88988988988989
611,388,6.81342062193126,7.0,999,6.88588588588589
622,377,6.81028938906752,7.0,999,6.88188188188188
627,372,6.81020733652313,7.0,999,6.88088088088088
629,370,6.79491255961844,7.0,999,6.87087087087087
616,383,6.79383116883117,7.0,999,6.87287287287287
615,384,6.7869918699187,7.0,999,6.86886886886887
621,378,6.78582930756844,7.0,999,6.86686686686687
621,378,6.7938808373591,7.0,999,6.87187187187187
613,386,6.78466557911909,7.0,999,6.86786786786787
622,377,6.78456591639871,7.0,999,6.86586586586587
620,379,6.77741935483871,7.0,999,6.86186186186186
607,392,6.7660626029654,7.0,999,6.85785785785786
611,388,6.75941080196399,7.0,999,6.85285285285285
610,389,6.74918032786885,7.0,999,6.84684684684685
602,397,6.75747508305648,7.0,999,6.85385385385385
605,394,6.7603305785124,7.0,999,6.85485485485485
606,393,6.76237623762376,7.0,999,6.85585585585586
607,392,6.75782537067545,7.0,999,6.85285285285285
615,384,6.74959349593496,7.0,999,6.84584584584585
618,381,6.76375404530744,7.0,999,6.85385385385385
621,378,6.76006441223833,7.0,999,6.85085085085085
621,378,6.76489533011272,7.0,999,6.85385385385385
629,370,6.7631160572337,7.0,999,6.85085085085085
636,363,6.74842767295597,7.0,999,6.83983983983984
649,350,6.75038520801233,7.0,999,6.83783783783784
652,347,6.74539877300614,7.0,999,6.83383383383383
653,346,6.7427258805513,7.0,999,6.83183183183183
645,354,6.73178294573643,7.0,999,6.82682682682683
646,353,6.73684210526316,7.0,999,6.82982982982983
658,341,6.73252279635258,7.0,999,6.82382382382382
653,346,6.72894333843798,7.0,999,6.82282282282282
651,348,6.72964669738863,7.0,999,6.82382382382382
659,340,6.72078907435508,7.0,999,6.81581581581582
656,343,6.72103658536585,7.0,999,6.81681681681682
666,333,6.72072072072072,7.0,999,6.81381381381381
667,332,6.72413793103448,7.0,999,6.81581581581582
662,337,6.71601208459214,7.0,999,6.81181181181181
660,339,6.70909090909091,7.0,999,6.80780780780781
679,320,6.71281296023564,7.0,999,6.8048048048048
671,328,6.70193740685544,7.0,999,6.7997997997998
663,336,6.70739064856712,7.0,999,6.80580580580581
658,341,6.7112462006079,7.0,999,6.80980980980981
666,333,6.71171171171171,7.0,999,6.80780780780781
670,329,6.71492537313433,7.0,999,6.80880880880881
671,328,6.70640834575261,7.0,999,6.8028028028028
680,319,6.70735294117647,7.0,999,6.8008008008008
677,322,6.70901033973412,7.0,999,6.8028028028028
675,324,6.70814814814815,7.0,999,6.8028028028028
665,334,6.70225563909774,7.0,999,6.8018018018018
646,353,6.70588235294118,7.0,999,6.80980980980981
653,346,6.70750382848392,7.0,999,6.80880880880881
665,334,6.71127819548872,7.0,999,6.80780780780781
662,337,6.71601208459214,7.0,999,6.81181181181181
653,346,6.7197549770291,7.0,999,6.81681681681682
657,342,6.71993911719939,7.0,999,6.81581581581582
653,346,6.71822358346095,7.0,999,6.81581581581582
649,350,6.71032357473035,7.0,999,6.81181181181181
651,348,6.71582181259601,7.0,999,6.81481481481481
645,354,6.71317829457364,7.0,999,6.81481481481481
638,361,6.71316614420063,7.0,999,6.81681681681682
650,349,6.72,7.0,999,6.81781781781782
651,348,6.70814132104455,7.0,999,6.80980980980981
650,349,6.71076923076923,7.0,999,6.81181181181181
649,350,6.70261941448382,7.0,999,6.80680680680681
635,364,6.71496062992126,7.0,999,6.81881881881882
636,363,6.72012578616352,7.0,999,6.82182182182182
642,357,6.72429906542056,7.0,999,6.82282282282282
633,366,6.73775671406003,7.0,999,6.83383383383383
632,367,6.71993670886076,7.0,999,6.82282282282282
633,366,6.73143759873618,7.0,999,6.82982982982983
637,362,6.73469387755102,7.0,999,6.83083083083083
634,365,6.74605678233439,7.0,999,6.83883883883884
625,374,6.7504,7.0,999,6.84384384384384
617,382,6.76012965964344,7.0,999,6.85185185185185
625,374,6.7584,7.0,999,6.84884884884885
624,375,6.77083333333333,7.0,999,6.85685685685686
614,385,6.78013029315961,7.0,999,6.86486486486486
623,376,6.78170144462279,7.0,999,6.86386386386386
621,378,6.78743961352657,7.0,999,6.86786786786787
630,369,6.78253968253968,7.0,999,6.86286286286286
633,366,6.78041074249605,7.0,999,6.86086086086086
632,367,6.78639240506329,7.0,999,6.86486486486486
624,375,6.78525641025641,7.0,999,6.86586586586587
618,381,6.79773462783171,7.0,999,6.87487487487487
617,382,6.80551053484603,7.0,999,6.87987987987988
620,379,6.81129032258065,7.0,999,6.88288288288288
617,382,6.81685575364668,7.0,999,6.88688688688689
624,375,6.80608974358974,7.0,999,6.87887887887888
638,361,6.79623824451411,7.0,999,6.86986986986987
639,360,6.78716744913928,7.0,999,6.86386386386386
630,369,6.78730158730159,7.0,999,6.86586586586587
622,377,6.78617363344051,7.0,999,6.86686686686687
631,368,6.7797147385103,7.0,999,6.86086086086086
633,366,6.78672985781991,7.0,999,6.86486486486486
636,363,6.7814465408805,7.0,999,6.86086086086086
640,359,6.7828125,7.0,999,6.86086086086086
641,358,6.77223088923557,7.0,999,6.85385385385385
644,355,6.77484472049689,7.0,999,6.85485485485485
649,350,6.7673343605547,7.0,999,6.84884884884885
645,354,6.75968992248062,7.0,999,6.84484484484484
641,358,6.76443057722309,7.0,999,6.84884884884885
650,349,6.75846153846154,7.0,999,6.84284284284284
654,345,6.77217125382263,7.0,999,6.85085085085085
640,359,6.7765625,7.0,999,6.85685685685686
650,349,6.78153846153846,7.0,999,6.85785785785786
649,350,6.79198767334361,7.0,999,6.86486486486486
632,367,6.78639240506329,7.0,999,6.86486486486486
623,376,6.79293739967897,7.0,999,6.87087087087087
618,381,6.79288025889968,7.0,999,6.87187187187187
630,369,6.78253968253968,7.0,999,6.86286286286286
634,365,6.78391167192429,7.0,999,6.86286286286286
631,368,6.78129952456418,7.0,999,6.86186186186186
623,376,6.7784911717496,7.0,999,6.86186186186186
626,373,6.76996805111821,7.0,999,6.85585585585586
628,371,6.77866242038217,7.0,999,6.86086086086086
628,371,6.78025477707006,7.0,999,6.86186186186186
635,364,6.79212598425197,7.0,999,6.86786786786787
638,361,6.78996865203762,7.0,999,6.86586586586587
651,348,6.78494623655914,7.0,999,6.85985985985986
647,352,6.78516228748068,7.0,999,6.86086086086086
650,349,6.76923076923077,7.0,999,6.84984984984985
656,343,6.77439024390244,7.0,999,6.85185185185185
656,343,6.77134146341463,7.0,999,6.84984984984985
665,334,6.77293233082707,7.0,999,6.84884884884885
657,342,6.76103500761035,7.0,999,6.84284284284284
662,337,6.7583081570997,7.0,999,6.83983983983984
651,348,6.76497695852535,7.0,999,6.84684684684685
642,357,6.75856697819315,7.0,999,6.84484484484484
650,349,6.74,7.0,999,6.83083083083083
645,354,6.72868217054264,7.0,999,6.82482482482482
654,345,6.73700305810398,7.0,999,6.82782782782783
643,356,6.7402799377916,7.0,999,6.83283283283283
640,359,6.7390625,7.0,999,6.83283283283283
629,370,6.73608903020668,7.0,999,6.83383383383383
619,380,6.73021001615509,7.0,999,6.83283283283283
630,369,6.72380952380952,7.0,999,6.82582582582583
633,366,6.73143759873618,7.0,999,6.82982982982983
633,366,6.73301737756714,7.0,999,6.83083083083083
617,382,6.72933549432739,7.0,999,6.83283283283283
626,373,6.73162939297125,7.0,999,6.83183183183183
624,375,6.72115384615385,7.0,999,6.82582582582583
620,379,6.71612903225806,7.0,999,6.82382382382382
631,368,6.71156893819334,7.0,999,6.81781781781782
620,379,6.70967741935484,7.0,999,6.81981981981982
625,374,6.7344,7.0,999,6.83383383383383
625,374,6.7328,7.0,999,6.83283283283283
638,361,6.73354231974922,7.0,999,6.82982982982983
638,361,6.73354231974922,7.0,999,6.82982982982983
636,363,6.74213836477987,7.0,999,6.83583583583584
645,354,6.73643410852713,7.0,999,6.82982982982983
634,365,6.73028391167192,7.0,999,6.82882882882883
634,365,6.73343848580442,7.0,999,6.83083083083083
629,370,6.7329093799682,7.0,999,6.83183183183183
638,361,6.73824451410658,7.0,999,6.83283283283283
640,359,6.728125,7.0,999,6.82582582582583
644,355,6.72360248447205,7.0,999,6.82182182182182
639,360,6.7339593114241,7.0,999,6.82982982982983
629,370,6.74085850556439,7.0,999,6.83683683683684
628,371,6.74044585987261,7.0,999,6.83683683683684
623,376,6.74959871589085,7.0,999,6.84384384384384
623,376,6.75601926163724,7.0,999,6.84784784784785
624,375,6.75320512820513,7.0,999,6.84584584584585
624,375,6.75320512820513,7.0,999,6.84584584584585
618,381,6.7588996763754,7.0,999,6.85085085085085
606,393,6.75412541254125,7.0,999,6.85085085085085
617,382,6.75850891410049,7.0,999,6.85085085085085
610,389,6.75081967213115,7.0,999,6.84784784784785
613,386,6.75203915171289,7.0,999,6.84784784784785
613,386,6.76182707993475,7.0,999,6.85385385385385
615,384,6.76585365853659,7.0,999,6.85585585585586
615,384,6.75609756097561,7.0,999,6.84984984984985
615,384,6.75609756097561,7.0,999,6.84984984984985
604,395,6.77152317880795,7.0,999,6.86186186186186
596,403,6.77013422818792,7.0,999,6.86286286286286
602,397,6.77076411960133,7.0,999,6.86186186186186
603,396,6.77446102819237,7.0,999,6.86386386386386
595,404,6.78991596638655,7.0,999,6.87487487487487
587,412,6.77683134582623,7.0,999,6.86886886886887
599,400,6.77462437395659,7.0,999,6.86486486486486
598,401,6.77591973244147,7.0,999,6.86586586586587
589,410,6.78947368421053,7.0,999,6.87587587587588
581,418,6.78313253012048,7.0,999,6.87387387387387
583,416,6.79931389365352,7.0,999,6.88288288288288
578,421,6.79584775086505,7.0,999,6.88188188188188
576,423,6.80381944444444,7.0,999,6.88688688688689
580,419,6.8,7.0,999,6.88388388388388
583,416,6.80102915951973,7.0,999,6.88388388388388
582,417,6.79381443298969,7.0,999,6.87987987987988
582,417,6.79553264604811,7.0,999,6.88088088088088
579,420,6.80310880829016,7.0,999,6.88588588588589
578,421,6.80276816608997,7.0,999,6.88588588588589
577,422,6.79549393414211,7.0,999,6.88188188188188
584,415,6.79109589041096,7.0,999,6.87787787787788
584,415,6.79109589041096,7.0,999,6.87787787787788
582,417,6.79037800687285,7.0,999,6.87787787787788
586,413,6.7901023890785,7.0,999,6.87687687687688
587,412,6.78364565587734,7.0,999,6.87287287287287
590,409,6.79661016949153,7.0,999,6.87987987987988
574,425,6.80313588850174,7.0,999,6.88688688688689
577,422,6.78856152512998,7.0,999,6.87787787787788
571,428,6.77758318739054,7.0,999,6.87287287287287
571,428,6.77758318739054,7.0,999,6.87287287287287
567,432,6.78306878306878,7.0,999,6.87687687687688
572,427,6.76573426573427,7.0,999,6.86586586586587
575,424,6.76,7.0,999,6.86186186186186
575,424,6.7704347826087,7.0,999,6.86786786786787
582,417,6.77319587628866,7.0,999,6.86786786786787
575,424,6.7704347826087,7.0,999,6.86786786786787
568,431,6.77992957746479,7.0,999,6.87487487487487
576,423,6.77777777777778,7.0,999,6.87187187187187
586,413,6.77815699658703,7.0,999,6.86986986986987
586,413,6.77986348122867,7.0,999,6.87087087087087
584,415,6.78938356164384,7.0,999,6.87687687687688
587,412,6.77342419080068,7.0,999,6.86686686686687
581,418,6.78313253012048,7.0,999,6.87387387387387
587,412,6.79045996592845,7.0,999,6.87687687687688
584,415,6.78767123287671,7.0,999,6.87587587587588
583,416,6.78559176672384,7.0,999,6.87487487487487
587,412,6.79045996592845,7.0,999,6.87687687687688
589,410,6.78777589134126,7.0,999,6.87487487487487
591,408,6.78510998307953,7.0,999,6.87287287287287
586,413,6.77474402730375,7.0,999,6.86786786786787
580,419,6.77413793103448,7.0,999,6.86886886886887
585,414,6.78119658119658,7.0,999,6.87187187187187
572,427,6.78671328671329,7.0,999,6.87787787787788
580,419,6.77931034482759,7.0,999,6.87187187187187
583,416,6.78044596912521,7.0,999,6.87187187187187
580,419,6.79137931034483,7.0,999,6.87887887887888
578,421,6.7923875432526,7.0,999,6.87987987987988
578,421,6.79065743944637,7.0,999,6.87887887887888
580,419,6.79137931034483,7.0,999,6.87887887887888
576,423,6.78645833333333,7.0,999,6.87687687687688
575,424,6.78782608695652,7.0,999,6.87787787787788
575,424,6.78782608695652,7.0,999,6.87787787787788
573,426,6.78359511343805,7.0,999,6.87587587587588
565,434,6.78938053097345,7.0,999,6.88088088088088
571,428,6.784588441331,7.0,999,6.87687687687688
570,429,6.7859649122807,7.0,999,6.87787787787788
574,425,6.78745644599303,7.0,999,6.87787787787788
579,420,6.79965457685665,7.0,999,6.88388388388388
582,417,6.81099656357388,7.0,999,6.88988988988989
583,416,6.80445969125214,7.0,999,6.88588588588589
575,424,6.8,7.0,999,6.88488488488488
573,426,6.80628272251309,7.0,999,6.88888888888889
575,424,6.79826086956522,7.0,999,6.88388388388388
586,413,6.79692832764505,7.0,999,6.88088088088088
580,419,6.78793103448276,7.0,999,6.87687687687688
583,416,6.80102915951973,7.0,999,6.88388388388388
588,411,6.79931972789116,7.0,999,6.88188188188188
591,408,6.80033840947547,7.0,999,6.88188188188188
584,415,6.78767123287671,7.0,999,6.87587587587588
589,410,6.78777589134126,7.0,999,6.87487487487487
597,402,6.79061976549414,7.0,999,6.87487487487487
589,410,6.77928692699491,7.0,999,6.86986986986987
600,399,6.78666666666667,7.0,999,6.87187187187187
603,396,6.77114427860697,7.0,999,6.86186186186186
607,392,6.77924217462932,7.0,999,6.86586586586587
599,400,6.77462437395659,7.0,999,6.86486486486486
599,400,6.78130217028381,7.0,999,6.86886886886887
605,394,6.7702479338843,7.0,999,6.86086086086086
609,390,6.77504105090312,7.0,999,6.86286286286286
615,384,6.77235772357724,7.0,999,6.85985985985986
624,375,6.76762820512821,7.0,999,6.85485485485485
625,374,6.7696,7.0,999,6.85585585585586
616,383,6.75162337662338,7.0,999,6.84684684684685
613,386,6.74714518760196,7.0,999,6.84484484484484
607,392,6.74464579901153,7.0,999,6.84484484484484
612,387,6.7516339869281,7.0,999,6.84784784784785
607,392,6.73970345963756,7.0,999,6.84184184184184
609,390,6.73563218390805,7.0,999,6.83883883883884
598,401,6.73913043478261,7.0,999,6.84384384384384
599,400,6.73622704507513,7.0,999,6.84184184184184
610,389,6.73114754098361,7.0,999,6.83583583583584
604,395,6.72516556291391,7.0,999,6.83383383383383
615,384,6.73658536585366,7.0,999,6.83783783783784
613,386,6.71451876019576,7.0,999,6.82482482482482
629,370,6.71224165341812,7.0,999,6.81881881881882
628,371,6.70700636942675,7.0,999,6.81581581581582
626,373,6.69648562300319,7.0,999,6.80980980980981
625,374,6.7008,7.0,999,6.81281281281281
618,381,6.70064724919094,7.0,999,6.81481481481481
621,378,6.7037037037037,7.0,999,6.81581581581582
618,381,6.70388349514563,7.0,999,6.81681681681682
616,383,6.7012987012987,7.0,999,6.81581581581582
619,380,6.70597738287561,7.0,999,6.81781781781782
619,380,6.7092084006462,7.0,999,6.81981981981982
613,386,6.70799347471452,7.0,999,6.82082082082082
610,389,6.70327868852459,7.0,999,6.81881881881882
613,386,6.70146818923328,7.0,999,6.81681681681682
614,385,6.69381107491857,7.0,999,6.81181181181181
614,385,6.68403908794788,7.0,999,6.80580580580581
606,393,6.68811881188119,7.0,999,6.81081081081081
601,398,6.67886855241265,7.0,999,6.80680680680681
595,404,6.67899159663866,7.0,999,6.80880880880881
596,403,6.68456375838926,7.0,999,6.81181181181181
593,406,6.67959527824621,7.0,999,6.80980980980981
587,412,6.66780238500852,7.0,999,6.8048048048048
590,409,6.66949152542373,7.0,999,6.8048048048048
596,403,6.67114093959732,7.0,999,6.8038038038038
597,402,6.6750418760469,7.0,999,6.80580580580581
599,400,6.67946577629382,7.0,999,6.80780780780781
599,400,6.67278797996661,7.0,999,6.8038038038038
606,393,6.66996699669967,7.0,999,6.7997997997998
617,382,6.6742301458671,7.0,999,6.7987987987988
619,380,6.66397415185784,7.0,999,6.79179179179179
634,365,6.65299684542587,7.0,999,6.77977977977978
627,372,6.64912280701754,7.0,999,6.77977977977978
630,369,6.66825396825397,7.0,999,6.79079079079079
644,355,6.6583850931677,7.0,999,6.77977977977978
646,353,6.65015479876161,7.0,999,6.77377377377377
641,358,6.65366614664587,7.0,999,6.77777777777778
652,347,6.64723926380368,7.0,999,6.76976976976977
656,343,6.65396341463415,7.0,999,6.77277277277277
656,343,6.67073170731707,7.0,999,6.78378378378378
656,343,6.66615853658537,7.0,999,6.78078078078078
648,351,6.66203703703704,7.0,999,6.78078078078078
642,357,6.64330218068536,7.0,999,6.77077077077077
640,359,6.6421875,7.0,999,6.77077077077077
655,344,6.6412213740458,7.0,999,6.76476476476476
657,342,6.63165905631659,7.0,999,6.75775775775776
661,338,6.6338880484115,7.0,999,6.75775775775776
659,340,6.63732928679818,7.0,999,6.76076076076076
661,338,6.63691376701967,7.0,999,6.75975975975976
666,333,6.64114114114114,7.0,999,6.76076076076076
668,331,6.6497005988024,7.0,999,6.76576576576577
671,328,6.65573770491803,7.0,999,6.76876876876877
668,331,6.66467065868263,7.0,999,6.77577577577578
659,340,6.66919575113809,7.0,999,6.78178178178178
652,347,6.66257668711656,7.0,999,6.77977977977978
651,348,6.64976958525346,7.0,999,6.77177177177177
644,355,6.63664596273292,7.0,999,6.76576576576577
643,356,6.64541213063764,7.0,999,6.77177177177177
643,356,6.64852255054432,7.0,999,6.77377377377377
651,348,6.64823348694316,7.0,999,6.77077077077077
656,343,6.65853658536585,7.0,999,6.77577577577578
647,352,6.65996908809892,7.0,999,6.77977977977978
650,349,6.66,7.0,999,6.77877877877878
649,350,6.66563944530046,7.0,999,6.78278278278278
649,350,6.65793528505393,7.0,999,6.77777777777778
649,350,6.67796610169492,7.0,999,6.79079079079079
649,350,6.68104776579353,7.0,999,6.79279279279279
654,345,6.68348623853211,7.0,999,6.79279279279279
652,347,6.67177914110429,7.0,999,6.78578578578579
657,342,6.67884322678843,7.0,999,6.78878878878879
664,335,6.68825301204819,7.0,999,6.79279279279279
666,333,6.69069069069069,7.0,999,6.79379379379379
667,332,6.68965517241379,7.0,999,6.79279279279279
661,338,6.69591527987897,7.0,999,6.7987987987988
657,342,6.69406392694064,7.0,999,6.7987987987988
655,344,6.69160305343511,7.0,999,6.7977977977978
658,341,6.709726443769,7.0,999,6.80880880880881
666,333,6.7027027027027,7.0,999,6.8018018018018
660,339,6.7,7.0,999,6.8018018018018
669,330,6.69955156950673,7.0,999,6.7987987987988
662,337,6.70543806646526,7.0,999,6.8048048048048
670,329,6.70298507462687,7.0,999,6.8008008008008
654,345,6.70642201834862,7.0,999,6.80780780780781
663,336,6.69984917043741,7.0,999,6.8008008008008
667,332,6.68965517241379,7.0,999,6.79279279279279
681,318,6.68722466960352,7.0,999,6.78678678678679
683,316,6.69399707174231,7.0,999,6.79079079079079
685,314,6.71094890510949,7.0,999,6.8018018018018
682,317,6.69941348973607,7.0,999,6.79479479479479
679,320,6.70692194403535,7.0,999,6.8008008008008
687,312,6.70305676855895,7.0,999,6.7957957957958
687,312,6.70305676855895,7.0,999,6.7957957957958
692,307,6.70086705202312,7.0,999,6.79279279279279
683,316,6.7086383601757,7.0,999,6.8008008008008
688,311,6.71656976744186,7.0,999,6.8048048048048
686,313,6.71137026239067,7.0,999,6.8018018018018
680,319,6.71323529411765,7.0,999,6.8048048048048
674,325,6.72255192878338,7.0,999,6.81281281281281
675,324,6.71851851851852,7.0,999,6.80980980980981
675,324,6.72,7.0,999,6.81081081081081
675,324,6.72444444444444,7.0,999,6.81381381381381
677,322,6.7341211225997,7.0,999,6.81981981981982
668,331,6.73502994011976,7.0,999,6.82282282282282
672,327,6.74255952380952,7.0,999,6.82682682682683
670,329,6.75074626865672,7.0,999,6.83283283283283
665,334,6.75187969924812,7.0,999,6.83483483483483
664,335,6.74096385542169,7.0,999,6.82782782782783
677,322,6.75775480059084,7.0,999,6.83583583583584
681,318,6.7503671071953,7.0,999,6.82982982982983
694,305,6.75936599423631,7.0,999,6.83283283283283
693,306,6.76767676767677,7.0,999,6.83883883883884
693,306,6.77633477633478,7.0,999,6.84484484484484
704,295,6.78409090909091,7.0,999,6.84784784784785
701,298,6.79457917261056,7.0,999,6.85585585585586
697,302,6.80487804878049,7.0,999,6.86386386386386
705,294,6.81276595744681,7.0,999,6.86786786786787
695,304,6.80863309352518,7.0,999,6.86686686686687
699,300,6.82260371959943,7.0,999,6.87587587587588
696,303,6.82614942528736,7.0,999,6.87887887887888
701,298,6.82453637660485,7.0,999,6.87687687687688
702,297,6.83048433048433,7.0,999,6.88088088088088
699,300,6.83547925608011,7.0,999,6.88488488488488
709,290,6.82369534555712,7.0,999,6.87487487487487
703,296,6.83926031294452,7.0,999,6.88688688688689
705,294,6.83687943262411,7.0,999,6.88488488488488
709,290,6.83638928067701,7.0,999,6.88388388388388
713,286,6.84011220196353,7.0,999,6.88588588588589
717,282,6.84518828451883,7.0,999,6.88888888888889
724,275,6.84944751381216,7.0,999,6.89089089089089
729,270,6.84499314128944,7.0,999,6.88688688688689
733,266,6.84993178717599,7.0,999,6.88988988988989
724,275,6.84254143646409,7.0,999,6.88588588588589
723,276,6.85200553250346,7.0,999,6.89289289289289
728,271,6.85164835164835,7.0,999,6.89189189189189
727,272,6.85144429160935,7.0,999,6.89189189189189
735,264,6.84625850340136,7.0,999,6.88688688688689
731,268,6.84131326949384,7.0,999,6.88388388388388
733,266,6.83901773533424,7.0,999,6.88188188188188
740,259,6.84189189189189,7.0,999,6.88288288288288
736,263,6.84510869565217,7.0,999,6.88588588588589
735,264,6.83537414965986,7.0,999,6.87887887887888
739,260,6.83355886332882,7.0,999,6.87687687687688
741,258,6.83805668016194,7.0,999,6.87987987987988
746,253,6.83914209115281,7.0,999,6.87987987987988
739,260,6.8403247631935,7.0,999,6.88188188188188
732,267,6.83879781420765,7.0,999,6.88188188188188
738,261,6.83739837398374,7.0,999,6.87987987987988
735,264,6.83673469387755,7.0,999,6.87987987987988
732,267,6.83333333333333,7.0,999,6.87787787787788
739,260,6.84573748308525,7.0,999,6.88588588588589
735,264,6.84897959183674,7.0,999,6.88888888888889
724,275,6.84254143646409,7.0,999,6.88588588588589
723,276,6.84508990318119,7.0,999,6.88788788788789
720,279,6.84722222222222,7.0,999,6.88988988988989
719,280,6.83588317107093,7.0,999,6.88188188188188
721,278,6.84604715672677,7.0,999,6.88888888888889
726,273,6.85123966942149,7.0,999,6.89189189189189
737,262,6.8493894165536,7.0,999,6.88888888888889
743,256,6.85464333781965,7.0,999,6.89189189189189
754,245,6.85543766578249,7.0,999,6.89089089089089
763,236,6.84927916120577,7.0,999,6.88488488488488
774,225,6.84883720930233,7.0,999,6.88288288288288
776,223,6.84922680412371,7.0,999,6.88288288288288
767,232,6.85658409387223,7.0,999,6.88988988988989
759,240,6.85770750988142,7.0,999,6.89189189189189
764,235,6.84685863874346,7.0,999,6.88288288288288
769,230,6.85955786736021,7.0,999,6.89189189189189
771,228,6.84954604409857,7.0,999,6.88388388388388
772,227,6.84585492227979,7.0,999,6.88088088088088
774,225,6.85271317829457,7.0,999,6.88588588588589
775,224,6.85677419354839,7.0,999,6.88888888888889
785,214,6.86369426751592,7.0,999,6.89289289289289
773,226,6.86287192755498,7.0,999,6.89389389389389
778,221,6.86375321336761,7.0,999,6.89389389389389
784,215,6.85459183673469,7.0,999,6.88588588588589
781,218,6.85019206145967,7.0,999,6.88288288288288
787,212,6.85387547649301,7.0,999,6.88488488488488
789,210,6.85044359949303,7.0,999,6.88188188188188
796,203,6.8429648241206,7.0,999,6.87487487487487
796,203,6.85050251256281,7.0,999,6.88088088088088
801,198,6.85767790262172,7.0,999,6.88588588588589
796,203,6.84547738693467,7.0,999,6.87687687687688
791,208,6.84323640960809,7.0,999,6.87587587587588
800,199,6.845,7.0,999,6.87587587587588
804,195,6.83208955223881,7.0,999,6.86486486486486
806,193,6.83374689826303,7.0,999,6.86586586586587
802,197,6.83167082294264,7.0,999,6.86486486486486
806,193,6.82506203473945,7.0,999,6.85885885885886
802,197,6.82294264339152,7.0,999,6.85785785785786
805,194,6.81987577639752,7.0,999,6.85485485485485
808,191,6.82425742574257,7.0,999,6.85785785785786
800,199,6.815,7.0,999,6.85185185185185
799,200,6.81226533166458,7.0,999,6.84984984984985
794,205,6.81108312342569,7.0,999,6.84984984984985
797,202,6.80928481806775,7.0,999,6.84784784784785
793,206,6.80832282471627,7.0,999,6.84784784784785
785,214,6.81019108280255,7.0,999,6.85085085085085
784,215,6.80484693877551,7.0,999,6.84684684684685
784,215,6.80229591836735,7.0,999,6.84484484484484
786,213,6.8027989821883,7.0,999,6.84484484484484
776,223,6.80025773195876,7.0,999,6.84484484484484
783,216,6.79948914431673,7.0,999,6.84284284284284
782,217,6.79795396419437,7.0,999,6.84184184184184
780,219,6.78846153846154,7.0,999,6.83483483483483
788,211,6.78807106598985,7.0,999,6.83283283283283
786,213,6.79262086513995,7.0,999,6.83683683683684
789,210,6.79087452471483,7.0,999,6.83483483483483
786,213,6.79134860050891,7.0,999,6.83583583583584
793,206,6.78184110970996,7.0,999,6.82682682682683
797,202,6.78042659974906,7.0,999,6.82482482482482
788,211,6.78680203045685,7.0,999,6.83183183183183
795,204,6.78364779874214,7.0,999,6.82782782782783
785,214,6.7796178343949,7.0,999,6.82682682682683
788,211,6.78807106598985,7.0,999,6.83283283283283
790,209,6.79746835443038,7.0,999,6.83983983983984
793,206,6.79697351828499,7.0,999,6.83883883883884
786,213,6.78880407124682,7.0,999,6.83383383383383
784,215,6.78698979591837,7.0,999,6.83283283283283
783,216,6.79821200510856,7.0,999,6.84184184184184
779,220,6.798459563543,7.0,999,6.84284284284284
777,222,6.8043758043758,7.0,999,6.84784784784785
779,220,6.79204107830552,7.0,999,6.83783783783784
783,216,6.79310344827586,7.0,999,6.83783783783784
776,223,6.79639175257732,7.0,999,6.84184184184184
779,220,6.79589216944801,7.0,999,6.84084084084084
779,220,6.80359435173299,7.0,999,6.84684684684685
783,216,6.81736909323116,7.0,999,6.85685685685686
787,212,6.82465057179161,7.0,999,6.86186186186186
788,211,6.82106598984772,7.0,999,6.85885885885886
795,204,6.82264150943396,7.0,999,6.85885885885886
797,202,6.82308657465496,7.0,999,6.85885885885886
800,199,6.82375,7.0,999,6.85885885885886
799,200,6.81476846057572,7.0,999,6.85185185185185
798,201,6.81328320802005,7.0,999,6.85085085085085
799,200,6.81226533166458,7.0,999,6.84984984984985
794,205,6.80856423173804,7.0,999,6.84784784784785
802,197,6.80548628428928,7.0,999,6.84384384384384
806,193,6.80397022332506,7.0,999,6.84184184184184
809,190,6.80222496909765,7.0,999,6.83983983983984
804,195,6.80099502487562,7.0,999,6.83983983983984
802,197,6.79800498753117,7.0,999,6.83783783783784
795,204,6.80125786163522,7.0,999,6.84184184184184
785,214,6.80764331210191,7.0,999,6.84884884884885
785,214,6.79363057324841,7.0,999,6.83783783783784
790,209,6.80506329113924,7.0,999,6.84584584584585
781,218,6.80793854033291,7.0,999,6.84984984984985
789,210,6.81115335868188,7.0,999,6.85085085085085
782,217,6.80434782608696,7.0,999,6.84684684684685
789,210,6.80101394169835,7.0,999,6.84284284284284
778,221,6.79691516709512,7.0,999,6.84184184184184
779,220,6.78947368421053,7.0,999,6.83583583583584
778,221,6.79048843187661,7.0,999,6.83683683683684
771,228,6.79118028534371,7.0,999,6.83883883883884
767,232,6.78748370273794,7.0,999,6.83683683683684
763,236,6.79030144167759,7.0,999,6.83983983983984
754,245,6.79310344827586,7.0,999,6.84384384384384
756,243,6.7962962962963,7.0,999,6.84584584584585
774,225,6.79198966408269,7.0,999,6.83883883883884
778,221,6.80077120822622,7.0,999,6.84484484484484
785,214,6.79490445859873,7.0,999,6.83883883883884
771,228,6.79377431906615,7.0,999,6.84084084084084
763,236,6.79554390563565,7.0,999,6.84384384384384
764,235,6.79581151832461,7.0,999,6.84384384384384
760,239,6.79078947368421,7.0,999,6.84084084084084
771,228,6.78599221789883,7.0,999,6.83483483483483
771,228,6.78339818417639,7.0,999,6.83283283283283
775,224,6.7858064516129,7.0,999,6.83383383383383
769,230,6.78933680104031,7.0,999,6.83783783783784
764,235,6.78403141361257,7.0,999,6.83483483483483
764,235,6.77748691099476,7.0,999,6.82982982982983
760,239,6.78552631578947,7.0,999,6.83683683683684
760,239,6.79473684210526,7.0,999,6.84384384384384
757,242,6.79788639365918,7.0,999,6.84684684684685
749,250,6.80240320427236,7.0,999,6.85185185185185
746,253,6.80428954423592,7.0,999,6.85385385385385
737,262,6.81275440976933,7.0,999,6.86186186186186
735,264,6.79863945578231,7.0,999,6.85185185185185
721,278,6.79611650485437,7.0,999,6.85285285285285
715,284,6.7986013986014,7.0,999,6.85585585585586
715,284,6.79020979020979,7.0,999,6.84984984984985
720,279,6.7875,7.0,999,6.84684684684685
710,289,6.7943661971831,7.0,999,6.85385385385385
718,281,6.77576601671309,7.0,999,6.83883883883884
722,277,6.77146814404432,7.0,999,6.83483483483483
719,280,6.77607788595271,7.0,999,6.83883883883884
716,283,6.77653631284916,7.0,999,6.83983983983984
716,283,6.77932960893855,7.0,999,6.84184184184184
724,275,6.77762430939227,7.0,999,6.83883883883884
725,274,6.7848275862069,7.0,999,6.84384384384384
724,275,6.76933701657459,7.0,999,6.83283283283283
746,253,6.77077747989276,7.0,999,6.82882882882883
746,253,6.77077747989276,7.0,999,6.82882882882883
746,253,6.76809651474531,7.0,999,6.82682682682683
747,252,6.76974564926372,7.0,999,6.82782782782783
751,248,6.76564580559254,7.0,999,6.82382382382382
750,249,6.76,7.0,999,6.81981981981982
732,267,6.75136612021858,7.0,999,6.81781781781782
737,262,6.74355495251018,7.0,999,6.81081081081081
733,266,6.73669849931787,7.0,999,6.80680680680681
740,259,6.72702702702703,7.0,999,6.7977977977978
730,269,6.73013698630137,7.0,999,6.8028028028028
729,270,6.73251028806584,7.0,999,6.8048048048048
724,275,6.73342541436464,7.0,999,6.80680680680681
720,279,6.72361111111111,7.0,999,6.8008008008008
712,287,6.71488764044944,7.0,999,6.7967967967968
710,289,6.7112676056338,7.0,999,6.79479479479479
717,282,6.70153417015342,7.0,999,6.78578578578579
707,292,6.7015558698727,7.0,999,6.78878878878879
711,288,6.69620253164557,7.0,999,6.78378378378378
706,293,6.70254957507082,7.0,999,6.78978978978979
707,292,6.68741159830269,7.0,999,6.77877877877878
716,283,6.69553072625698,7.0,999,6.78178178178178
715,284,6.6965034965035,7.0,999,6.78278278278278
712,287,6.68258426966292,7.0,999,6.77377377377377
705,294,6.6936170212766,7.0,999,6.78378378378378
714,285,6.69607843137255,7.0,999,6.78278278278278
715,284,6.71608391608392,7.0,999,6.7967967967968
713,286,6.70967741935484,7.0,999,6.79279279279279
714,285,6.71288515406162,7.0,999,6.79479479479479
714,285,6.70588235294118,7.0,999,6.78978978978979
707,292,6.7029702970297,7.0,999,6.78978978978979
710,289,6.7,7.0,999,6.78678678678679
718,281,6.69777158774373,7.0,999,6.78278278278278
719,280,6.70514603616134,7.0,999,6.78778778778779
716,283,6.70810055865922,7.0,999,6.79079079079079
709,290,6.7179125528914,7.0,999,6.7997997997998
705,294,6.70921985815603,7.0,999,6.79479479479479
705,294,6.71347517730496,7.0,999,6.7977977977978
703,296,6.72403982930299,7.0,999,6.80580580580581
703,296,6.72688477951636,7.0,999,6.80780780780781
710,289,6.72394366197183,7.0,999,6.8038038038038
707,292,6.72701555869873,7.0,999,6.80680680680681
718,281,6.72701949860724,7.0,999,6.8038038038038
720,279,6.72222222222222,7.0,999,6.7997997997998
720,279,6.72083333333333,7.0,999,6.7987987987988
733,266,6.71896316507503,7.0,999,6.79379379379379
730,269,6.72739726027397,7.0,999,6.8008008008008
740,259,6.72162162162162,7.0,999,6.79379379379379
734,265,6.72615803814714,7.0,999,6.7987987987988
743,256,6.72005383580081,7.0,999,6.79179179179179
739,260,6.71447902571042,7.0,999,6.78878878878879
745,254,6.70872483221476,7.0,999,6.78278278278278
744,255,6.70698924731183,7.0,999,6.78178178178178
735,264,6.70612244897959,7.0,999,6.78378378378378
737,262,6.70420624151967,7.0,999,6.78178178178178
743,256,6.71332436069987,7.0,999,6.78678678678679
752,247,6.70478723404255,7.0,999,6.77777777777778
745,254,6.6993288590604,7.0,999,6.77577577577578
738,261,6.710027100271,7.0,999,6.78578578578579
739,260,6.71041948579161,7.0,999,6.78578578578579
727,272,6.71664374140303,7.0,999,6.79379379379379
728,271,6.71153846153846,7.0,999,6.78978978978979
731,268,6.71682626538988,7.0,999,6.79279279279279
729,270,6.71742112482853,7.0,999,6.79379379379379
746,253,6.71447721179625,7.0,999,6.78678678678679
744,255,6.71370967741935,7.0,999,6.78678678678679
738,261,6.71544715447155,7.0,999,6.78978978978979
742,257,6.71293800539084,7.0,999,6.78678678678679
738,261,6.71273712737127,7.0,999,6.78778778778779
742,257,6.72102425876011,7.0,999,6.79279279279279
742,257,6.7277628032345,7.0,999,6.7977977977978
740,259,6.71486486486486,7.0,999,6.78878878878879
729,270,6.7201646090535,7.0,999,6.7957957957958
731,268,6.72366621067031,7.0,999,6.7977977977978
726,273,6.72865013774105,7.0,999,6.8028028028028
724,275,6.72513812154696,7.0,999,6.8008008008008
732,267,6.72404371584699,7.0,999,6.7977977977978
735,264,6.72108843537415,7.0,999,6.79479479479479
735,264,6.71836734693878,7.0,999,6.79279279279279
732,267,6.73497267759563,7.0,999,6.80580580580581
730,269,6.74246575342466,7.0,999,6.81181181181181
735,264,6.73741496598639,7.0,999,6.80680680680681
725,274,6.73655172413793,7.0,999,6.80880880880881
733,266,6.73260572987722,7.0,999,6.8038038038038
740,259,6.72702702702703,7.0,999,6.7977977977978
752,247,6.72207446808511,7.0,999,6.79079079079079
748,251,6.73395721925134,7.0,999,6.8008008008008
748,251,6.73529411764706,7.0,999,6.8018018018018
752,247,6.73537234042553,7.0,999,6.8008008008008
757,242,6.72787318361955,7.0,999,6.79379379379379
760,239,6.74605263157895,7.0,999,6.80680680680681
756,243,6.74603174603175,7.0,999,6.80780780780781
752,247,6.73537234042553,7.0,999,6.8008008008008
759,240,6.73122529644269,7.0,999,6.7957957957958
759,240,6.72990777338603,7.0,999,6.79479479479479
755,244,6.73907284768212,7.0,999,6.8028028028028
759,240,6.74571805006588,7.0,999,6.80680680680681
764,235,6.74476439790576,7.0,999,6.8048048048048
760,239,6.7421052631579,7.0,999,6.8038038038038
760,239,6.75394736842105,7.0,999,6.81281281281281
764,235,6.75785340314136,7.0,999,6.81481481481481
766,233,6.75456919060052,7.0,999,6.81181181181181
766,233,6.7532637075718,7.0,999,6.81081081081081
766,233,6.75848563968668,7.0,999,6.81481481481481
766,233,6.74804177545692,7.0,999,6.80680680680681
756,243,6.74338624338624,7.0,999,6.80580580580581
752,247,6.73936170212766,7.0,999,6.8038038038038
755,244,6.73377483443709,7.0,999,6.7987987987988
758,241,6.72559366754617,7.0,999,6.79179179179179
757,242,6.71994715984148,7.0,999,6.78778778778779
770,229,6.73246753246753,7.0,999,6.79379379379379
772,227,6.71761658031088,7.0,999,6.78178178178178
771,228,6.72114137483787,7.0,999,6.78478478478478
768,231,6.71744791666667,7.0,999,6.78278278278278
769,230,6.71131339401821,7.0,999,6.77777777777778
772,227,6.70077720207254,7.0,999,6.76876876876877
772,227,6.70725388601036,7.0,999,6.77377377377377
768,231,6.72005208333333,7.0,999,6.78478478478478
771,228,6.72503242542153,7.0,999,6.78778778778779
772,227,6.72668393782383,7.0,999,6.78878878878879
767,232,6.73663624511082,7.0,999,6.7977977977978
771,228,6.73411154345006,7.0,999,6.79479479479479
779,220,6.73299101412067,7.0,999,6.79179179179179
785,214,6.73375796178344,7.0,999,6.79079079079079
792,207,6.73358585858586,7.0,999,6.78878878878879
797,202,6.72647427854454,7.0,999,6.78178178178178
802,197,6.72069825436409,7.0,999,6.77577577577578
798,201,6.71679197994987,7.0,999,6.77377377377377
792,207,6.71212121212121,7.0,999,6.77177177177177
778,221,6.7120822622108,7.0,999,6.77577577577578
785,214,6.70955414012739,7.0,999,6.77177177177177
784,215,6.70280612244898,7.0,999,6.76676676676677
784,215,6.69897959183673,7.0,999,6.76376376376376
780,219,6.68974358974359,7.0,999,6.75775775775776
780,219,6.69102564102564,7.0,999,6.75875875875876
785,214,6.69299363057325,7.0,999,6.75875875875876
777,222,6.68854568854569,7.0,999,6.75775775775776
775,224,6.69032258064516,7.0,999,6.75975975975976
766,233,6.68798955613577,7.0,999,6.76076076076076
766,233,6.69321148825065,7.0,999,6.76476476476476
769,230,6.68660598179454,7.0,999,6.75875875875876
771,228,6.69001297016861,7.0,999,6.76076076076076
775,224,6.68129032258065,7.0,999,6.75275275275275
765,234,6.6797385620915,7.0,999,6.75475475475475
775,224,6.67741935483871,7.0,999,6.74974974974975
780,219,6.67564102564103,7.0,999,6.74674674674675
781,218,6.67349551856594,7.0,999,6.74474474474474
778,221,6.66838046272494,7.0,999,6.74174174174174
782,217,6.66496163682864,7.0,999,6.73773773773774
781,218,6.6696542893726,7.0,999,6.74174174174174
777,222,6.68983268983269,7.0,999,6.75875875875876
778,221,6.69408740359897,7.0,999,6.76176176176176
774,225,6.68604651162791,7.0,999,6.75675675675676
776,223,6.68685567010309,7.0,999,6.75675675675676
774,225,6.67829457364341,7.0,999,6.75075075075075
781,218,6.68245838668374,7.0,999,6.75175175175175
787,212,6.66963151207116,7.0,999,6.73973973973974
778,221,6.67609254498715,7.0,999,6.74774774774775
784,215,6.66198979591837,7.0,999,6.73473473473473
776,223,6.65979381443299,7.0,999,6.73573573573574
778,221,6.65167095115681,7.0,999,6.72872872872873
786,213,6.66793893129771,7.0,999,6.73873873873874
783,216,6.67305236270754,7.0,999,6.74374374374374
779,220,6.65340179717587,7.0,999,6.72972972972973
794,205,6.65743073047859,7.0,999,6.72772772772773
798,201,6.65413533834586,7.0,999,6.72372372372372
794,205,6.64357682619647,7.0,999,6.71671671671672
782,217,6.64066496163683,7.0,999,6.71871871871872
779,220,6.64313222079589,7.0,999,6.72172172172172
786,213,6.63613231552163,7.0,999,6.71371371371371
783,216,6.64240102171137,7.0,999,6.71971971971972
775,224,6.64774193548387,7.0,999,6.72672672672673
773,226,6.65717981888745,7.0,999,6.73473473473473
779,220,6.65083440308087,7.0,999,6.72772772772773
777,222,6.64993564993565,7.0,999,6.72772772772773
769,230,6.66059817945384,7.0,999,6.73873873873874
766,233,6.65535248041775,7.0,999,6.73573573573574
755,244,6.64900662251656,7.0,999,6.73473473473473
751,248,6.64580559254328,7.0,999,6.73373373373373
752,247,6.64627659574468,7.0,999,6.73373373373373
752,247,6.64627659574468,7.0,999,6.73373373373373
743,256,6.66756393001346,7.0,999,6.75275275275275
745,254,6.66174496644295,7.0,999,6.74774774774775
740,259,6.65810810810811,7.0,999,6.74674674674675
729,270,6.67352537722908,7.0,999,6.76176176176176
731,268,6.67441860465116,7.0,999,6.76176176176176
734,265,6.67983651226158,7.0,999,6.76476476476476
728,271,6.68406593406593,7.0,999,6.76976976976977
738,261,6.67208672086721,7.0,999,6.75775775775776
740,259,6.66351351351351,7.0,999,6.75075075075075
729,270,6.6639231824417,7.0,999,6.75475475475475
731,268,6.67441860465116,7.0,999,6.76176176176176
740,259,6.66756756756757,7.0,999,6.75375375375375
735,264,6.65714285714286,7.0,999,6.74774774774775
728,271,6.66071428571429,7.0,999,6.75275275275275
726,273,6.66942148760331,7.0,999,6.75975975975976
734,265,6.66348773841962,7.0,999,6.75275275275275
720,279,6.64583333333333,7.0,999,6.74474474474474
710,289,6.65352112676056,7.0,999,6.75375375375375
706,293,6.65297450424929,7.0,999,6.75475475475475
706,293,6.6614730878187,7.0,999,6.76076076076076
700,299,6.66428571428571,7.0,999,6.76476476476476
707,292,6.65063649222065,7.0,999,6.75275275275275
699,300,6.62804005722461,7.0,999,6.73973973973974
695,304,6.63021582733813,7.0,999,6.74274274274274
702,297,6.63532763532764,7.0,999,6.74374374374374
691,308,6.62807525325615,7.0,999,6.74274274274274
704,295,6.61647727272727,7.0,999,6.72972972972973
707,292,6.61951909476662,7.0,999,6.73073073073073
718,281,6.6100278551532,7.0,999,6.71971971971972
716,283,6.61033519553073,7.0,999,6.72072072072072
726,273,6.60881542699725,7.0,999,6.71571571571572
727,272,6.61072902338377,7.0,999,6.71671671671672
724,275,6.61878453038674,7.0,999,6.72372372372372
727,272,6.61760660247593,7.0,999,6.72172172172172
716,283,6.62430167597765,7.0,999,6.73073073073073
720,279,6.60833333333333,7.0,999,6.71771771771772
710,289,6.6112676056338,7.0,999,6.72372372372372
718,281,6.61559888579387,7.0,999,6.72372372372372
720,279,6.62083333333333,7.0,999,6.72672672672673
714,285,6.61624649859944,7.0,999,6.72572572572573
722,277,6.61495844875346,7.0,999,6.72172172172172
728,271,6.62087912087912,7.0,999,6.72372372372372
727,272,6.61348005502063,7.0,999,6.71871871871872
721,278,6.61165048543689,7.0,999,6.71971971971972
726,273,6.61157024793388,7.0,999,6.71771771771772
731,268,6.61285909712722,7.0,999,6.71671671671672
726,273,6.6198347107438,7.0,999,6.72372372372372
730,269,6.61095890410959,7.0,999,6.71571571571572
739,260,6.60893098782138,7.0,999,6.71071071071071
722,277,6.59141274238227,7.0,999,6.7047047047047
732,267,6.59016393442623,7.0,999,6.6996996996997
731,268,6.58823529411765,7.0,999,6.6986986986987
736,263,6.57744565217391,7.0,999,6.68868868868869
739,260,6.57104194857916,7.0,999,6.68268268268268
736,263,6.57744565217391,7.0,999,6.68868868868869
734,265,6.58038147138965,7.0,999,6.69169169169169
738,261,6.58130081300813,7.0,999,6.69069069069069
743,256,6.59219380888291,7.0,999,6.6966966966967
742,257,6.60916442048518,7.0,999,6.70970970970971
742,257,6.60512129380054,7.0,999,6.70670670670671
751,248,6.60585885486019,7.0,999,6.7037037037037
742,257,6.59838274932615,7.0,999,6.7017017017017
747,252,6.60240963855422,7.0,999,6.7027027027027
743,256,6.58681022880215,7.0,999,6.69269269269269
750,249,6.58533333333333,7.0,999,6.68868868868869
748,251,6.59090909090909,7.0,999,6.69369369369369
747,252,6.59571619812584,7.0,999,6.6976976976977
748,251,6.60026737967914,7.0,999,6.7007007007007
746,253,6.60321715817694,7.0,999,6.7037037037037
740,259,6.61081081081081,7.0,999,6.71171171171171
745,254,6.61208053691275,7.0,999,6.71071071071071
752,247,6.62367021276596,7.0,999,6.71671671671672
756,243,6.63095238095238,7.0,999,6.72072072072072
746,253,6.62332439678284,7.0,999,6.71871871871872
749,250,6.60881174899867,7.0,999,6.70670670670671
763,236,6.60419397116645,7.0,999,6.6976976976977
763,236,6.59895150720839,7.0,999,6.69369369369369
758,241,6.62269129287599,7.0,999,6.71371371371371
760,239,6.62763157894737,7.0,999,6.71671671671672
767,232,6.6245110821382,7.0,999,6.71171171171171
764,235,6.63743455497382,7.0,999,6.72272272272272
765,234,6.62745098039216,7.0,999,6.71471471471471
765,234,6.60915032679739,7.0,999,6.7007007007007
766,233,6.62271540469974,7.0,999,6.71071071071071
757,242,6.63143989431968,7.0,999,6.72072072072072
760,239,6.62631578947368,7.0,999,6.71571571571572
753,246,6.62416998671979,7.0,999,6.71671671671672
757,242,6.63408190224571,7.0,999,6.72272272272272
756,243,6.62169312169312,7.0,999,6.71371371371371
751,248,6.61784287616511,7.0,999,6.71271271271271
748,251,6.61764705882353,7.0,999,6.71371371371371
746,253,6.60723860589812,7.0,999,6.70670670670671
743,256,6.60296096904441,7.0,999,6.7047047047047
738,261,6.60433604336043,7.0,999,6.70770770770771
742,257,6.61320754716981,7.0,999,6.71271271271271
744,255,6.5994623655914,7.0,999,6.7017017017017
734,265,6.59536784741144,7.0,999,6.7027027027027
727,272,6.58596973865199,7.0,999,6.6986986986987
739,260,6.57780784844384,7.0,999,6.68768768768769
733,266,6.58663028649386,7.0,999,6.6966966966967
734,265,6.57629427792916,7.0,999,6.68868868868869
736,263,6.58288043478261,7.0,999,6.69269269269269
743,256,6.57604306864065,7.0,999,6.68468468468468
736,263,6.58152173913043,7.0,999,6.69169169169169
746,253,6.57908847184987,7.0,999,6.68568568568569
750,249,6.584,7.0,999,6.68768768768769
744,255,6.58870967741935,7.0,999,6.69369369369369
758,241,6.57651715039578,7.0,999,6.67867867867868
760,239,6.57763157894737,7.0,999,6.67867867867868
765,234,6.57647058823529,7.0,999,6.67567567567568
762,237,6.57086614173228,7.0,999,6.67267267267267
767,232,6.55541069100391,7.0,999,6.65865865865866
768,231,6.57552083333333,7.0,999,6.67367367367367
771,228,6.59273670557717,7.0,999,6.68568568568569
772,227,6.58937823834197,7.0,999,6.68268268268268
772,227,6.59067357512953,7.0,999,6.68368368368368
771,228,6.59014267185473,7.0,999,6.68368368368368
772,227,6.59067357512953,7.0,999,6.68368368368368
768,231,6.59765625,7.0,999,6.69069069069069
754,245,6.59814323607427,7.0,999,6.6966966966967
757,242,6.57859973579921,7.0,999,6.68068068068068
766,233,6.58746736292428,7.0,999,6.68368368368368
772,227,6.59974093264249,7.0,999,6.69069069069069
769,230,6.60078023407022,7.0,999,6.69269269269269
770,229,6.5987012987013,7.0,999,6.69069069069069
767,232,6.59582790091265,7.0,999,6.68968968968969
765,234,6.60522875816993,7.0,999,6.6976976976977
770,229,6.5974025974026,7.0,999,6.68968968968969
770,229,6.6025974025974,7.0,999,6.69369369369369
770,229,6.61818181818182,7.0,999,6.70570570570571
775,224,6.60903225806452,7.0,999,6.6966966966967
767,232,6.60756192959583,7.0,999,6.6986986986987
775,224,6.6141935483871,7.0,999,6.7007007007007
785,214,6.63057324840764,7.0,999,6.70970970970971
776,223,6.60180412371134,7.0,999,6.69069069069069
781,218,6.61331626120359,7.0,999,6.6976976976977
777,222,6.62676962676963,7.0,999,6.70970970970971
777,222,6.63449163449163,7.0,999,6.71571571571572
774,225,6.63695090439276,7.0,999,6.71871871871872
763,236,6.63695937090433,7.0,999,6.72272272272272
768,231,6.63411458333333,7.0,999,6.71871871871872
765,234,6.64705882352941,7.0,999,6.72972972972973
771,228,6.65239948119326,7.0,999,6.73173173173173
779,220,6.65211810012837,7.0,999,6.72872872872873
770,229,6.65064935064935,7.0,999,6.73073073073073
776,223,6.65850515463918,7.0,999,6.73473473473473
790,209,6.65696202531646,7.0,999,6.72872872872873
790,209,6.65316455696203,7.0,999,6.72572572572573
784,215,6.64668367346939,7.0,999,6.72272272272272
785,214,6.64713375796178,7.0,999,6.72272272272272
787,212,6.64930114358323,7.0,999,6.72372372372372
787,212,6.65565438373571,7.0,999,6.72872872872873
787,212,6.66454891994917,7.0,999,6.73573573573574
784,215,6.66964285714286,7.0,999,6.74074074074074
783,216,6.67432950191571,7.0,999,6.74474474474474
786,213,6.66666666666667,7.0,999,6.73773773773774
789,210,6.66920152091255,7.0,999,6.73873873873874
787,212,6.67217280813215,7.0,999,6.74174174174174
795,204,6.67421383647799,7.0,999,6.74074074074074
794,205,6.67758186397985,7.0,999,6.74374374374374
789,210,6.67046894803549,7.0,999,6.73973973973974
793,206,6.67213114754098,7.0,999,6.73973973973974
799,200,6.67459324155194,7.0,999,6.73973973973974
792,207,6.67424242424242,7.0,999,6.74174174174174
797,202,6.64993726474279,7.0,999,6.72072072072072
790,209,6.66329113924051,7.0,999,6.73373373373373
793,206,6.66078184110971,7.0,999,6.73073073073073
791,208,6.65486725663717,7.0,999,6.72672672672673
795,204,6.64528301886792,7.0,999,6.71771771771772
794,205,6.65743073047859,7.0,999,6.72772772772773
795,204,6.6503144654088,7.0,999,6.72172172172172
793,206,6.64186633039092,7.0,999,6.71571571571572
794,205,6.64609571788413,7.0,999,6.71871871871872
801,198,6.63670411985019,7.0,999,6.70870870870871
806,193,6.62655086848635,7.0,999,6.6986986986987
804,195,6.62064676616915,7.0,999,6.69469469469469
804,195,6.62437810945274,7.0,999,6.6976976976977
814,185,6.62039312039312,7.0,999,6.69069069069069
820,179,6.62073170731707,7.0,999,6.68868868868869
820,179,6.61829268292683,7.0,999,6.68668668668669
819,180,6.6043956043956,7.0,999,6.67567567567568
821,178,6.59926918392205,7.0,999,6.67067067067067
825,174,6.59878787878788,7.0,999,6.66866866866867
820,179,6.59634146341463,7.0,999,6.66866866866867
827,172,6.58887545344619,7.0,999,6.65965965965966
823,176,6.58809234507898,7.0,999,6.66066066066066
818,181,6.59168704156479,7.0,999,6.66566566566567
822,177,6.58880778588808,7.0,999,6.66166166166166
825,174,6.59878787878788,7.0,999,6.66866866866867
807,192,6.58612143742255,7.0,999,6.66566566566567
812,187,6.58990147783251,7.0,999,6.66666666666667
805,194,6.5888198757764,7.0,999,6.66866866866867
811,188,6.59062885326757,7.0,999,6.66766766766767
803,196,6.57907845579078,7.0,999,6.66166166166166
805,194,6.57888198757764,7.0,999,6.66066066066066
807,192,6.59727385377943,7.0,999,6.67467467467467
806,193,6.59057071960298,7.0,999,6.66966966966967
809,190,6.58590852904821,7.0,999,6.66466466466466
810,189,6.57901234567901,7.0,999,6.65865865865866
809,190,6.58343634116193,7.0,999,6.66266266266266
812,187,6.57142857142857,7.0,999,6.65165165165165
814,185,6.56879606879607,7.0,999,6.64864864864865
816,183,6.56740196078431,7.0,999,6.64664664664665
813,186,6.56334563345633,7.0,999,6.64464464464464
821,178,6.55420219244823,7.0,999,6.63363363363363
820,179,6.56829268292683,7.0,999,6.64564564564565
819,180,6.56532356532357,7.0,999,6.64364364364364
818,181,6.56356968215159,7.0,999,6.64264264264264
820,179,6.56829268292683,7.0,999,6.64564564564565
817,182,6.57160342717258,7.0,999,6.64964964964965
816,183,6.58210784313725,7.0,999,6.65865865865866
808,191,6.58415841584158,7.0,999,6.66366366366366
816,183,6.58700980392157,7.0,999,6.66266266266266
822,177,6.58029197080292,7.0,999,6.65465465465465
823,176,6.58323207776428,7.0,999,6.65665665665666
826,173,6.59685230024213,7.0,999,6.66666666666667
829,170,6.60313630880579,7.0,999,6.67067067067067
827,172,6.60096735187424,7.0,999,6.66966966966967
824,175,6.60679611650485,7.0,999,6.67567567567568
825,174,6.61333333333333,7.0,999,6.68068068068068
819,180,6.63247863247863,7.0,999,6.6986986986987
818,181,6.62224938875306,7.0,999,6.69069069069069
820,179,6.63414634146341,7.0,999,6.6996996996997
817,182,6.63525091799266,7.0,999,6.7017017017017
809,190,6.64524103831891,7.0,999,6.71271271271271
815,184,6.64049079754601,7.0,999,6.70670670670671
814,185,6.64250614250614,7.0,999,6.70870870870871
805,194,6.6472049689441,7.0,999,6.71571571571572
812,187,6.6551724137931,7.0,999,6.71971971971972
811,188,6.6596794081381,7.0,999,6.72372372372372
803,196,6.66251556662516,7.0,999,6.72872872872873
812,187,6.6576354679803,7.0,999,6.72172172172172
819,180,6.67399267399267,7.0,999,6.73273273273273
818,181,6.66259168704156,7.0,999,6.72372372372372
824,175,6.66626213592233,7.0,999,6.72472472472472
827,172,6.67110036275695,7.0,999,6.72772772772773
826,173,6.67796610169492,7.0,999,6.73373373373373
827,172,6.68319226118501,7.0,999,6.73773773773774
821,178,6.67113276492083,7.0,999,6.72972972972973
821,178,6.67844092570037,7.0,999,6.73573573573574
834,165,6.68705035971223,7.0,999,6.73873873873874
830,169,6.69518072289157,7.0,999,6.74674674674675
829,170,6.70928829915561,7.0,999,6.75875875875876
828,171,6.71135265700483,7.0,999,6.76076076076076
820,179,6.70731707317073,7.0,999,6.75975975975976
831,168,6.71239470517449,7.0,999,6.76076076076076
836,163,6.70454545454545,7.0,999,6.75275275275275
840,159,6.71666666666667,7.0,999,6.76176176176176
836,163,6.71172248803828,7.0,999,6.75875875875876
837,162,6.71923536439665,7.0,999,6.76476476476476
842,157,6.72209026128266,7.0,999,6.76576576576577
842,157,6.72565320665083,7.0,999,6.76876876876877
840,159,6.72142857142857,7.0,999,6.76576576576577
840,159,6.71785714285714,7.0,999,6.76276276276276
843,156,6.7141162514828,7.0,999,6.75875875875876
845,154,6.71005917159763,7.0,999,6.75475475475475
839,160,6.71513706793802,7.0,999,6.76076076076076
840,159,6.71666666666667,7.0,999,6.76176176176176
841,158,6.71581450653983,7.0,999,6.76076076076076
838,161,6.72434367541766,7.0,999,6.76876876876877
842,157,6.71496437054632,7.0,999,6.75975975975976
845,154,6.71360946745562,7.0,999,6.75775775775776
837,162,6.71326164874552,7.0,999,6.75975975975976
837,162,6.70609318996416,7.0,999,6.75375375375375
842,157,6.71733966745843,7.0,999,6.76176176176176
841,158,6.71343638525565,7.0,999,6.75875875875876
840,159,6.71309523809524,7.0,999,6.75875875875876
834,165,6.71822541966427,7.0,999,6.76476476476476
837,162,6.70967741935484,7.0,999,6.75675675675676
833,166,6.71188475390156,7.0,999,6.75975975975976
832,167,6.71153846153846,7.0,999,6.75975975975976
830,169,6.71686746987952,7.0,999,6.76476476476476
831,168,6.72202166064982,7.0,999,6.76876876876877
826,173,6.70944309927361,7.0,999,6.75975975975976
832,167,6.71995192307692,7.0,999,6.76676676676677
827,172,6.71825876662636,7.0,999,6.76676676676677
824,175,6.72330097087379,7.0,999,6.77177177177177
831,168,6.7280385078219,7.0,999,6.77377377377377
829,170,6.73220747889023,7.0,999,6.77777777777778
828,171,6.72705314009662,7.0,999,6.77377377377377
824,175,6.73058252427184,7.0,999,6.77777777777778
828,171,6.73792270531401,7.0,999,6.78278278278278
825,174,6.74060606060606,7.0,999,6.78578578578579
827,172,6.74848851269649,7.0,999,6.79179179179179
832,167,6.75360576923077,7.0,999,6.79479479479479
832,167,6.75841346153846,7.0,999,6.7987987987988
834,165,6.75179856115108,7.0,999,6.79279279279279
833,166,6.75870348139256,7.0,999,6.7987987987988
835,164,6.75329341317365,7.0,999,6.79379379379379
835,164,6.74730538922156,7.0,999,6.78878878878879
837,162,6.74193548387097,7.0,999,6.78378378378378
843,156,6.72835112692764,7.0,999,6.77077077077077
847,152,6.72018890200708,7.0,999,6.76276276276276
852,147,6.71948356807512,7.0,999,6.76076076076076
855,144,6.72397660818713,7.0,999,6.76376376376376
857,142,6.71411901983664,7.0,999,6.75475475475475
854,145,6.70140515222482,7.0,999,6.74474474474474
849,150,6.71024734982332,7.0,999,6.75375375375375
850,149,6.70470588235294,7.0,999,6.74874874874875
842,157,6.70783847980998,7.0,999,6.75375375375375
847,152,6.70011806375443,7.0,999,6.74574574574575
848,151,6.70165094339623,7.0,999,6.74674674674675
849,150,6.70435806831567,7.0,999,6.74874874874875
851,148,6.69212690951821,7.0,999,6.73773773773774
852,147,6.69835680751174,7.0,999,6.74274274274274
861,138,6.68292682926829,7.0,999,6.72672672672673
860,139,6.68720930232558,7.0,999,6.73073073073073
866,133,6.68360277136259,7.0,999,6.72572572572573
856,143,6.66822429906542,7.0,999,6.71571571571572
861,138,6.6678281068525,7.0,999,6.71371371371371
860,139,6.66860465116279,7.0,999,6.71471471471471
860,139,6.66976744186046,7.0,999,6.71571571571572
853,146,6.66119577960141,7.0,999,6.71071071071071
848,151,6.6686320754717,7.0,999,6.71871871871872
850,149,6.65294117647059,7.0,999,6.7047047047047
847,152,6.66115702479339,7.0,999,6.71271271271271
852,147,6.67488262910798,7.0,999,6.72272272272272
856,143,6.67406542056075,7.0,999,6.72072072072072
861,138,6.6678281068525,7.0,999,6.71371371371371
864,135,6.66435185185185,7.0,999,6.70970970970971
854,145,6.67213114754098,7.0,999,6.71971971971972
854,145,6.66393442622951,7.0,999,6.71271271271271
860,139,6.66511627906977,7.0,999,6.71171171171171
866,133,6.65127020785219,7.0,999,6.6976976976977
864,135,6.65393518518519,7.0,999,6.7007007007007
862,137,6.6508120649652,7.0,999,6.6986986986987
859,140,6.65657741559953,7.0,999,6.7047047047047
859,140,6.65541327124563,7.0,999,6.7037037037037
860,139,6.65232558139535,7.0,999,6.7007007007007
858,141,6.65617715617716,7.0,999,6.7047047047047
855,144,6.67251461988304,7.0,999,6.71971971971972
855,144,6.66432748538012,7.0,999,6.71271271271271
852,147,6.67723004694836,7.0,999,6.72472472472472
861,138,6.6794425087108,7.0,999,6.72372372372372
858,141,6.68764568764569,7.0,999,6.73173173173173
857,142,6.66861143523921,7.0,999,6.71571571571572
857,142,6.67444574095683,7.0,999,6.72072072072072
863,136,6.67902665121669,7.0,999,6.72272272272272
864,135,6.6875,7.0,999,6.72972972972973
866,133,6.68013856812933,7.0,999,6.72272272272272
864,135,6.67592592592593,7.0,999,6.71971971971972
867,132,6.68281430219147,7.0,999,6.72472472472472
862,137,6.67633410672854,7.0,999,6.72072072072072
865,134,6.67630057803468,7.0,999,6.71971971971972
867,132,6.68050749711649,7.0,999,6.72272272272272
867,132,6.67589388696655,7.0,999,6.71871871871872
869,130,6.67203682393556,7.0,999,6.71471471471471
862,137,6.68213457076566,7.0,999,6.72572572572573
866,133,6.68129330254042,7.0,999,6.72372372372372
862,137,6.68213457076566,7.0,999,6.72572572572573
861,138,6.6945412311266,7.0,999,6.73673673673674
860,139,6.69302325581395,7.0,999,6.73573573573574
861,138,6.69105691056911,7.0,999,6.73373373373373
860,139,6.68488372093023,7.0,999,6.72872872872873
857,142,6.68844807467911,7.0,999,6.73273273273273
848,151,6.68985849056604,7.0,999,6.73673673673674
841,158,6.68133174791914,7.0,999,6.73173173173173
846,153,6.68676122931442,7.0,999,6.73473473473473
843,156,6.68327402135231,7.0,999,6.73273273273273
855,144,6.69122807017544,7.0,999,6.73573573573574
852,147,6.68544600938967,7.0,999,6.73173173173173
841,158,6.68965517241379,7.0,999,6.73873873873874
839,160,6.68891537544696,7.0,999,6.73873873873874
832,167,6.68269230769231,7.0,999,6.73573573573574
838,161,6.69212410501193,7.0,999,6.74174174174174
835,164,6.68502994011976,7.0,999,6.73673673673674
836,163,6.69258373205742,7.0,999,6.74274274274274
838,161,6.6945107398568,7.0,999,6.74374374374374
839,160,6.6865315852205,7.0,999,6.73673673673674
837,162,6.69653524492234,7.0,999,6.74574574574575
831,168,6.68832731648616,7.0,999,6.74074074074074
841,158,6.68965517241379,7.0,999,6.73873873873874
838,161,6.67899761336515,7.0,999,6.73073073073073
830,169,6.68795180722892,7.0,999,6.74074074074074
834,165,6.69544364508393,7.0,999,6.74574574574575
827,172,6.69044740024184,7.0,999,6.74374374374374
824,175,6.69902912621359,7.0,999,6.75175175175175
828,171,6.69202898550725,7.0,999,6.74474474474474
830,169,6.69156626506024,7.0,999,6.74374374374374
821,178,6.68331303288672,7.0,999,6.73973973973974
819,180,6.68986568986569,7.0,999,6.74574574574575
828,171,6.68478260869565,7.0,999,6.73873873873874
823,176,6.69380315917375,7.0,999,6.74774774774775
821,178,6.69183922046285,7.0,999,6.74674674674675
820,179,6.69512195121951,7.0,999,6.74974974974975
833,166,6.70108043217287,7.0,999,6.75075075075075
839,160,6.70798569725864,7.0,999,6.75475475475475
850,149,6.69882352941177,7.0,999,6.74374374374374
844,155,6.6978672985782,7.0,999,6.74474474474474
847,152,6.68713105076741,7.0,999,6.73473473473473
848,151,6.68514150943396,7.0,999,6.73273273273273
850,149,6.68117647058824,7.0,999,6.72872872872873
848,151,6.68632075471698,7.0,999,6.73373373373373
836,163,6.69377990430622,7.0,999,6.74374374374374
844,155,6.68601895734597,7.0,999,6.73473473473473
851,148,6.6780258519389,7.0,999,6.72572572572573
859,140,6.68335273573923,7.0,999,6.72772772772773
849,150,6.67255594817432,7.0,999,6.72172172172172
849,150,6.67608951707892,7.0,999,6.72472472472472
846,153,6.67730496453901,7.0,999,6.72672672672673
846,153,6.67139479905437,7.0,999,6.72172172172172
840,159,6.67380952380952,7.0,999,6.72572572572573
834,165,6.67386091127098,7.0,999,6.72772772772773
840,159,6.6702380952381,7.0,999,6.72272272272272
850,149,6.66588235294118,7.0,999,6.71571571571572
848,151,6.66391509433962,7.0,999,6.71471471471471
841,158,6.67776456599287,7.0,999,6.72872872872873
852,147,6.67253521126761,7.0,999,6.72072072072072
856,143,6.67172897196262,7.0,999,6.71871871871872
861,138,6.6678281068525,7.0,999,6.71371371371371
855,144,6.66783625730994,7.0,999,6.71571571571572
855,144,6.66666666666667,7.0,999,6.71471471471471
849,150,6.66077738515901,7.0,999,6.71171171171171
855,144,6.66783625730994,7.0,999,6.71571571571572
856,143,6.66238317757009,7.0,999,6.71071071071071
853,146,6.66354044548652,7.0,999,6.71271271271271
853,146,6.66236811254396,7.0,999,6.71171171171171
856,143,6.65654205607477,7.0,999,6.70570570570571
861,138,6.65505226480836,7.0,999,6.7027027027027
855,144,6.65029239766082,7.0,999,6.7007007007007
861,138,6.64808362369338,7.0,999,6.6966966966967
859,140,6.65424912689173,7.0,999,6.7027027027027
854,145,6.64871194379391,7.0,999,6.6996996996997
855,144,6.63859649122807,7.0,999,6.69069069069069
856,143,6.63785046728972,7.0,999,6.68968968968969
860,139,6.63953488372093,7.0,999,6.68968968968969
862,137,6.63573085846868,7.0,999,6.68568568568569
867,132,6.63437139561707,7.0,999,6.68268268268268
868,131,6.62672811059908,7.0,999,6.67567567567568
867,132,6.62860438292964,7.0,999,6.67767767767768
865,134,6.64624277456647,7.0,999,6.69369369369369
869,130,6.63866513233602,7.0,999,6.68568568568569
869,130,6.64326812428078,7.0,999,6.68968968968969
867,132,6.65513264129181,7.0,999,6.7007007007007
867,132,6.6482122260669,7.0,999,6.69469469469469
857,142,6.64060676779463,7.0,999,6.69169169169169
861,138,6.64227642276423,7.0,999,6.69169169169169
869,130,6.64441887226697,7.0,999,6.69069069069069
868,131,6.65322580645161,7.0,999,6.6986986986987
864,135,6.65740740740741,7.0,999,6.7037037037037
867,132,6.65513264129181,7.0,999,6.7007007007007
865,134,6.65433526011561,7.0,999,6.7007007007007
871,128,6.64867967853043,7.0,999,6.69369369369369
874,125,6.64530892448513,7.0,999,6.68968968968969
869,130,6.63866513233602,7.0,999,6.68568568568569
872,127,6.64220183486239,7.0,999,6.68768768768769
868,131,6.64516129032258,7.0,999,6.69169169169169
875,124,6.64,7.0,999,6.68468468468468
870,129,6.63563218390805,7.0,999,6.68268268268268
871,128,6.63834672789897,7.0,999,6.68468468468468
872,127,6.63990825688073,7.0,999,6.68568568568569
871,128,6.64408725602755,7.0,999,6.68968968968969
876,123,6.64155251141552,7.0,999,6.68568568568569
878,121,6.6503416856492,7.0,999,6.69269269269269
878,121,6.6503416856492,7.0,999,6.69269269269269
871,128,6.64523536165327,7.0,999,6.69069069069069
873,126,6.64604810996564,7.0,999,6.69069069069069
875,124,6.65485714285714,7.0,999,6.6976976976977
873,126,6.64375715922108,7.0,999,6.68868868868869
881,118,6.64472190692395,7.0,999,6.68668668668669
878,121,6.64920273348519,7.0,999,6.69169169169169
875,124,6.648,7.0,999,6.69169169169169
872,127,6.65252293577982,7.0,999,6.6966966966967
866,133,6.65704387990762,7.0,999,6.7027027027027
861,138,6.65853658536585,7.0,999,6.70570570570571
865,134,6.65433526011561,7.0,999,6.7007007007007
867,132,6.65051903114187,7.0,999,6.6966966966967
865,134,6.64624277456647,7.0,999,6.69369369369369
866,133,6.64203233256351,7.0,999,6.68968968968969
867,132,6.65051903114187,7.0,999,6.6966966966967
864,135,6.64930555555556,7.0,999,6.6966966966967
860,139,6.65116279069767,7.0,999,6.6996996996997
864,135,6.64699074074074,7.0,999,6.69469469469469
873,126,6.64604810996564,7.0,999,6.69069069069069
871,128,6.6406429391504,7.0,999,6.68668668668669
871,128,6.63719862227325,7.0,999,6.68368368368368
867,132,6.63321799307958,7.0,999,6.68168168168168
867,132,6.6239907727797,7.0,999,6.67367367367367
863,136,6.62456546929316,7.0,999,6.67567567567568
866,133,6.62817551963049,7.0,999,6.67767767767768
863,136,6.62224797219003,7.0,999,6.67367367367367
863,136,6.61761297798378,7.0,999,6.66966966966967
857,142,6.62777129521587,7.0,999,6.68068068068068
851,148,6.62749706227967,7.0,999,6.68268268268268
852,147,6.61971830985915,7.0,999,6.67567567567568
848,151,6.62617924528302,7.0,999,6.68268268268268
846,153,6.62647754137116,7.0,999,6.68368368368368
849,150,6.62661955241461,7.0,999,6.68268268268268
860,139,6.61860465116279,7.0,999,6.67167167167167
859,140,6.61699650756694,7.0,999,6.67067067067067
855,144,6.6093567251462,7.0,999,6.66566566566567
847,152,6.62101534828808,7.0,999,6.67867867867868
847,152,6.63282172373081,7.0,999,6.68868868868869
851,148,6.6310223266745,7.0,999,6.68568568568569
841,158,6.62901307966706,7.0,999,6.68768768768769
844,155,6.63507109004739,7.0,999,6.69169169169169
840,159,6.63690476190476,7.0,999,6.69469469469469
841,158,6.6397146254459,7.0,999,6.6966966966967
841,158,6.64209274673008,7.0,999,6.6986986986987
839,160,6.63408820023838,7.0,999,6.69269269269269
830,169,6.65421686746988,7.0,999,6.71271271271271
825,174,6.66181818181818,7.0,999,6.72072072072072
831,168,6.67268351383875,7.0,999,6.72772772772773
836,163,6.66985645933014,7.0,999,6.72372372372372
836,163,6.66866028708134,7.0,999,6.72272272272272
840,159,6.65833333333333,7.0,999,6.71271271271271
845,154,6.66153846153846,7.0,999,6.71371371371371
852,147,6.66784037558685,7.0,999,6.71671671671672
855,144,6.65730994152047,7.0,999,6.70670670670671
852,147,6.66079812206573,7.0,999,6.71071071071071
848,151,6.65801886792453,7.0,999,6.70970970970971
839,160,6.65792610250298,7.0,999,6.71271271271271
842,157,6.65320665083135,7.0,999,6.70770770770771
846,153,6.65366430260047,7.0,999,6.70670670670671
847,152,6.64935064935065,7.0,999,6.7027027027027
855,144,6.65029239766082,7.0,999,6.7007007007007
857,142,6.64527421236873,7.0,999,6.6956956956957
857,142,6.63477246207701,7.0,999,6.68668668668669
858,141,6.63752913752914,7.0,999,6.68868868868869
857,142,6.64527421236873,7.0,999,6.6956956956957
860,139,6.65,7.0,999,6.6986986986987
857,142,6.64994165694282,7.0,999,6.6996996996997
856,143,6.63434579439252,7.0,999,6.68668668668669
852,147,6.62793427230047,7.0,999,6.68268268268268
855,144,6.61637426900585,7.0,999,6.67167167167167
847,152,6.62219598583235,7.0,999,6.67967967967968
848,151,6.61320754716981,7.0,999,6.67167167167167
846,153,6.6193853427896,7.0,999,6.67767767767768
843,156,6.63345195729537,7.0,999,6.69069069069069
842,157,6.62945368171021,7.0,999,6.68768768768769
838,161,6.63723150357995,7.0,999,6.6956956956957
833,166,6.63145258103241,7.0,999,6.69269269269269
823,176,6.64277035236938,7.0,999,6.70570570570571
830,169,6.62289156626506,7.0,999,6.68668668668669
827,172,6.63119709794438,7.0,999,6.69469469469469
822,177,6.63625304136253,7.0,999,6.7007007007007
826,173,6.64891041162228,7.0,999,6.70970970970971
830,169,6.65542168674699,7.0,999,6.71371371371371
832,167,6.65504807692308,7.0,999,6.71271271271271
827,172,6.64933494558646,7.0,999,6.70970970970971
839,160,6.64481525625745,7.0,999,6.7017017017017
835,164,6.64910179640719,7.0,999,6.70670670670671
831,168,6.64981949458484,7.0,999,6.70870870870871
835,164,6.64431137724551,7.0,999,6.7027027027027
834,165,6.65107913669065,7.0,999,6.70870870870871
835,164,6.6502994011976,7.0,999,6.70770770770771
830,169,6.65180722891566,7.0,999,6.71071071071071
834,165,6.64748201438849,7.0,999,6.70570570570571
834,165,6.6462829736211,7.0,999,6.7047047047047
835,164,6.6562874251497,7.0,999,6.71271271271271
837,162,6.64994026284349,7.0,999,6.70670670670671
839,160,6.65435041716329,7.0,999,6.70970970970971
834,165,6.66426858513189,7.0,999,6.71971971971972
825,174,6.67030303030303,7.0,999,6.72772772772773
821,178,6.67113276492083,7.0,999,6.72972972972973
817,182,6.67441860465116,7.0,999,6.73373373373373
815,184,6.67484662576687,7.0,999,6.73473473473473
818,181,6.67970660146699,7.0,999,6.73773773773774
824,175,6.67961165048544,7.0,999,6.73573573573574
824,175,6.68932038834951,7.0,999,6.74374374374374
824,175,6.6881067961165,7.0,999,6.74274274274274
828,171,6.69927536231884,7.0,999,6.75075075075075
828,171,6.68961352657005,7.0,999,6.74274274274274
830,169,6.67951807228916,7.0,999,6.73373373373373
836,163,6.67224880382775,7.0,999,6.72572572572573
831,168,6.67027677496992,7.0,999,6.72572572572573
822,177,6.65936739659367,7.0,999,6.71971971971972
813,186,6.65682656826568,7.0,999,6.72072072072072
816,183,6.65686274509804,7.0,999,6.71971971971972
820,179,6.65,7.0,999,6.71271271271271
819,180,6.64590964590965,7.0,999,6.70970970970971
827,172,6.64691656590085,7.0,999,6.70770770770771
828,171,6.64009661835749,7.0,999,6.7017017017017
832,167,6.63942307692308,7.0,999,6.6996996996997
836,163,6.63038277511962,7.0,999,6.69069069069069
840,159,6.63333333333333,7.0,999,6.69169169169169
843,156,6.644128113879,7.0,999,6.6996996996997
845,154,6.64142011834319,7.0,999,6.6966966966967
844,155,6.64691943127962,7.0,999,6.7017017017017
843,156,6.64887307236062,7.0,999,6.7037037037037
846,153,6.64657210401891,7.0,999,6.7007007007007
852,147,6.64201877934272,7.0,999,6.69469469469469
853,146,6.62485345838218,7.0,999,6.67967967967968
854,145,6.61943793911007,7.0,999,6.67467467467467
854,145,6.62177985948478,7.0,999,6.67667667667668
861,138,6.62833914053426,7.0,999,6.67967967967968
859,140,6.63096623981374,7.0,999,6.68268268268268
854,145,6.6288056206089,7.0,999,6.68268268268268
853,146,6.62837045720985,7.0,999,6.68268268268268
856,143,6.63434579439252,7.0,999,6.68668668668669
862,137,6.63109048723898,7.0,999,6.68168168168168
858,141,6.62121212121212,7.0,999,6.67467467467467
858,141,6.62703962703963,7.0,999,6.67967967967968
858,141,6.63519813519814,7.0,999,6.68668668668669
868,131,6.62557603686636,7.0,999,6.67467467467467
871,128,6.6142365097589,7.0,999,6.66366366366366
873,126,6.60710194730813,7.0,999,6.65665665665666
874,125,6.61784897025172,7.0,999,6.66566566566567
874,125,6.60983981693364,7.0,999,6.65865865865866
875,124,6.616,7.0,999,6.66366366366366
872,127,6.61238532110092,7.0,999,6.66166166166166
876,123,6.61643835616438,7.0,999,6.66366366366366
872,127,6.62385321100917,7.0,999,6.67167167167167
874,125,6.61556064073227,7.0,999,6.66366366366366
876,123,6.61415525114155,7.0,999,6.66166166166166
874,125,6.60068649885584,7.0,999,6.65065065065065
869,130,6.59608745684695,7.0,999,6.64864864864865
875,124,6.59542857142857,7.0,999,6.64564564564565
873,126,6.59450171821306,7.0,999,6.64564564564565
868,131,6.58986175115207,7.0,999,6.64364364364364
872,127,6.60091743119266,7.0,999,6.65165165165165
872,127,6.59174311926605,7.0,999,6.64364364364364
872,127,6.59403669724771,7.0,999,6.64564564564565
866,133,6.59468822170901,7.0,999,6.64864864864865
869,130,6.58803222094361,7.0,999,6.64164164164164
869,130,6.58457997698504,7.0,999,6.63863863863864
868,131,6.59101382488479,7.0,999,6.64464464464464
865,134,6.6,7.0,999,6.65365365365365
869,130,6.58457997698504,7.0,999,6.63863863863864
868,131,6.58064516129032,7.0,999,6.63563563563564
864,135,6.58564814814815,7.0,999,6.64164164164164
864,135,6.58449074074074,7.0,999,6.64064064064064
861,138,6.57607433217189,7.0,999,6.63463463463463
863,136,6.58285052143685,7.0,999,6.63963963963964
863,136,6.58864426419467,7.0,999,6.64464464464464
856,143,6.59228971962617,7.0,999,6.65065065065065
861,138,6.57955865272938,7.0,999,6.63763763763764
866,133,6.5796766743649,7.0,999,6.63563563563564
860,139,6.57441860465116,7.0,999,6.63363363363363
860,139,6.56627906976744,7.0,999,6.62662662662663
856,143,6.55724299065421,7.0,999,6.62062062062062
859,140,6.57392316647264,7.0,999,6.63363363363363
867,132,6.56170703575548,7.0,999,6.61961961961962
866,133,6.5715935334873,7.0,999,6.62862862862863
870,129,6.57126436781609,7.0,999,6.62662662662663
874,125,6.56979405034325,7.0,999,6.62362362362362
878,121,6.57289293849658,7.0,999,6.62462462462462
874,125,6.56064073226545,7.0,999,6.61561561561562
877,122,6.58152793614595,7.0,999,6.63263263263263
876,123,6.57420091324201,7.0,999,6.62662662662663
877,122,6.58494868871152,7.0,999,6.63563563563564
884,115,6.5814479638009,7.0,999,6.62962962962963
876,123,6.57876712328767,7.0,999,6.63063063063063
867,132,6.58592848904268,7.0,999,6.64064064064064
868,131,6.5852534562212,7.0,999,6.63963963963964
879,120,6.59158134243458,7.0,999,6.64064064064064
879,120,6.58361774744027,7.0,999,6.63363363363363
883,116,6.58437146092865,7.0,999,6.63263263263263
887,112,6.58173618940248,7.0,999,6.62862862862863
888,111,6.5777027027027,7.0,999,6.62462462462462
884,115,6.5814479638009,7.0,999,6.62962962962963
874,125,6.57551487414188,7.0,999,6.62862862862863
879,120,6.57792946530148,7.0,999,6.62862862862863
878,121,6.5751708428246,7.0,999,6.62662662662663
879,120,6.57337883959044,7.0,999,6.62462462462462
883,116,6.58097395243488,7.0,999,6.62962962962963
877,122,6.5860889395667,7.0,999,6.63663663663664
874,125,6.58810068649886,7.0,999,6.63963963963964
877,122,6.5769669327252,7.0,999,6.62862862862863
888,111,6.57432432432432,7.0,999,6.62162162162162
893,106,6.55543113101904,7.0,999,6.6026026026026
892,107,6.57062780269058,7.0,999,6.61661661661662
888,111,6.57657657657658,7.0,999,6.62362362362362
887,112,6.59188275084555,7.0,999,6.63763763763764
888,111,6.58333333333333,7.0,999,6.62962962962963
881,118,6.57661748013621,7.0,999,6.62662662662663
879,120,6.57565415244596,7.0,999,6.62662662662663
882,117,6.56689342403628,7.0,999,6.61761761761762
881,118,6.57207718501703,7.0,999,6.62262262262262
884,115,6.57352941176471,7.0,999,6.62262262262262
879,120,6.56427758816837,7.0,999,6.61661661661662
878,121,6.56492027334852,7.0,999,6.61761761761762
882,117,6.5578231292517,7.0,999,6.60960960960961
888,111,6.56193693693694,7.0,999,6.61061061061061
889,110,6.55343082114736,7.0,999,6.6026026026026
892,107,6.56726457399103,7.0,999,6.61361361361361
886,113,6.58352144469526,7.0,999,6.63063063063063
884,115,6.57805429864253,7.0,999,6.62662662662663
884,115,6.57352941176471,7.0,999,6.62262262262262
887,112,6.58286358511838,7.0,999,6.62962962962963
887,112,6.58962795941375,7.0,999,6.63563563563564
888,111,6.59121621621622,7.0,999,6.63663663663664
892,107,6.59865470852018,7.0,999,6.64164164164164
894,105,6.6006711409396,7.0,999,6.64264264264264
890,109,6.59662921348315,7.0,999,6.64064064064064
887,112,6.59639233370913,7.0,999,6.64164164164164
884,115,6.59389140271493,7.0,999,6.64064064064064
885,114,6.58983050847458,7.0,999,6.63663663663664
886,113,6.58126410835214,7.0,999,6.62862862862863
878,121,6.58542141230068,7.0,999,6.63563563563564
877,122,6.57924743443558,7.0,999,6.63063063063063
874,125,6.57551487414188,7.0,999,6.62862862862863
871,128,6.5683122847302,7.0,999,6.62362362362362
861,138,6.56329849012776,7.0,999,6.62362362362362
869,130,6.57422324510932,7.0,999,6.62962962962963
871,128,6.5752009184845,7.0,999,6.62962962962963
868,131,6.58179723502304,7.0,999,6.63663663663664
875,124,6.58514285714286,7.0,999,6.63663663663664
883,116,6.58210645526614,7.0,999,6.63063063063063
887,112,6.57046223224352,7.0,999,6.61861861861862
884,115,6.56674208144796,7.0,999,6.61661661661662
882,117,6.56122448979592,7.0,999,6.61261261261261
884,115,6.55995475113122,7.0,999,6.61061061061061
881,118,6.55845629965948,7.0,999,6.61061061061061
885,114,6.54915254237288,7.0,999,6.6006006006006
886,113,6.55079006772009,7.0,999,6.6016016016016
884,115,6.54638009049774,7.0,999,6.5985985985986
873,126,6.54066437571592,7.0,999,6.5985985985986
874,125,6.53775743707094,7.0,999,6.5955955955956
875,124,6.54628571428571,7.0,999,6.6026026026026
875,124,6.55657142857143,7.0,999,6.61161161161161
875,124,6.55771428571429,7.0,999,6.61261261261261
869,130,6.56271576524741,7.0,999,6.61961961961962
864,135,6.5625,7.0,999,6.62162162162162
862,137,6.57308584686775,7.0,999,6.63163163163163
864,135,6.57523148148148,7.0,999,6.63263263263263
871,128,6.57060849598163,7.0,999,6.62562562562563
876,123,6.57191780821918,7.0,999,6.62462462462462
880,119,6.58068181818182,7.0,999,6.63063063063063
884,115,6.57466063348416,7.0,999,6.62362362362362
886,113,6.57336343115124,7.0,999,6.62162162162162
883,116,6.58210645526614,7.0,999,6.63063063063063
888,111,6.58220720720721,7.0,999,6.62862862862863
892,107,6.57847533632287,7.0,999,6.62362362362362
893,106,6.57334826427772,7.0,999,6.61861861861862
896,103,6.58035714285714,7.0,999,6.62362362362362
896,103,6.5703125,7.0,999,6.61461461461461
898,101,6.57683741648107,7.0,999,6.61961961961962
895,104,6.5854748603352,7.0,999,6.62862862862863
889,110,6.58042744656918,7.0,999,6.62662662662663
890,109,6.59325842696629,7.0,999,6.63763763763764
889,110,6.5793025871766,7.0,999,6.62562562562563
888,111,6.58558558558559,7.0,999,6.63163163163163
889,110,6.59617547806524,7.0,999,6.64064064064064
898,101,6.61469933184855,7.0,999,6.65365365365365
902,97,6.61086474501109,7.0,999,6.64864864864865
907,92,6.61631753031974,7.0,999,6.65165165165165
905,94,6.62872928176796,7.0,999,6.66366366366366
905,94,6.63204419889503,7.0,999,6.66666666666667
904,95,6.62942477876106,7.0,999,6.66466466466466
907,92,6.63506063947078,7.0,999,6.66866866866867
910,89,6.64175824175824,7.0,999,6.67367367367367
908,91,6.63215859030837,7.0,999,6.66566566566567
904,95,6.64269911504425,7.0,999,6.67667667667668
906,93,6.64459161147903,7.0,999,6.67767767767768
905,94,6.66077348066298,7.0,999,6.69269269269269
916,83,6.65720524017467,7.0,999,6.68568568568569
926,73,6.65874730021598,7.0,999,6.68368368368368
933,66,6.66452304394427,7.0,999,6.68668668668669
931,68,6.6702470461869,7.0,999,6.69269269269269
930,69,6.6752688172043,7.0,999,6.6976976976977
927,72,6.67745415318231,7.0,999,6.7007007007007
926,73,6.68466522678186,7.0,999,6.70770770770771
924,75,6.67857142857143,7.0,999,6.7027027027027
919,80,6.68008705114255,7.0,999,6.70570570570571
920,79,6.67934782608696,7.0,999,6.7047047047047
923,76,6.67280606717226,7.0,999,6.6976976976977
924,75,6.67532467532468,7.0,999,6.6996996996997
931,68,6.66702470461869,7.0,999,6.68968968968969
930,69,6.6741935483871,7.0,999,6.6966966966967
933,66,6.67631296891747,7.0,999,6.6976976976977
930,69,6.66451612903226,7.0,999,6.68768768768769
929,70,6.66738428417653,7.0,999,6.69069069069069
928,71,6.66702586206897,7.0,999,6.69069069069069
929,70,6.66630785791173,7.0,999,6.68968968968969
933,66,6.66452304394427,7.0,999,6.68668668668669
936,63,6.66346153846154,7.0,999,6.68468468468468
934,65,6.65952890792291,7.0,999,6.68168168168168
932,67,6.65557939914163,7.0,999,6.67867867867868
930,69,6.64086021505376,7.0,999,6.66566566566567
935,64,6.6524064171123,7.0,999,6.67467467467467
935,64,6.64598930481283,7.0,999,6.66866866866867
931,68,6.64661654135338,7.0,999,6.67067067067067
927,72,6.64832793959008,7.0,999,6.67367367367367
927,72,6.65587918015102,7.0,999,6.68068068068068
928,71,6.6551724137931,7.0,999,6.67967967967968
929,70,6.65984930032293,7.0,999,6.68368368368368
929,70,6.65231431646932,7.0,999,6.67667667667668
928,71,6.64762931034483,7.0,999,6.67267267267267
924,75,6.65476190476191,7.0,999,6.68068068068068
928,71,6.65409482758621,7.0,999,6.67867867867868
921,78,6.64929424538545,7.0,999,6.67667667667668
923,76,6.65113759479957,7.0,999,6.67767767767768
920,79,6.66847826086957,7.0,999,6.69469469469469
920,79,6.67282608695652,7.0,999,6.6986986986987
920,79,6.66413043478261,7.0,999,6.69069069069069
922,77,6.65835140997831,7.0,999,6.68468468468468
924,75,6.65692640692641,7.0,999,6.68268268268268
924,75,6.6504329004329,7.0,999,6.67667667667668
924,75,6.64502164502164,7.0,999,6.67167167167167
926,73,6.65550755939525,7.0,999,6.68068068068068
916,83,6.65393013100437,7.0,999,6.68268268268268
915,84,6.65792349726776,7.0,999,6.68668668668669
917,82,6.65321701199564,7.0,999,6.68168168168168
918,81,6.65250544662309,7.0,999,6.68068068068068
914,85,6.66411378555799,7.0,999,6.69269269269269
914,85,6.64113785557987,7.0,999,6.67167167167167
911,88,6.6443468715697,7.0,999,6.67567567567568
916,83,6.64519650655022,7.0,999,6.67467467467467
914,85,6.64879649890591,7.0,999,6.67867867867868
911,88,6.64654226125137,7.0,999,6.67767767767768
911,88,6.64544456641054,7.0,999,6.67667667667668
908,91,6.65198237885463,7.0,999,6.68368368368368
912,87,6.65241228070175,7.0,999,6.68268268268268
912,87,6.65021929824561,7.0,999,6.68068068068068
906,93,6.65894039735099,7.0,999,6.69069069069069
907,92,6.65821389195149,7.0,999,6.68968968968969
908,91,6.66409691629956,7.0,999,6.69469469469469
909,90,6.66886688668867,7.0,999,6.6986986986987
906,93,6.67549668874172,7.0,999,6.70570570570571
900,99,6.66444444444444,7.0,999,6.6976976976977
897,102,6.64659977703456,7.0,999,6.68268268268268
894,105,6.65324384787472,7.0,999,6.68968968968969
898,101,6.66146993318486,7.0,999,6.6956956956957
891,108,6.662177328844,7.0,999,6.6986986986987
897,102,6.66220735785953,7.0,999,6.6966966966967
902,97,6.65853658536585,7.0,999,6.69169169169169
908,91,6.65859030837004,7.0,999,6.68968968968969
910,89,6.64395604395604,7.0,999,6.67567567567568
908,91,6.64096916299559,7.0,999,6.67367367367367
900,99,6.64555555555556,7.0,999,6.68068068068068
899,100,6.6496106785317,7.0,999,6.68468468468468
901,98,6.66037735849057,7.0,999,6.69369369369369
900,99,6.65666666666667,7.0,999,6.69069069069069
898,101,6.65144766146993,7.0,999,6.68668668668669
893,106,6.64837625979843,7.0,999,6.68568568568569
892,107,6.65022421524664,7.0,999,6.68768768768769
891,108,6.66105499438833,7.0,999,6.6976976976977
894,105,6.65436241610738,7.0,999,6.69069069069069
890,109,6.65955056179775,7.0,999,6.6966966966967
888,111,6.65202702702703,7.0,999,6.69069069069069
883,116,6.64099660249151,7.0,999,6.68268268268268
877,122,6.63511972633979,7.0,999,6.67967967967968
885,114,6.6361581920904,7.0,999,6.67767767767768
890,109,6.62921348314607,7.0,999,6.66966966966967
890,109,6.64044943820225,7.0,999,6.67967967967968
893,106,6.63941769316909,7.0,999,6.67767767767768
897,102,6.62764771460424,7.0,999,6.66566566566567
899,100,6.62847608453838,7.0,999,6.66566566566567
893,106,6.62821948488242,7.0,999,6.66766766766767
893,106,6.63045912653975,7.0,999,6.66966966966967
897,102,6.62764771460424,7.0,999,6.66566566566567
893,106,6.63605823068309,7.0,999,6.67467467467467
900,99,6.64777777777778,7.0,999,6.68268268268268
903,96,6.64562569213732,7.0,999,6.67967967967968
898,101,6.63363028953229,7.0,999,6.67067067067067
897,102,6.64102564102564,7.0,999,6.67767767767768
897,102,6.63768115942029,7.0,999,6.67467467467467
898,101,6.64476614699332,7.0,999,6.68068068068068
894,105,6.64988814317673,7.0,999,6.68668668668669
906,93,6.65342163355408,7.0,999,6.68568568568569
906,93,6.65121412803532,7.0,999,6.68368368368368
905,94,6.65303867403315,7.0,999,6.68568568568569
907,92,6.65270121278942,7.0,999,6.68468468468468
902,97,6.6529933481153,7.0,999,6.68668668668669
901,98,6.64483906770255,7.0,999,6.67967967967968
898,101,6.64031180400891,7.0,999,6.67667667667668
901,98,6.65371809100999,7.0,999,6.68768768768769
903,96,6.66666666666667,7.0,999,6.6986986986987
899,100,6.66629588431591,7.0,999,6.6996996996997
904,95,6.67256637168142,7.0,999,6.7037037037037
905,94,6.67182320441989,7.0,999,6.7027027027027
905,94,6.67513812154696,7.0,999,6.70570570570571
908,91,6.68171806167401,7.0,999,6.71071071071071
906,93,6.6766004415011,7.0,999,6.70670670670671
908,91,6.67400881057269,7.0,999,6.7037037037037
909,90,6.68646864686469,7.0,999,6.71471471471471
914,85,6.67943107221007,7.0,999,6.70670670670671
916,83,6.68449781659389,7.0,999,6.71071071071071
919,80,6.68117519042437,7.0,999,6.70670670670671
924,75,6.6969696969697,7.0,999,6.71971971971972
926,73,6.70086393088553,7.0,999,6.72272272272272
929,70,6.69752421959096,7.0,999,6.71871871871872
926,73,6.69114470842333,7.0,999,6.71371371371371
923,76,6.67497291440953,7.0,999,6.6996996996997
925,74,6.67675675675676,7.0,999,6.7007007007007
926,73,6.6695464362851,7.0,999,6.69369369369369
926,73,6.6792656587473,7.0,999,6.7027027027027
925,74,6.67891891891892,7.0,999,6.7027027027027
929,70,6.68353067814855,7.0,999,6.70570570570571
931,68,6.68958109559613,7.0,999,6.71071071071071
932,67,6.6931330472103,7.0,999,6.71371371371371
930,69,6.69677419354839,7.0,999,6.71771771771772
933,66,6.68917470525188,7.0,999,6.70970970970971
933,66,6.69346195069668,7.0,999,6.71371371371371
928,71,6.68534482758621,7.0,999,6.70770770770771
929,70,6.68998923573735,7.0,999,6.71171171171171
925,74,6.69189189189189,7.0,999,6.71471471471471
928,71,6.69612068965517,7.0,999,6.71771771771772
934,65,6.67987152034261,7.0,999,6.7007007007007
935,64,6.68021390374332,7.0,999,6.7007007007007
932,67,6.67918454935622,7.0,999,6.7007007007007
932,67,6.67489270386266,7.0,999,6.6966966966967
932,67,6.66952789699571,7.0,999,6.69169169169169
930,69,6.66236559139785,7.0,999,6.68568568568569
934,65,6.65738758029979,7.0,999,6.67967967967968
938,61,6.65138592750533,7.0,999,6.67267267267267
941,58,6.65249734325186,7.0,999,6.67267267267267
938,61,6.65138592750533,7.0,999,6.67267267267267
940,59,6.6436170212766,7.0,999,6.66466466466466
935,64,6.6331550802139,7.0,999,6.65665665665666
937,62,6.63927427961579,7.0,999,6.66166166166166
941,58,6.6461211477152,7.0,999,6.66666666666667
938,61,6.6407249466951,7.0,999,6.66266266266266
934,65,6.65203426124197,7.0,999,6.67467467467467
933,66,6.66345123258307,7.0,999,6.68568568568569
932,67,6.65021459227468,7.0,999,6.67367367367367
933,66,6.64523043944266,7.0,999,6.66866866866867
932,67,6.65128755364807,7.0,999,6.67467467467467
931,68,6.65413533834586,7.0,999,6.67767767767768
930,69,6.65161290322581,7.0,999,6.67567567567568
925,74,6.64324324324324,7.0,999,6.66966966966967
917,82,6.64449291166848,7.0,999,6.67367367367367
919,80,6.63329706202394,7.0,999,6.66266266266266
922,77,6.63774403470716,7.0,999,6.66566566566567
925,74,6.64648648648649,7.0,999,6.67267267267267
922,77,6.64316702819957,7.0,999,6.67067067067067
922,77,6.64533622559653,7.0,999,6.67267267267267
925,74,6.64,7.0,999,6.66666666666667
921,78,6.64495114006515,7.0,999,6.67267267267267
923,76,6.65005417118093,7.0,999,6.67667667667668
923,76,6.64788732394366,7.0,999,6.67467467467467
921,78,6.65363735070575,7.0,999,6.68068068068068
923,76,6.6489707475623,7.0,999,6.67567567567568
923,76,6.64355362946912,7.0,999,6.67067067067067
924,75,6.64718614718615,7.0,999,6.67367367367367
915,84,6.64699453551913,7.0,999,6.67667667667668
917,82,6.64885496183206,7.0,999,6.67767767767768
914,85,6.63566739606127,7.0,999,6.66666666666667
911,88,6.63995609220637,7.0,999,6.67167167167167
907,92,6.64498346196251,7.0,999,6.67767767767768
910,89,6.63296703296703,7.0,999,6.66566566566567
910,89,6.64285714285714,7.0,999,6.67467467467467
910,89,6.65274725274725,7.0,999,6.68368368368368
915,84,6.66229508196721,7.0,999,6.69069069069069
920,79,6.67065217391304,7.0,999,6.6966966966967
927,72,6.67098166127292,7.0,999,6.69469469469469
921,78,6.68186753528773,7.0,999,6.70670670670671
917,82,6.67611777535442,7.0,999,6.7027027027027
910,89,6.68131868131868,7.0,999,6.70970970970971
915,84,6.68852459016393,7.0,999,6.71471471471471
920,79,6.69673913043478,7.0,999,6.72072072072072
924,75,6.69588744588745,7.0,999,6.71871871871872
931,68,6.69280343716434,7.0,999,6.71371371371371
929,70,6.69860064585576,7.0,999,6.71971971971972
931,68,6.69602577873255,7.0,999,6.71671671671672
928,71,6.69181034482759,7.0,999,6.71371371371371
929,70,6.68891280947255,7.0,999,6.71071071071071
926,73,6.68142548596112,7.0,999,6.7047047047047
930,69,6.67956989247312,7.0,999,6.7017017017017
928,71,6.68318965517241,6.98591549295775,999,6.7047047047047
928,71,6.68965517241379,6.98591549295775,999,6.71071071071071
925,74,6.68972972972973,6.98648648648649,999,6.71171171171171
917,82,6.6979280261723,6.98780487804878,999,6.72172172172172
915,84,6.69071038251366,6.98809523809524,999,6.71571571571572
912,87,6.68530701754386,6.97701149425287,999,6.71071071071071
921,78,6.68186753528773,6.98717948717949,999,6.70570570570571
929,70,6.69106566200215,6.98571428571429,999,6.71171171171171
928,71,6.69396551724138,7.0,999,6.71571571571572
929,70,6.67707212055974,7.0,999,6.6996996996997
920,79,6.68260869565217,7.0,999,6.70770770770771
922,77,6.69305856832972,7.0,999,6.71671671671672
927,72,6.69687162891046,7.0,999,6.71871871871872
928,71,6.68534482758621,7.0,999,6.70770770770771
932,67,6.6824034334764,7.0,999,6.7037037037037
927,72,6.68716289104639,7.0,999,6.70970970970971
927,72,6.69147788565264,7.0,999,6.71371371371371
925,74,6.69837837837838,7.0,999,6.72072072072072
924,75,6.69588744588745,7.0,999,6.71871871871872
923,76,6.69230769230769,7.0,999,6.71571571571572
920,79,6.7,7.0,999,6.72372372372372
924,75,6.71753246753247,7.0,999,6.73873873873874
927,72,6.72060409924488,7.0,999,6.74074074074074
933,66,6.72025723472669,7.0,999,6.73873873873874
933,66,6.71811361200429,7.0,999,6.73673673673674
934,65,6.71734475374732,7.0,999,6.73573573573574
935,64,6.71550802139037,7.0,999,6.73373373373373
935,64,6.7144385026738,7.0,999,6.73273273273273
937,62,6.71824973319104,7.0,999,6.73573573573574
934,65,6.71306209850107,7.0,999,6.73173173173173
925,74,6.71891891891892,7.0,999,6.73973973973974
922,77,6.71908893709328,7.0,999,6.74074074074074
927,72,6.73031283710895,7.0,999,6.74974974974975
928,71,6.72413793103448,7.0,999,6.74374374374374
929,70,6.72766415500538,7.0,999,6.74674674674675
929,70,6.72551130247578,7.0,999,6.74474474474474
931,68,6.73147153598281,7.0,999,6.74974974974975
927,72,6.73031283710895,7.0,999,6.74974974974975
926,73,6.7354211663067,7.0,999,6.75475475475475
922,77,6.74295010845987,7.0,999,6.76276276276276
920,79,6.73586956521739,7.0,999,6.75675675675676
921,78,6.74267100977199,7.0,999,6.76276276276276
926,73,6.73974082073434,7.0,999,6.75875875875876
926,73,6.73002159827214,7.0,999,6.74974974974975
923,76,6.73781148429036,7.0,999,6.75775775775776
925,74,6.73513513513513,7.0,999,6.75475475475475
925,74,6.74054054054054,7.0,999,6.75975975975976
926,73,6.73326133909287,7.0,999,6.75275275275275
930,69,6.74193548387097,7.0,999,6.75975975975976
922,77,6.73644251626898,7.0,999,6.75675675675676
917,82,6.74482006543075,7.0,999,6.76576576576577
916,83,6.74235807860262,7.0,999,6.76376376376376
920,79,6.74347826086957,7.0,999,6.76376376376376
921,78,6.73724212812161,7.0,999,6.75775775775776
925,74,6.72648648648649,7.0,999,6.74674674674675
931,68,6.73254564983888,7.0,999,6.75075075075075
932,67,6.73175965665236,7.0,999,6.74974974974975
935,64,6.7379679144385,7.0,999,6.75475475475475
937,62,6.73319103521878,7.0,999,6.74974974974975
937,62,6.74279615795091,7.0,999,6.75875875875876
934,65,6.74625267665953,7.0,999,6.76276276276276
934,65,6.74089935760171,7.0,999,6.75775775775776
932,67,6.75429184549356,7.0,999,6.77077077077077
931,68,6.74650912996778,7.0,999,6.76376376376376
928,71,6.75323275862069,7.0,999,6.77077077077077
927,72,6.75512405609493,7.0,999,6.77277277277277
924,75,6.74891774891775,7.0,999,6.76776776776777
921,78,6.74918566775244,7.0,999,6.76876876876877
924,75,6.74458874458874,7.0,999,6.76376376376376
928,71,6.75431034482759,7.0,999,6.77177177177177
926,73,6.75053995680346,7.0,999,6.76876876876877
925,74,6.75027027027027,7.0,999,6.76876876876877
923,76,6.74756229685807,7.0,999,6.76676676676677
923,76,6.74972914409534,7.0,999,6.76876876876877
929,70,6.75780409041981,7.0,999,6.77477477477477
933,66,6.7470525187567,7.0,999,6.76376376376376
933,66,6.7556270096463,7.0,999,6.77177177177177
936,63,6.76495726495726,7.0,999,6.77977977977978
943,56,6.76882290562036,7.0,999,6.78178178178178
941,58,6.7672688629118,7.0,999,6.78078078078078
941,58,6.75982996811902,7.0,999,6.77377377377377
938,61,6.76865671641791,7.0,999,6.78278278278278
941,58,6.76939426142402,7.0,999,6.78278278278278
940,59,6.77340425531915,7.0,999,6.78678678678679
936,63,6.78098290598291,7.0,999,6.79479479479479
941,58,6.77470775770457,7.0,999,6.78778778778779
935,64,6.7668449197861,7.0,999,6.78178178178178
937,62,6.77588046958378,7.0,999,6.78978978978979
942,57,6.76539278131635,7.0,999,6.77877877877878
936,63,6.76709401709402,7.0,999,6.78178178178178
934,65,6.76231263383298,7.0,999,6.77777777777778
936,63,6.76282051282051,7.0,999,6.77777777777778
936,63,6.76709401709402,7.0,999,6.78178178178178
938,61,6.76439232409382,7.0,999,6.77877877877878
949,50,6.75974710221286,7.0,999,6.77177177177177
951,48,6.75289169295478,7.0,999,6.76476476476476
952,47,6.74894957983193,7.0,999,6.76076076076076
948,51,6.75632911392405,7.0,999,6.76876876876877
948,51,6.75738396624473,7.0,999,6.76976976976977
948,51,6.75949367088608,7.0,999,6.77177177177177
947,52,6.76135163674762,7.0,999,6.77377377377377
951,48,6.76340694006309,7.0,999,6.77477477477477
952,47,6.75735294117647,7.0,999,6.76876876876877
952,47,6.75840336134454,7.0,999,6.76976976976977
950,49,6.76421052631579,7.0,999,6.77577577577578
948,51,6.76793248945148,7.0,999,6.77977977977978
948,51,6.76898734177215,7.0,999,6.78078078078078
948,51,6.76054852320675,7.0,999,6.77277277277277
946,53,6.7600422832981,7.0,999,6.77277277277277
948,51,6.76898734177215,7.0,999,6.78078078078078
952,47,6.77415966386555,7.0,999,6.78478478478478
954,45,6.77987421383648,7.0,999,6.78978978978979
954,45,6.77777777777778,7.0,999,6.78778778778779
953,46,6.77964323189927,7.0,999,6.78978978978979
952,47,6.77731092436975,7.0,999,6.78778778778779
953,46,6.78174186778594,7.0,999,6.79179179179179
955,44,6.76753926701571,7.0,999,6.77777777777778
955,44,6.7696335078534,7.0,999,6.77977977977978
959,40,6.76955161626694,7.0,999,6.77877877877878
957,42,6.76489028213166,7.0,999,6.77477477477477
957,42,6.76593521421108,7.0,999,6.77577577577578
955,44,6.77486910994764,7.0,999,6.78478478478478
959,40,6.77267987486966,7.0,999,6.78178178178178
958,41,6.76722338204593,7.0,999,6.77677677677678
958,41,6.77244258872651,7.0,999,6.78178178178178
957,42,6.77115987460815,7.0,999,6.78078078078078
954,45,6.77044025157233,7.0,999,6.78078078078078
955,44,6.75916230366492,7.0,999,6.76976976976977
951,48,6.76130389064143,7.0,999,6.77277277277277
954,45,6.76729559748428,7.0,999,6.77777777777778
951,48,6.77287066246057,7.0,999,6.78378378378378
952,47,6.78046218487395,7.0,999,6.79079079079079
952,47,6.77100840336134,7.0,999,6.78178178178178
950,49,6.76631578947368,7.0,999,6.77777777777778
953,46,6.76390346274921,7.0,999,6.77477477477477
954,45,6.76624737945493,7.0,999,6.77677677677678
956,43,6.76778242677824,7.0,999,6.77777777777778
954,45,6.76415094339623,7.0,999,6.77477477477477
955,44,6.76753926701571,7.0,999,6.77777777777778
953,46,6.76600209863589,7.0,999,6.77677677677678
949,50,6.77239199157007,7.0,999,6.78378378378378
950,49,6.77263157894737,7.0,999,6.78378378378378
948,51,6.77320675105485,7.0,999,6.78478478478478
949,50,6.7650158061117,7.0,999,6.77677677677678
952,47,6.76575630252101,7.0,999,6.77677677677678
955,44,6.77068062827225,7.0,999,6.78078078078078
953,46,6.77124868835257,7.0,999,6.78178178178178
953,46,6.7806925498426,7.0,999,6.79079079079079
954,45,6.78721174004193,7.0,999,6.7967967967968
959,40,6.78727841501564,7.0,999,6.7957957957958
957,42,6.77533960292581,7.0,999,6.78478478478478
958,41,6.78496868475992,7.0,999,6.79379379379379
956,43,6.78451882845188,7.0,999,6.79379379379379
958,41,6.77974947807933,7.0,999,6.78878878878879
952,47,6.77626050420168,7.0,999,6.78678678678679
953,46,6.79013641133263,7.0,999,6.7997997997998
953,46,6.78174186778594,7.0,999,6.79179179179179
956,43,6.76987447698745,7.0,999,6.77977977977978
955,44,6.78743455497382,7.0,999,6.7967967967968
959,40,6.78936392075078,7.0,999,6.7977977977978
960,39,6.79166666666667,7.0,999,6.7997997997998
956,43,6.78765690376569,7.0,999,6.7967967967968
958,41,6.79331941544885,7.0,999,6.8018018018018
958,41,6.78914405010438,7.0,999,6.7977977977978
955,44,6.78848167539267,7.0,999,6.7977977977978
959,40,6.79666319082378,7.0,999,6.8048048048048
957,42,6.78996865203762,7.0,999,6.7987987987988
954,45,6.79874213836478,7.0,999,6.80780780780781
957,42,6.79832810867294,7.0,999,6.80680680680681
953,46,6.80587618048269,7.0,999,6.81481481481481
955,44,6.79476439790576,7.0,999,6.8038038038038
958,41,6.79853862212944,7.0,999,6.80680680680681
961,38,6.80332986472425,7.0,999,6.81081081081081
955,44,6.7979057591623,7.0,999,6.80680680680681
957,42,6.79519331243469,7.0,999,6.8038038038038
958,41,6.79749478079332,7.0,999,6.80580580580581
962,37,6.79417879417879,7.0,999,6.8018018018018
961,38,6.79292403746098,7.0,999,6.8008008008008
964,35,6.80601659751037,7.0,999,6.81281281281281
964,35,6.8143153526971,7.0,999,6.82082082082082
961,38,6.80957336108221,7.0,999,6.81681681681682
963,36,6.81516095534787,7.0,999,6.82182182182182
964,35,6.81639004149378,7.0,999,6.82282282282282
964,35,6.81846473029046,7.0,999,6.82482482482482
965,34,6.80310880829016,7.0,999,6.80980980980981
967,32,6.8076525336091,7.0,999,6.81381381381381
968,31,6.8047520661157,7.0,999,6.81081081081081
972,27,6.78909465020576,7.0,999,6.79479479479479
971,28,6.79505664263646,7.0,999,6.8008008008008
970,29,6.7979381443299,7.0,999,6.8038038038038
966,33,6.79399585921325,7.0,999,6.8008008008008
970,29,6.7979381443299,7.0,999,6.8038038038038
966,33,6.80331262939959,7.0,999,6.80980980980981
962,37,6.79417879417879,7.0,999,6.8018018018018
962,37,6.7993762993763,7.0,999,6.80680680680681
964,35,6.79668049792531,7.0,999,6.8038038038038
965,34,6.79689119170984,7.0,999,6.8038038038038
969,30,6.79463364293086,7.0,999,6.8008008008008
972,27,6.80041152263374,7.0,999,6.80580580580581
968,31,6.79545454545455,7.0,999,6.8018018018018
968,31,6.78409090909091,7.0,999,6.79079079079079
969,30,6.79256965944272,7.0,999,6.7987987987988
962,37,6.79313929313929,7.0,999,6.8008008008008
963,36,6.79127725856698,7.0,999,6.7987987987988
963,36,6.79127725856698,7.0,999,6.7987987987988
965,34,6.78756476683938,7.0,999,6.79479479479479
970,29,6.77938144329897,7.0,999,6.78578578578579
972,27,6.77777777777778,7.0,999,6.78378378378378
970,29,6.78247422680412,7.0,999,6.78878878878879
971,28,6.78887744593203,7.0,999,6.79479479479479
969,30,6.78740970072239,7.0,999,6.79379379379379
971,28,6.77960865087539,7.0,999,6.78578578578579
969,30,6.7843137254902,7.0,999,6.79079079079079
967,32,6.78593588417787,7.0,999,6.79279279279279
969,30,6.79050567595459,7.0,999,6.7967967967968
968,31,6.78409090909091,7.0,999,6.79079079079079
965,34,6.79274611398964,7.0,999,6.7997997997998
968,31,6.79235537190083,7.0,999,6.7987987987988
969,30,6.79360165118679,7.0,999,6.7997997997998
967,32,6.79317476732161,7.0,999,6.7997997997998
963,36,6.79958463136033,7.0,999,6.80680680680681
962,37,6.79313929313929,7.0,999,6.8008008008008
961,38,6.789802289282,7.0,999,6.7977977977978
962,37,6.78690228690229,7.0,999,6.79479479479479
966,33,6.78260869565217,7.0,999,6.78978978978979
967,32,6.78697001034126,7.0,999,6.79379379379379
965,34,6.78756476683938,7.0,999,6.79479479479479
964,35,6.79564315352697,7.0,999,6.8028028028028
962,37,6.79002079002079,7.0,999,6.7977977977978
962,37,6.8004158004158,7.0,999,6.80780780780781
960,39,6.796875,7.0,999,6.8048048048048
960,39,6.80416666666667,7.0,999,6.81181181181181
963,36,6.80477673935618,7.0,999,6.81181181181181
963,36,6.80789200415369,7.0,999,6.81481481481481
964,35,6.79875518672199,7.0,999,6.80580580580581
968,31,6.79442148760331,7.0,999,6.8008008008008
967,32,6.79110651499483,7.0,999,6.7977977977978
965,34,6.78238341968912,7.0,999,6.78978978978979
969,30,6.79050567595459,7.0,999,6.7967967967968
969,30,6.78947368421053,7.0,999,6.7957957957958
968,31,6.78202479338843,7.0,999,6.78878878878879
969,30,6.78637770897833,7.0,999,6.79279279279279
966,33,6.79192546583851,7.0,999,6.7987987987988
967,32,6.79214064115822,7.0,999,6.7987987987988
967,32,6.78697001034126,7.0,999,6.79379379379379
966,33,6.79192546583851,7.0,999,6.7987987987988
965,34,6.78652849740933,7.0,999,6.79379379379379
961,38,6.7741935483871,7.0,999,6.78278278278278
961,38,6.78772112382934,7.0,999,6.7957957957958
962,37,6.78794178794179,7.0,999,6.7957957957958
962,37,6.78274428274428,7.0,999,6.79079079079079
965,34,6.77616580310881,7.0,999,6.78378378378378
966,33,6.78674948240166,7.0,999,6.79379379379379
967,32,6.79007238883144,7.0,999,6.7967967967968
965,34,6.79274611398964,7.0,999,6.7997997997998
965,34,6.7979274611399,7.0,999,6.8048048048048
964,35,6.79356846473029,7.0,999,6.8008008008008
966,33,6.79813664596273,7.0,999,6.8048048048048
963,36,6.79543094496366,7.0,999,6.8028028028028
964,35,6.78526970954357,7.0,999,6.79279279279279
965,34,6.78860103626943,7.0,999,6.7957957957958
965,34,6.79170984455959,7.0,999,6.7987987987988
963,36,6.79127725856698,7.0,999,6.7987987987988
964,35,6.78319502074689,7.0,999,6.79079079079079
965,34,6.79067357512953,7.0,999,6.7977977977978
968,31,6.79855371900826,7.0,999,6.8048048048048
967,32,6.79214064115822,7.0,999,6.7987987987988
966,33,6.78571428571429,7.0,999,6.79279279279279
967,32,6.78697001034126,7.0,999,6.79379379379379
967,32,6.78076525336091,7.0,999,6.78778778778779
965,34,6.77616580310881,7.0,999,6.78378378378378
964,35,6.77697095435685,7.0,999,6.78478478478478
968,31,6.78615702479339,7.0,999,6.79279279279279
969,30,6.7781217750258,7.0,999,6.78478478478478
969,30,6.78018575851393,7.0,999,6.78678678678679
970,29,6.78350515463918,7.0,999,6.78978978978979
966,33,6.7815734989648,7.0,999,6.78878878878879
964,35,6.78526970954357,7.0,999,6.79279279279279
967,32,6.79214064115822,7.0,999,6.7987987987988
971,28,6.79196704428424,7.0,999,6.7977977977978
966,33,6.78364389233954,7.0,999,6.79079079079079
971,28,6.7816683831102,7.0,999,6.78778778778779
971,28,6.78372811534501,7.0,999,6.78978978978979
974,25,6.77515400410678,7.0,999,6.78078078078078
975,24,6.77025641025641,7.0,999,6.77577577577578
975,24,6.76820512820513,7.0,999,6.77377377377377
975,24,6.77025641025641,7.0,999,6.77577577577578
975,24,6.77333333333333,7.0,999,6.77877877877878
976,23,6.77868852459016,7.0,999,6.78378378378378
976,23,6.78381147540984,7.0,999,6.78878878878879
974,25,6.78336755646817,7.0,999,6.78878878878879
977,22,6.79017400204708,7.0,999,6.79479479479479
977,22,6.7942681678608,7.0,999,6.7987987987988
976,23,6.79200819672131,7.0,999,6.7967967967968
975,24,6.78871794871795,7.0,999,6.79379379379379
977,22,6.79119754350051,7.0,999,6.7957957957958
977,22,6.78915046059365,7.0,999,6.79379379379379
976,23,6.77868852459016,7.0,999,6.78378378378378
976,23,6.77459016393443,7.0,999,6.77977977977978
975,24,6.77641025641026,7.0,999,6.78178178178178
973,26,6.77492291880781,7.0,999,6.78078078078078
975,24,6.78564102564103,7.0,999,6.79079079079079
979,20,6.78855975485189,7.0,999,6.79279279279279
978,21,6.79345603271984,7.0,999,6.7977977977978
978,21,6.78425357873211,7.0,999,6.78878878878879
981,18,6.79001019367992,7.0,999,6.79379379379379
974,25,6.78336755646817,7.0,999,6.78878878878879
974,25,6.7864476386037,7.0,999,6.79179179179179
974,25,6.78439425051335,7.0,999,6.78978978978979
977,22,6.78300921187308,7.0,999,6.78778778778779
977,22,6.78300921187308,7.0,999,6.78778778778779
977,22,6.78505629477994,7.0,999,6.78978978978979
979,20,6.7906026557712,7.0,999,6.79479479479479
975,24,6.78461538461538,7.0,999,6.78978978978979
977,22,6.7871033776868,7.0,999,6.79179179179179
977,22,6.77789150460594,7.0,999,6.78278278278278
979,20,6.77834525025536,7.0,999,6.78278278278278
978,21,6.77811860940695,7.0,999,6.78278278278278
979,20,6.76915219611849,7.0,999,6.77377377377377
980,19,6.77857142857143,7.0,999,6.78278278278278
979,20,6.77425944841675,7.0,999,6.77877877877878
979,20,6.7752808988764,7.0,999,6.77977977977978
978,21,6.77914110429448,7.0,999,6.78378378378378
980,19,6.78469387755102,7.0,999,6.78878878878879
978,21,6.79038854805726,7.0,999,6.79479479479479
977,22,6.79222108495394,7.0,999,6.7967967967968
973,26,6.78211716341213,7.0,999,6.78778778778779
973,26,6.77492291880781,7.0,999,6.78078078078078
973,26,6.76978417266187,7.0,999,6.77577577577578
973,26,6.775950668037,7.0,999,6.78178178178178
975,24,6.77025641025641,7.0,999,6.77577577577578
976,23,6.7766393442623,7.0,999,6.78178178178178
976,23,6.77254098360656,7.0,999,6.77777777777778
973,26,6.77800616649538,7.0,999,6.78378378378378
972,27,6.78395061728395,7.0,999,6.78978978978979
970,29,6.78041237113402,7.0,999,6.78678678678679
967,32,6.78800413650465,7.0,999,6.79479479479479
968,31,6.79132231404959,7.0,999,6.7977977977978
968,31,6.78615702479339,7.0,999,6.79279279279279
968,31,6.78822314049587,7.0,999,6.79479479479479
965,34,6.79585492227979,7.0,999,6.8028028028028
967,32,6.79110651499483,7.0,999,6.7977977977978
969,30,6.78534571723426,7.0,999,6.79179179179179
968,31,6.77789256198347,7.0,999,6.78478478478478
970,29,6.78453608247423,7.0,999,6.79079079079079
967,32,6.78490175801448,7.0,999,6.79179179179179
965,34,6.79378238341969,7.0,999,6.8008008008008
964,35,6.78838174273859,7.0,999,6.7957957957958
967,32,6.78283350568769,7.0,999,6.78978978978979
968,31,6.77685950413223,7.0,999,6.78378378378378
971,28,6.78063851699279,7.0,999,6.78678678678679
972,27,6.7880658436214,7.0,999,6.79379379379379
973,26,6.78828365878726,7.0,999,6.79379379379379
973,26,6.78211716341213,7.0,999,6.78778778778779
969,30,6.7843137254902,7.0,999,6.79079079079079
974,25,6.78131416837782,7.0,999,6.78678678678679
972,27,6.78497942386831,7.0,999,6.79079079079079
972,27,6.78703703703704,7.0,999,6.79279279279279
973,26,6.78314491264132,7.0,999,6.78878878878879
973,26,6.78211716341213,7.0,999,6.78778778778779
975,24,6.78666666666667,7.0,999,6.79179179179179
972,27,6.78909465020576,7.0,999,6.79479479479479
972,27,6.77777777777778,7.0,999,6.78378378378378
970,29,6.78659793814433,7.0,999,6.79279279279279
973,26,6.78725590955807,7.0,999,6.79279279279279
973,26,6.77903391572456,7.0,999,6.78478478478478
975,24,6.78461538461538,7.0,999,6.78978978978979
975,24,6.78974358974359,7.0,999,6.79479479479479
973,26,6.79239465570401,7.0,999,6.7977977977978
976,23,6.78688524590164,7.0,999,6.79179179179179
974,25,6.7782340862423,7.0,999,6.78378378378378
976,23,6.77766393442623,7.0,999,6.78278278278278
977,22,6.78198567041965,7.0,999,6.78678678678679
977,22,6.78505629477994,7.0,999,6.78978978978979
978,21,6.78834355828221,7.0,999,6.79279279279279
979,20,6.7906026557712,7.0,999,6.79479479479479
979,20,6.78345250255363,7.0,999,6.78778778778779
978,21,6.78118609406953,7.0,999,6.78578578578579
980,19,6.7765306122449,7.0,999,6.78078078078078
983,16,6.7853509664293,7.0,999,6.78878878878879
986,13,6.78904665314402,7.0,999,6.79179179179179
987,12,6.78318135764944,7.0,999,6.78578578578579
988,11,6.78846153846154,7.0,999,6.79079079079079
988,11,6.78137651821862,7.0,999,6.78378378378378
989,10,6.78766430738119,7.0,999,6.78978978978979
989,10,6.78058645096057,7.0,999,6.78278278278278
987,12,6.78318135764944,7.0,999,6.78578578578579
987,12,6.78115501519757,7.0,999,6.78378378378378
988,11,6.78238866396761,7.0,999,6.78478478478478
986,13,6.78194726166329,7.0,999,6.78478478478478
986,13,6.78701825557809,7.0,999,6.78978978978979
988,11,6.78744939271255,7.0,999,6.78978978978979
990,9,6.78787878787879,7.0,999,6.78978978978979
990,9,6.78686868686869,7.0,999,6.78878878878879
992,7,6.79032258064516,7.0,999,6.79179179179179
992,7,6.78629032258065,7.0,999,6.78778778778779
991,8,6.78304742684157,7.0,999,6.78478478478478
991,8,6.78708375378406,7.0,999,6.78878878878879
992,7,6.78225806451613,7.0,999,6.78378378378378
993,6,6.79456193353474,7.0,999,6.7957957957958
993,6,6.79053373615307,7.0,999,6.79179179179179
994,5,6.79275653923541,7.0,999,6.79379379379379
994,5,6.79275653923541,7.0,999,6.79379379379379
995,4,6.80100502512563,7.0,999,6.8018018018018
995,4,6.81105527638191,7.0,999,6.81181181181181
995,4,6.81206030150754,7.0,999,6.81281281281281
996,3,6.82128514056225,7.0,999,6.82182182182182
996,3,6.81124497991968,7.0,999,6.81181181181181
995,4,6.82110552763819,7.0,999,6.82182182182182
995,4,6.81608040201005,7.0,999,6.81681681681682
994,5,6.80684104627767,7.0,999,6.80780780780781
993,6,6.80463242698892,7.0,999,6.80580580580581
994,5,6.80784708249497,7.0,999,6.80880880880881
994,5,6.8158953722334,7.0,999,6.81681681681682
994,5,6.81086519114688,7.0,999,6.81181181181181
994,5,6.81086519114688,7.0,999,6.81181181181181
994,5,6.81086519114688,7.0,999,6.81181181181181
995,4,6.80502512562814,7.0,999,6.80580580580581
994,5,6.81287726358149,7.0,999,6.81381381381381
993,6,6.81168177240685,7.0,999,6.81281281281281
992,7,6.8195564516129,7.0,999,6.82082082082082
993,6,6.81873111782477,7.0,999,6.81981981981982
993,6,6.81168177240685,7.0,999,6.81281281281281
992,7,6.80745967741935,7.0,999,6.80880880880881
992,7,6.79838709677419,7.0,999,6.7997997997998
992,7,6.79637096774194,7.0,999,6.7977977977978
990,9,6.7969696969697,7.0,999,6.7987987987988
987,12,6.80952380952381,7.0,999,6.81181181181181
989,10,6.80182002022245,7.0,999,6.8038038038038
988,11,6.80566801619433,7.0,999,6.80780780780781
990,9,6.8020202020202,7.0,999,6.8038038038038
990,9,6.8020202020202,7.0,999,6.8038038038038
991,8,6.80827447023209,7.0,999,6.80980980980981
992,7,6.80947580645161,7.0,999,6.81081081081081
991,8,6.81533804238143,7.0,999,6.81681681681682
993,6,6.80866062437059,7.0,999,6.80980980980981
994,5,6.80080482897384,7.0,999,6.8018018018018
992,7,6.80040322580645,7.0,999,6.8018018018018
994,5,6.80080482897384,7.0,999,6.8018018018018
994,5,6.80080482897384,7.0,999,6.8018018018018
994,5,6.7897384305835,7.0,999,6.79079079079079
993,6,6.78751258811682,7.0,999,6.78878878878879
993,6,6.79053373615307,7.0,999,6.79179179179179
992,7,6.78225806451613,7.0,999,6.78378378378378
991,8,6.77800201816347,7.0,999,6.77977977977978
991,8,6.78203834510595,7.0,999,6.78378378378378
991,8,6.79212916246216,7.0,999,6.79379379379379
989,10,6.7896865520728,7.0,999,6.79179179179179
989,10,6.788675429727,7.0,999,6.79079079079079
990,9,6.7969696969697,7.0,999,6.7987987987988
987,12,6.790273556231,7.0,999,6.79279279279279
990,9,6.76969696969697,7.0,999,6.77177177177177
991,8,6.77194752774975,7.0,999,6.77377377377377
990,9,6.78181818181818,7.0,999,6.78378378378378
989,10,6.77957532861476,7.0,999,6.78178178178178
987,12,6.78622087132725,7.0,999,6.78878878878879
989,10,6.79271991911021,7.0,999,6.79479479479479
988,11,6.7834008097166,7.0,999,6.78578578578579
988,11,6.78643724696356,7.0,999,6.78878878878879
989,10,6.78058645096057,7.0,999,6.78278278278278
991,8,6.77396569122099,7.0,999,6.77577577577578
993,6,6.77744209466264,7.0,999,6.77877877877878
993,6,6.77744209466264,7.0,999,6.77877877877878
993,6,6.77945619335347,7.0,999,6.78078078078078
992,7,6.77923387096774,7.0,999,6.78078078078078
992,7,6.78326612903226,7.0,999,6.78478478478478
994,5,6.79275653923541,7.0,999,6.79379379379379
993,6,6.79456193353474,7.0,999,6.7957957957958
993,6,6.79355488418933,7.0,999,6.79479479479479
993,6,6.79859013091641,7.0,999,6.7997997997998
994,5,6.78772635814889,7.0,999,6.78878878878879
992,7,6.78528225806452,7.0,999,6.78678678678679
992,7,6.7883064516129,7.0,999,6.78978978978979
991,8,6.78304742684157,7.0,999,6.78478478478478
993,6,6.78247734138973,7.0,999,6.78378378378378
995,4,6.78994974874372,7.0,999,6.79079079079079
994,5,6.80181086519115,7.0,999,6.8028028028028
993,6,6.80563947633434,7.0,999,6.80680680680681
992,7,6.80947580645161,7.0,999,6.81081081081081
993,6,6.81268882175227,7.0,999,6.81381381381381
992,7,6.80745967741935,7.0,999,6.80880880880881
993,6,6.81168177240685,7.0,999,6.81281281281281
992,7,6.81048387096774,7.0,999,6.81181181181181
990,9,6.81010101010101,7.0,999,6.81181181181181
989,10,6.81092012133468,7.0,999,6.81281281281281
990,9,6.7989898989899,7.0,999,6.8008008008008
991,8,6.80322906155399,7.0,999,6.8048048048048
990,9,6.8040404040404,7.0,999,6.80580580580581
991,8,6.80827447023209,7.0,999,6.80980980980981
991,8,6.81331987891019,7.0,999,6.81481481481481
990,9,6.80909090909091,7.0,999,6.81081081081081
990,9,6.81212121212121,7.0,999,6.81381381381381
992,7,6.81552419354839,7.0,999,6.81681681681682
991,8,6.82441977800202,7.0,999,6.82582582582583
988,11,6.82085020242915,7.0,999,6.82282282282282
989,10,6.82810920121335,7.0,999,6.82982982982983
988,11,6.82894736842105,7.0,999,6.83083083083083
990,9,6.83131313131313,7.0,999,6.83283283283283
989,10,6.82709807886754,7.0,999,6.82882882882883
989,10,6.82204246713852,7.0,999,6.82382382382382
990,9,6.82626262626263,7.0,999,6.82782782782783
991,8,6.82139253279516,7.0,999,6.82282282282282
992,7,6.83568548387097,7.0,999,6.83683683683684
991,8,6.84561049445005,7.0,999,6.84684684684685
990,9,6.84848484848485,7.0,999,6.84984984984985
989,10,6.84630940343782,7.0,999,6.84784784784785
987,12,6.84498480243161,7.0,999,6.84684684684685
986,13,6.85091277890467,7.0,999,6.85285285285285
986,13,6.84381338742394,7.0,999,6.84584584584585
986,13,6.84584178498986,7.0,999,6.84784784784785
986,13,6.8448275862069,7.0,999,6.84684684684685
985,14,6.84568527918782,7.0,999,6.84784784784785
986,13,6.84584178498986,7.0,999,6.84784784784785
984,15,6.84451219512195,7.0,999,6.84684684684685
986,13,6.8498985801217,7.0,999,6.85185185185185
985,14,6.848730964467,7.0,999,6.85085085085085
987,12,6.85207700101317,7.0,999,6.85385385385385
988,11,6.85526315789474,7.0,999,6.85685685685686
987,12,6.85714285714286,7.0,999,6.85885885885886
987,12,6.86220871327254,7.0,999,6.86386386386386
987,12,6.86524822695035,7.0,999,6.86686686686687
987,12,6.87234042553191,7.0,999,6.87387387387387
988,11,6.87449392712551,7.0,999,6.87587587587588
989,10,6.87259858442872,7.0,999,6.87387387387387
987,12,6.87335359675785,7.0,999,6.87487487487487
987,12,6.87031408308004,7.0,999,6.87187187187187
988,11,6.86943319838057,7.0,999,6.87087087087087
988,11,6.87449392712551,7.0,999,6.87587587587588
989,10,6.87866531850354,7.0,999,6.87987987987988
990,9,6.87979797979798,7.0,999,6.88088088088088
