forward_num,reverse_num,forward_rate,reverse_rate,organism_num,organism_rate
5,5,5.0,5.0,10,5.0
5,5,5.0,5.0,10,5.0
5,5,5.0,5.0,10,5.0
6,6,5.33333333333333,5.33333333333333,12,5.33333333333333
7,7,5.42857142857143,5.42857142857143,14,5.42857142857143
8,8,5.375,5.375,16,5.375
11,11,5.54545454545455,5.54545454545455,22,5.54545454545455
14,14,5.42857142857143,5.42857142857143,28,5.42857142857143
13,14,5.46153846153846,5.42857142857143,27,5.44444444444444
18,20,5.77777777777778,5.7,38,5.73684210526316
18,20,5.77777777777778,5.7,38,5.73684210526316
24,26,5.66666666666667,5.61538461538461,50,5.64
32,34,6.0,5.94117647058824,66,5.96969696969697
34,38,5.94117647058824,5.84210526315789,72,5.88888888888889
44,48,5.81818181818182,5.75,92,5.78260869565217
60,64,6.13333333333333,6.0625,124,6.09677419354839
64,68,6.0,5.94117647058824,132,5.96969696969697
84,92,5.95238095238095,5.8695652173913,176,5.90909090909091
116,124,6.24137931034483,6.16129032258065,240,6.2
116,124,6.24137931034483,6.16129032258065,240,6.2
116,124,6.24137931034483,6.16129032258065,240,6.2
232,248,6.24137931034483,6.16129032258065,480,6.2
232,248,6.24137931034483,6.16129032258065,480,6.2
232,248,6.24137931034483,6.16129032258065,480,6.2
424,440,6.43396226415094,6.38181818181818,864,6.40740740740741
440,472,6.38181818181818,6.28813559322034,912,6.33333333333333
506,493,6.36758893280632,6.22515212981744,999,6.2972972972973
513,485,6.38401559454191,6.27422680412371,998,6.33066132264529
508,491,6.40157480314961,6.28513238289206,999,6.34434434434434
513,484,6.36842105263158,6.23760330578512,997,6.3049147442327
520,477,6.41923076923077,6.29140461215933,997,6.358074222668
535,464,6.36261682242991,6.25862068965517,999,6.31431431431431
525,474,6.37333333333333,6.30801687763713,999,6.34234234234234
521,478,6.40499040307102,6.32217573221757,999,6.36536536536537
519,480,6.40847784200385,6.32708333333333,999,6.36936936936937
514,484,6.43774319066148,6.33264462809917,998,6.38677354709419
521,478,6.46641074856046,6.31799163179916,999,6.3953953953954
522,477,6.47509578544061,6.32914046121593,999,6.40540540540541
510,489,6.46078431372549,6.34560327198364,999,6.4044044044044
504,495,6.46825396825397,6.37979797979798,999,6.42442442442442
508,491,6.48818897637795,6.37678207739308,999,6.43343343343343
505,493,6.45544554455446,6.31440162271805,998,6.38577154308617
496,500,6.46774193548387,6.366,996,6.41666666666667
505,492,6.51287128712871,6.38821138211382,997,6.45135406218656
508,490,6.49803149606299,6.36938775510204,998,6.43486973947896
497,500,6.53923541247485,6.37,997,6.4543630892678
506,493,6.51778656126482,6.34077079107505,999,6.43043043043043
505,494,6.51881188118812,6.33805668016194,999,6.42942942942943
497,500,6.52917505030181,6.356,997,6.44232698094283
502,496,6.55179282868526,6.35282258064516,998,6.45290581162325
506,492,6.5395256916996,6.35772357723577,998,6.4498997995992
498,500,6.55823293172691,6.322,998,6.43987975951904
494,503,6.56477732793522,6.3220675944334,997,6.44232698094283
493,503,6.58012170385396,6.30616302186879,996,6.44176706827309
499,500,6.57915831663327,6.31,999,6.44444444444444
504,495,6.60515873015873,6.33939393939394,999,6.47347347347347
504,495,6.59325396825397,6.36565656565657,999,6.48048048048048
508,490,6.58070866141732,6.35918367346939,998,6.47194388777555
507,492,6.55818540433925,6.34552845528455,999,6.45345345345345
500,499,6.58,6.36673346693387,999,6.47347347347347
515,484,6.57669902912621,6.37603305785124,999,6.47947947947948
509,488,6.56581532416503,6.38319672131148,997,6.47642928786359
500,498,6.55,6.3855421686747,998,6.46793587174349
507,492,6.53846153846154,6.38617886178862,999,6.46346346346346
512,487,6.52734375,6.35934291581109,999,6.44544544544545
510,487,6.54901960784314,6.37166324435318,997,6.46238716148445
519,480,6.54527938342967,6.375,999,6.46346346346346
511,488,6.55185909980431,6.38729508196721,999,6.47147147147147
494,504,6.58097165991903,6.41071428571429,998,6.49498997995992
502,495,6.59163346613546,6.42626262626263,997,6.50952858575727
493,506,6.5841784989858,6.41106719367589,999,6.4964964964965
482,517,6.58713692946058,6.40618955512573,999,6.49349349349349
487,512,6.58932238193018,6.408203125,999,6.4964964964965
484,514,6.60330578512397,6.41634241245136,998,6.50701402805611
480,516,6.5875,6.41666666666667,996,6.49899598393574
487,512,6.59137577002053,6.416015625,999,6.5015015015015
482,517,6.58298755186722,6.41972920696325,999,6.4984984984985
473,524,6.59830866807611,6.44465648854962,997,6.51755265797392
482,517,6.60995850622407,6.4642166344294,999,6.53453453453453
483,514,6.59834368530021,6.46498054474708,997,6.5295887662989
480,519,6.62708333333333,6.46820809248555,999,6.54454454454454
481,517,6.62370062370062,6.45841392649903,998,6.53807615230461
488,511,6.64344262295082,6.47553816046967,999,6.55755755755756
491,508,6.65580448065173,6.48622047244094,999,6.56956956956957
488,511,6.65368852459016,6.4559686888454,999,6.55255255255255
491,508,6.65784114052953,6.44094488188976,999,6.54754754754755
501,497,6.67065868263473,6.4466800804829,998,6.55911823647295
501,498,6.6686626746507,6.45381526104418,999,6.56156156156156
503,495,6.66202783300199,6.45050505050505,998,6.55711422845691
501,498,6.6626746506986,6.46184738955823,999,6.56256256256256
508,490,6.66338582677165,6.47959183673469,998,6.57314629258517
503,496,6.67594433399602,6.47782258064516,999,6.57757757757758
513,485,6.67641325536062,6.48865979381443,998,6.58517034068136
514,482,6.67120622568093,6.51659751037344,996,6.59638554216868
508,490,6.67913385826772,6.54897959183673,998,6.61523046092184
517,482,6.68278529980658,6.53526970954357,999,6.61161161161161
519,479,6.6897880539499,6.55323590814196,998,6.62424849699399
513,485,6.68615984405458,6.55876288659794,998,6.62424849699399
525,473,6.68,6.54756871035941,998,6.61723446893788
522,477,6.67432950191571,6.56394129979036,999,6.62162162162162
524,475,6.66412213740458,6.56,999,6.61461461461461
518,480,6.68339768339768,6.55208333333333,998,6.62024048096192
507,492,6.67258382642998,6.54878048780488,999,6.61161161161161
513,485,6.66081871345029,6.56082474226804,998,6.6122244488978
514,485,6.66147859922179,6.57113402061856,999,6.61761761761762
489,509,6.66053169734151,6.57563850687623,998,6.61723446893788
497,501,6.64185110663984,6.56686626746507,998,6.60420841683367
494,505,6.66396761133603,6.56633663366337,999,6.61461461461461
492,506,6.67073170731707,6.58695652173913,998,6.62825651302605
500,498,6.674,6.56024096385542,998,6.61723446893788
500,499,6.664,6.56913827655311,999,6.61661661661662
485,513,6.64536082474227,6.5692007797271,998,6.6062124248497
487,512,6.65092402464066,6.5625,999,6.60560560560561
487,511,6.65092402464066,6.56164383561644,998,6.60521042084168
472,525,6.65889830508475,6.55809523809524,997,6.60581745235707
481,518,6.65488565488566,6.54633204633205,999,6.5985985985986
496,503,6.65725806451613,6.56660039761431,999,6.61161161161161
490,509,6.6530612244898,6.57956777996071,999,6.61561561561562
490,509,6.66734693877551,6.58349705304519,999,6.62462462462462
496,502,6.67741935483871,6.58167330677291,998,6.62925851703407
490,508,6.66938775510204,6.59055118110236,998,6.62925851703407
485,513,6.67835051546392,6.5906432748538,998,6.63326653306613
490,507,6.68163265306122,6.60355029585799,997,6.641925777332
483,514,6.68530020703934,6.57782101167315,997,6.62988966900702
472,526,6.69703389830508,6.58365019011407,998,6.6372745490982
481,515,6.70686070686071,6.59029126213592,996,6.64658634538153
485,512,6.71752577319588,6.58984375,997,6.65195586760281
485,514,6.71752577319588,6.62062256809338,999,6.66766766766767
491,507,6.72912423625255,6.61538461538461,998,6.67134268537074
499,499,6.72945891783567,6.62124248496994,998,6.67535070140281
504,494,6.74404761904762,6.64574898785425,998,6.69539078156313
505,494,6.74851485148515,6.65991902834008,999,6.7047047047047
499,499,6.75551102204409,6.66332665330661,998,6.70941883767535
498,500,6.7570281124498,6.67,998,6.71342685370742
501,495,6.7564870259481,6.67878787878788,996,6.71787148594377
504,494,6.75992063492064,6.65991902834008,998,6.71042084168337
509,490,6.75049115913556,6.66734693877551,999,6.70970970970971
514,483,6.76070038910506,6.67908902691511,997,6.72116349047141
512,487,6.759765625,6.6776180698152,999,6.71971971971972
515,483,6.75145631067961,6.67080745341615,998,6.7124248496994
511,488,6.75929549902153,6.67418032786885,999,6.71771771771772
516,483,6.7577519379845,6.6935817805383,999,6.72672672672673
515,484,6.75728155339806,6.6900826446281,999,6.72472472472472
513,486,6.74853801169591,6.68106995884774,999,6.71571571571572
519,480,6.74373795761079,6.7,999,6.72272272272272
509,489,6.74656188605108,6.69529652351738,998,6.72144288577154
514,483,6.7568093385214,6.68115942028986,997,6.72016048144433
519,479,6.76300578034682,6.67432150313152,998,6.72044088176353
526,473,6.76045627376426,6.6723044397463,999,6.71871871871872
525,474,6.75238095238095,6.67932489451477,999,6.71771771771772
536,462,6.75559701492537,6.67532467532468,998,6.7184368737475
542,457,6.75830258302583,6.67177242888403,999,6.71871871871872
529,469,6.77126654064272,6.6545842217484,998,6.71643286573146
537,460,6.76722532588454,6.63913043478261,997,6.70812437311936
540,458,6.77592592592593,6.65065502183406,998,6.7184368737475
535,461,6.78317757009346,6.65075921908894,996,6.7218875502008
519,478,6.78227360308285,6.64225941422594,997,6.71514543630893
523,476,6.80497131931166,6.65126050420168,999,6.73173173173173
524,475,6.80534351145038,6.64631578947368,999,6.72972972972973
538,460,6.80855018587361,6.66304347826087,998,6.74148296593186
534,463,6.80524344569288,6.66738660907127,997,6.74122367101304
533,466,6.79737335834897,6.67381974248927,999,6.73973973973974
540,458,6.79444444444444,6.66593886462882,998,6.73547094188377
539,460,6.78664192949907,6.67826086956522,999,6.73673673673674
544,454,6.78492647058824,6.68061674008811,998,6.7374749498998
538,460,6.78810408921933,6.68260869565217,998,6.73947895791583
531,468,6.78531073446328,6.70512820512821,999,6.74774774774775
535,464,6.78504672897196,6.6875,999,6.73973973973974
536,461,6.78544776119403,6.70065075921909,997,6.74623871614845
530,469,6.78679245283019,6.6908315565032,999,6.74174174174174
535,464,6.78691588785047,6.67456896551724,999,6.73473473473473
534,464,6.79588014981273,6.68534482758621,998,6.74448897795591
534,463,6.7940074906367,6.6976241900648,997,6.74924774322969
545,454,6.80733944954128,6.68722466960352,999,6.75275275275275
555,443,6.81261261261261,6.71331828442438,998,6.7685370741483
546,453,6.80586080586081,6.70860927152318,999,6.76176176176176
547,451,6.80255941499086,6.68736141906874,998,6.75050100200401
550,448,6.81090909090909,6.69419642857143,998,6.75851703406814
546,453,6.80769230769231,6.69757174392936,999,6.75775775775776
551,448,6.81669691470054,6.68973214285714,999,6.75975975975976
552,446,6.81884057971014,6.67937219730942,998,6.7565130260521
546,453,6.81868131868132,6.6887417218543,999,6.75975975975976
543,456,6.81399631675875,6.70394736842105,999,6.76376376376376
548,451,6.81021897810219,6.70509977827051,999,6.76276276276276
539,459,6.81818181818182,6.72549019607843,998,6.77555110220441
542,457,6.81734317343173,6.71772428884026,999,6.77177177177177
544,455,6.80882352941176,6.69230769230769,999,6.75575575575576
548,451,6.81569343065693,6.70509977827051,999,6.76576576576577
555,444,6.81081081081081,6.7027027027027,999,6.76276276276276
560,439,6.80892857142857,6.69020501138952,999,6.75675675675676
554,445,6.7942238267148,6.66966292134831,999,6.73873873873874
548,449,6.79197080291971,6.67483296213808,997,6.73921765295888
551,448,6.79854809437387,6.67410714285714,999,6.74274274274274
550,447,6.8,6.68008948545861,997,6.74623871614845
538,460,6.80483271375465,6.6695652173913,998,6.74248496993988
539,460,6.80890538033395,6.67608695652174,999,6.74774774774775
535,464,6.80560747663551,6.68965517241379,999,6.75175175175175
541,458,6.82439926062847,6.68558951965066,999,6.76076076076076
546,453,6.82783882783883,6.69315673289183,999,6.76676676676677
538,460,6.83271375464684,6.69782608695652,998,6.77054108216433
543,455,6.82504604051565,6.68571428571429,998,6.76152304609218
555,444,6.82162162162162,6.7027027027027,999,6.76876876876877
559,438,6.83542039355993,6.71461187214612,997,6.78234704112337
554,444,6.83574007220217,6.71846846846847,998,6.78356713426854
549,449,6.84517304189435,6.71937639198218,998,6.78857715430862
554,445,6.85018050541516,6.7123595505618,999,6.78878878878879
556,443,6.84352517985612,6.70880361173815,999,6.78378378378378
553,442,6.84629294755877,6.71493212669683,995,6.78793969849246
552,443,6.84963768115942,6.71106094808126,995,6.78793969849246
553,445,6.84629294755877,6.70786516853933,998,6.78456913827655
554,445,6.84115523465704,6.69887640449438,999,6.77777777777778
548,450,6.83576642335766,6.68666666666667,998,6.7685370741483
548,450,6.83576642335766,6.69111111111111,998,6.77054108216433
545,454,6.84220183486239,6.69823788546256,999,6.77677677677678
553,445,6.84267631103074,6.69887640449438,998,6.77855711422846
559,440,6.8515205724508,6.7,999,6.78478478478478
566,432,6.85512367491166,6.72685185185185,998,6.79959919839679
570,428,6.86842105263158,6.72663551401869,998,6.80761523046092
562,435,6.87544483985765,6.73103448275862,997,6.81243731193581
558,440,6.87992831541219,6.73181818181818,998,6.81462925851703
571,427,6.88266199649737,6.74473067915691,998,6.82364729458918
563,434,6.88632326820604,6.74884792626728,997,6.82647943831495
556,441,6.89028776978417,6.76417233560091,997,6.83450351053159
554,442,6.88808664259928,6.75565610859729,996,6.8293172690763
560,438,6.8875,6.74885844748858,998,6.82665330661323
562,437,6.88967971530249,6.75057208237986,999,6.82882882882883
557,441,6.89228007181329,6.74829931972789,998,6.82865731462926
566,432,6.87632508833922,6.73842592592593,998,6.81663326653307
570,428,6.88947368421053,6.74532710280374,998,6.82765531062124
558,439,6.89247311827957,6.749430523918,997,6.82948846539619
559,440,6.89445438282648,6.76363636363636,999,6.83683683683684
558,441,6.89247311827957,6.75963718820862,999,6.83383383383383
551,446,6.88566243194192,6.75560538116592,997,6.82748244734203
556,443,6.89028776978417,6.75846501128668,999,6.83183183183183
560,439,6.89285714285714,6.75626423690205,999,6.83283283283283
553,445,6.89692585895118,6.74831460674157,998,6.83066132264529
551,448,6.89655172413793,6.75446428571429,999,6.83283283283283
551,448,6.88747731397459,6.75446428571429,999,6.82782782782783
550,449,6.89818181818182,6.74387527839644,999,6.82882882882883
549,450,6.89981785063752,6.74222222222222,999,6.82882882882883
553,446,6.89692585895118,6.75560538116592,999,6.83383383383383
563,436,6.8898756660746,6.75917431192661,999,6.83283283283283
577,422,6.89254766031196,6.7654028436019,999,6.83883883883884
570,429,6.8859649122807,6.78321678321678,999,6.84184184184184
576,421,6.87326388888889,6.78859857482185,997,6.83751253761284
573,426,6.8760907504363,6.79107981220657,999,6.83983983983984
574,425,6.88675958188153,6.80235294117647,999,6.85085085085085
580,417,6.88448275862069,6.810551558753,997,6.85356068204614
577,422,6.88561525129983,6.80331753554502,999,6.85085085085085
577,419,6.88908145580589,6.8090692124105,996,6.85542168674699
577,422,6.88734835355286,6.80568720379147,999,6.85285285285285
572,427,6.88986013986014,6.81030444964871,999,6.85585585585586
576,423,6.89409722222222,6.79669030732861,999,6.85285285285285
584,415,6.8972602739726,6.79277108433735,999,6.85385385385385
579,417,6.89119170984456,6.79856115107914,996,6.85240963855422
577,421,6.88908145580589,6.80285035629454,998,6.85270541082164
577,421,6.88214904679376,6.80047505938242,998,6.84769539078156
576,423,6.88020833333333,6.80378250591017,999,6.84784784784785
579,418,6.87910189982729,6.78947368421053,997,6.84152457372116
582,417,6.87972508591065,6.7841726618705,999,6.83983983983984
582,417,6.88144329896907,6.78177458033573,999,6.83983983983984
574,424,6.88675958188153,6.7688679245283,998,6.83667334669339
575,424,6.89739130434783,6.77358490566038,999,6.84484484484484
570,427,6.88947368421053,6.78454332552693,997,6.84453360080241
570,428,6.88771929824561,6.7803738317757,998,6.84168336673347
573,425,6.89877835951134,6.78823529411765,998,6.85170340681363
570,429,6.90350877192982,6.79487179487179,999,6.85685685685686
565,432,6.90796460176991,6.78240740740741,997,6.85356068204614
562,437,6.90569395017794,6.79633867276888,999,6.85785785785786
554,444,6.8971119133574,6.79954954954955,998,6.85370741482966
563,436,6.89698046181172,6.79357798165138,999,6.85185185185185
557,442,6.90125673249551,6.80316742081448,999,6.85785785785786
551,448,6.9038112522686,6.80133928571429,999,6.85785785785786
566,433,6.91342756183746,6.78521939953811,999,6.85785785785786
563,435,6.90763765541741,6.77931034482759,998,6.85170340681363
571,428,6.90542907180385,6.78971962616822,999,6.85585585585586
573,425,6.90750436300175,6.78588235294118,998,6.85571142284569
566,432,6.90989399293286,6.80092592592593,998,6.8627254509018
575,424,6.90608695652174,6.79952830188679,999,6.86086086086086
570,429,6.90701754385965,6.8041958041958,999,6.86286286286286
559,440,6.92307692307692,6.80681818181818,999,6.87187187187187
569,430,6.92442882249561,6.80697674418605,999,6.87387387387387
574,425,6.92682926829268,6.80705882352941,999,6.87587587587588
564,435,6.92375886524823,6.80229885057471,999,6.87087087087087
569,430,6.92794376098418,6.8093023255814,999,6.87687687687688
573,425,6.92670157068063,6.81882352941176,998,6.88076152304609
564,435,6.9290780141844,6.81149425287356,999,6.87787787787788
568,431,6.93133802816901,6.80742459396752,999,6.87787787787788
559,439,6.93738819320215,6.81321184510251,998,6.88276553106212
555,444,6.93693693693694,6.80405405405405,999,6.87787787787788
558,441,6.93010752688172,6.8140589569161,999,6.87887887887888
552,446,6.93840579710145,6.82286995515695,998,6.88677354709419
560,438,6.94642857142857,6.82876712328767,998,6.89478957915832
561,436,6.94474153297683,6.8256880733945,997,6.89267803410231
556,442,6.94424460431655,6.8393665158371,998,6.89779559118236
561,438,6.93939393939394,6.84703196347032,999,6.8988988988989
558,440,6.92831541218638,6.85,998,6.8937875751503
550,449,6.93636363636364,6.85523385300668,999,6.8998998998999
556,442,6.93345323741007,6.8552036199095,998,6.89879759519038
552,447,6.92753623188406,6.86353467561521,999,6.8988988988989
557,441,6.92280071813285,6.85260770975057,998,6.89178356713427
549,450,6.91985428051002,6.86666666666667,999,6.8958958958959
542,456,6.91328413284133,6.86842105263158,998,6.89278557114228
541,458,6.91312384473198,6.86026200873362,999,6.88888888888889
545,454,6.91743119266055,6.86343612334802,999,6.89289289289289
542,456,6.9169741697417,6.87280701754386,998,6.89679358717435
538,460,6.91078066914498,6.87826086956522,998,6.89579158316633
547,451,6.90676416819013,6.87361419068736,998,6.89178356713427
539,460,6.90909090909091,6.87173913043478,999,6.89189189189189
529,466,6.90737240075614,6.87768240343348,995,6.89346733668342
532,466,6.90413533834586,6.86909871244635,998,6.8877755511022
525,472,6.91428571428571,6.86652542372881,997,6.89167502507523
522,475,6.90038314176245,6.87789473684211,997,6.88966900702106
529,470,6.9054820415879,6.87234042553191,999,6.88988988988989
533,465,6.90056285178236,6.86451612903226,998,6.88376753507014
529,469,6.90170132325142,6.86780383795309,998,6.88577154308617
544,453,6.90441176470588,6.86975717439294,997,6.88866599799398
541,458,6.89279112754159,6.86681222707424,999,6.88088088088088
541,458,6.90757855822551,6.86899563318777,999,6.88988988988989
544,455,6.91911764705882,6.87912087912088,999,6.9009009009009
538,461,6.92007434944238,6.88286334056399,999,6.9029029029029
539,460,6.91465677179963,6.8804347826087,999,6.8988988988989
544,455,6.91727941176471,6.87912087912088,999,6.8998998998999
536,463,6.92350746268657,6.88120950323974,999,6.9039039039039
541,458,6.92051756007394,6.882096069869,999,6.9029029029029
551,448,6.92196007259528,6.88392857142857,999,6.9049049049049
550,448,6.92363636363636,6.90401785714286,998,6.91482965931864
541,458,6.92606284658041,6.89956331877729,999,6.91391391391391
542,455,6.92066420664207,6.90549450549451,997,6.91374122367101
542,455,6.91881918819188,6.91208791208791,997,6.91574724172518
549,448,6.92167577413479,6.91964285714286,997,6.92076228686058
550,449,6.91636363636364,6.9109131403118,999,6.91391391391391
548,450,6.91423357664234,6.90444444444444,998,6.90981963927856
542,456,6.9169741697417,6.90789473684211,998,6.91282565130261
546,452,6.90842490842491,6.90929203539823,998,6.90881763527054
547,452,6.92138939670932,6.89823008849558,999,6.91091091091091
549,450,6.92349726775956,6.90444444444444,999,6.91491491491491
559,438,6.91592128801431,6.8972602739726,997,6.90772316950853
548,451,6.92700729927007,6.89356984478936,999,6.91191191191191
549,448,6.92531876138433,6.890625,997,6.90972918756269
550,448,6.91636363636364,6.890625,998,6.90480961923848
554,445,6.9115523465704,6.87640449438202,999,6.8958958958959
544,453,6.91544117647059,6.87637969094923,997,6.89769307923771
546,453,6.90842490842491,6.87417218543046,999,6.89289289289289
547,451,6.90493601462523,6.8669623059867,998,6.8877755511022
540,459,6.92222222222222,6.86492374727669,999,6.8958958958959
540,459,6.92407407407407,6.87145969498911,999,6.8998998998999
539,460,6.91836734693878,6.86739130434783,999,6.89489489489489
547,452,6.91042047531993,6.85619469026549,999,6.88588588588589
538,460,6.91263940520446,6.85869565217391,998,6.8877755511022
545,454,6.91376146788991,6.87004405286344,999,6.89389389389389
553,446,6.90415913200723,6.86995515695067,999,6.88888888888889
544,455,6.90625,6.87472527472527,999,6.89189189189189
546,453,6.91025641025641,6.88300220750552,999,6.8978978978979
549,450,6.90346083788707,6.88444444444444,999,6.89489489489489
542,457,6.90221402214022,6.87746170678337,999,6.89089089089089
548,449,6.91058394160584,6.87750556792873,997,6.89568706118355
547,452,6.91407678244973,6.88274336283186,999,6.8998998998999
537,459,6.90502793296089,6.87581699346405,996,6.89156626506024
533,466,6.91181988742964,6.87124463519313,999,6.89289289289289
528,470,6.92234848484848,6.88085106382979,998,6.90280561122244
525,473,6.92,6.87315010570825,998,6.89779559118236
532,466,6.91353383458647,6.87124463519313,998,6.8937875751503
535,462,6.91775700934579,6.87229437229437,997,6.89669007021063
534,464,6.91385767790262,6.875,998,6.89579158316633
533,466,6.90056285178236,6.88197424892704,999,6.89189189189189
528,471,6.89772727272727,6.87685774946921,999,6.88788788788789
523,475,6.90439770554493,6.88,998,6.89278557114228
531,468,6.90395480225989,6.87820512820513,999,6.89189189189189
533,466,6.90243902439024,6.87982832618026,999,6.89189189189189
533,465,6.90431519699812,6.88602150537634,998,6.89579158316633
552,446,6.90036231884058,6.87892376681614,998,6.89078156312625
558,439,6.89964157706093,6.88154897494305,997,6.89167502507523
547,452,6.90493601462523,6.88053097345133,999,6.89389389389389
549,450,6.90892531876138,6.88888888888889,999,6.8998998998999
557,441,6.90125673249551,6.8843537414966,998,6.8937875751503
550,449,6.89636363636364,6.88864142538976,999,6.89289289289289
557,441,6.90125673249551,6.90249433106576,998,6.90180360721443
552,447,6.89855072463768,6.90156599552573,999,6.8998998998999
548,451,6.8978102189781,6.8980044345898,999,6.8978978978979
539,460,6.8961038961039,6.89347826086957,999,6.89489489489489
544,455,6.89154411764706,6.9010989010989,999,6.8958958958959
544,454,6.88419117647059,6.90748898678414,998,6.89478957915832
536,462,6.88619402985075,6.89177489177489,998,6.88877755511022
542,455,6.8929889298893,6.89450549450549,997,6.89368104312939
552,447,6.88949275362319,6.90380313199105,999,6.8958958958959
558,441,6.88172043010753,6.9092970521542,999,6.89389389389389
555,444,6.88828828828829,6.90765765765766,999,6.8968968968969
547,451,6.89213893967093,6.91130820399113,998,6.90080160320641
550,449,6.89636363636364,6.91314031180401,999,6.9039039039039
545,453,6.8954128440367,6.9205298013245,998,6.90681362725451
537,462,6.90875232774674,6.92640692640693,999,6.91691691691692
549,449,6.91074681238616,6.92873051224944,998,6.9188376753507
553,446,6.90958408679928,6.92825112107623,999,6.91791791791792
556,443,6.91187050359712,6.93679458239278,999,6.92292292292292
557,442,6.91741472172352,6.93212669683258,999,6.92392392392392
560,439,6.91428571428571,6.92710706150342,999,6.91991991991992
552,446,6.92028985507246,6.93273542600897,998,6.92585170340681
558,441,6.92114695340502,6.92517006802721,999,6.92292292292292
556,442,6.91726618705036,6.92986425339367,998,6.92284569138277
546,453,6.92307692307692,6.92273730684327,999,6.92292292292292
548,451,6.92883211678832,6.91574279379157,999,6.92292292292292
548,451,6.92518248175182,6.9179600886918,999,6.92192192192192
553,445,6.92405063291139,6.91910112359551,998,6.92184368737475
562,436,6.92526690391459,6.91743119266055,998,6.92184368737475
552,445,6.92753623188406,6.92359550561798,997,6.92577733199599
559,440,6.91771019677996,6.925,999,6.92092092092092
567,432,6.92239858906526,6.92592592592593,999,6.92392392392392
560,438,6.925,6.92465753424658,998,6.9248496993988
559,440,6.92844364937388,6.92272727272727,999,6.92592592592593
567,432,6.92768959435626,6.9212962962963,999,6.92492492492492
553,445,6.92585895117541,6.92584269662921,998,6.92585170340681
559,437,6.92844364937388,6.91762013729977,996,6.92369477911647
573,426,6.92495636998255,6.92253521126761,999,6.92392392392392
564,433,6.92198581560284,6.91916859122402,997,6.92076228686058
554,442,6.92238267148014,6.9185520361991,996,6.9206827309237
558,441,6.91756272401434,6.92063492063492,999,6.91891891891892
547,451,6.91590493601463,6.91574279379157,998,6.91583166332665
552,447,6.92028985507246,6.917225950783,999,6.91891891891892
562,437,6.91992882562278,6.91533180778032,999,6.91791791791792
555,443,6.91891891891892,6.9255079006772,998,6.92184368737475
557,441,6.92100538599641,6.92290249433107,998,6.92184368737475
561,438,6.92156862745098,6.92922374429224,999,6.92492492492492
565,433,6.91681415929204,6.92609699769053,998,6.92084168336673
567,432,6.91710758377425,6.92592592592593,999,6.92092092092092
563,433,6.91829484902309,6.92609699769053,996,6.92168674698795
563,436,6.92184724689165,6.93348623853211,999,6.92692692692693
565,433,6.92212389380531,6.93071593533487,998,6.92585170340681
568,429,6.92253521126761,6.93006993006993,997,6.92577733199599
576,422,6.93402777777778,6.92654028436019,998,6.93086172344689
575,423,6.9304347826087,6.93144208037825,998,6.93086172344689
580,419,6.92931034482759,6.92840095465394,999,6.92892892892893
585,414,6.93162393162393,6.92753623188406,999,6.92992992992993
585,413,6.92649572649573,6.92978208232446,998,6.92785571142285
587,412,6.92504258943782,6.92961165048544,999,6.92692692692693
590,408,6.92542372881356,6.92647058823529,998,6.92585170340681
586,413,6.92491467576792,6.92009685230024,999,6.92292292292292
584,415,6.92808219178082,6.92289156626506,999,6.92592592592593
579,417,6.91882556131261,6.92805755395683,996,6.92269076305221
581,417,6.92598967297763,6.92565947242206,998,6.92585170340681
577,421,6.92894280762565,6.92874109263658,998,6.92885771543086
578,420,6.9204152249135,6.92142857142857,998,6.92084168336673
581,418,6.92426850258176,6.91626794258373,999,6.92092092092092
570,429,6.92982456140351,6.91608391608392,999,6.92392392392392
573,426,6.93368237347295,6.92253521126761,999,6.92892892892893
572,422,6.93531468531468,6.9218009478673,994,6.92957746478873
572,426,6.93706293706294,6.91784037558685,998,6.92885771543086
570,429,6.93333333333333,6.91841491841492,999,6.92692692692693
580,419,6.92586206896552,6.91885441527446,999,6.92292292292292
569,430,6.93497363796134,6.92558139534884,999,6.93093093093093
557,441,6.93357271095153,6.92290249433107,998,6.92885771543086
557,441,6.92818671454219,6.92063492063492,998,6.9248496993988
552,445,6.92934782608696,6.91910112359551,997,6.92477432296891
558,440,6.92831541218638,6.91136363636364,998,6.92084168336673
555,444,6.93153153153153,6.90990990990991,999,6.92192192192192
549,450,6.93624772313297,6.90666666666667,999,6.92292292292292
548,451,6.93795620437956,6.91130820399113,999,6.92592592592593
543,456,6.94106813996317,6.90350877192982,999,6.92392392392392
544,453,6.94301470588235,6.8962472406181,997,6.92176529588766
538,461,6.94237918215613,6.90455531453362,999,6.92492492492492
537,462,6.94227188081937,6.90476190476191,999,6.92492492492492
553,446,6.94394213381555,6.89461883408072,999,6.92192192192192
551,448,6.94192377495463,6.89285714285714,999,6.91991991991992
547,450,6.94698354661792,6.89333333333333,997,6.92276830491474
549,450,6.95081967213115,6.89333333333333,999,6.92492492492492
559,439,6.94633273703041,6.89293849658314,998,6.92284569138277
551,448,6.94555353901996,6.88839285714286,999,6.91991991991992
556,441,6.94964028776978,6.88208616780045,997,6.9197592778335
556,443,6.94604316546763,6.87810383747178,999,6.91591591591592
557,442,6.94614003590664,6.88235294117647,999,6.91791791791792
559,438,6.94275491949911,6.89497716894977,997,6.92176529588766
562,436,6.94483985765125,6.89220183486239,998,6.92184368737475
565,434,6.95221238938053,6.89400921658986,999,6.92692692692693
564,434,6.9468085106383,6.90092165898618,998,6.92685370741483
567,432,6.95061728395062,6.89814814814815,999,6.92792792792793
561,438,6.94830659536542,6.89269406392694,999,6.92392392392392
551,448,6.9491833030853,6.89508928571429,999,6.92492492492492
562,437,6.94839857651246,6.89931350114416,999,6.92692692692693
565,434,6.93805309734513,6.90092165898618,999,6.92192192192192
561,436,6.94295900178253,6.90366972477064,997,6.92577733199599
565,434,6.94513274336283,6.90552995391705,999,6.92792792792793
569,428,6.94376098418278,6.90420560747664,997,6.92678034102307
566,433,6.93639575971731,6.90531177829099,999,6.92292292292292
570,428,6.93333333333333,6.9088785046729,998,6.92284569138277
578,421,6.94117647058824,6.90261282660333,999,6.92492492492492
579,417,6.93782383419689,6.90887290167866,996,6.92570281124498
579,420,6.93955094991364,6.90714285714286,999,6.92592592592593
577,421,6.94107452339688,6.90973871733967,998,6.92785571142285
579,420,6.93609671848014,6.90952380952381,999,6.92492492492492
580,419,6.93620689655172,6.91646778042959,999,6.92792792792793
584,415,6.93493150684932,6.92048192771084,999,6.92892892892893
595,401,6.93613445378151,6.92019950124688,996,6.92971887550201
578,421,6.93771626297578,6.9144893111639,999,6.92792792792793
581,417,6.94492254733219,6.91606714628297,998,6.93286573146293
579,419,6.9447322970639,6.90930787589499,998,6.92985971943888
572,424,6.94230769230769,6.90801886792453,996,6.92771084337349
574,425,6.94599303135888,6.89882352941176,999,6.92592592592593
582,416,6.95017182130584,6.90144230769231,998,6.92985971943888
581,417,6.94664371772805,6.89448441247002,998,6.9248496993988
572,427,6.94755244755245,6.89695550351288,999,6.92592592592593
565,434,6.95575221238938,6.90552995391705,999,6.93393393393393
574,425,6.95121951219512,6.90352941176471,999,6.93093093093093
571,428,6.95271453590193,6.89719626168224,999,6.92892892892893
568,430,6.95598591549296,6.89767441860465,998,6.93086172344689
577,421,6.95840554592721,6.89311163895487,998,6.93086172344689
572,426,6.9527972027972,6.89671361502347,998,6.92885771543086
572,427,6.95454545454545,6.89461358313817,999,6.92892892892893
581,417,6.96041308089501,6.89208633093525,998,6.93186372745491
579,419,6.95336787564767,6.89498806682578,998,6.92885771543086
579,420,6.96200345423143,6.89285714285714,999,6.93293293293293
587,412,6.96081771720613,6.89805825242718,999,6.93493493493493
579,419,6.95682210708117,6.89498806682578,998,6.93086172344689
574,424,6.95470383275261,6.89622641509434,998,6.92985971943888
581,418,6.95697074010327,6.90191387559809,999,6.93393393393393
591,407,6.95431472081218,6.9041769041769,998,6.93386773547094
592,407,6.95608108108108,6.9017199017199,999,6.93393393393393
589,409,6.95925297113752,6.90220048899756,998,6.93587174348697
598,401,6.96153846153846,6.90523690773067,999,6.93893893893894
599,398,6.96160267111853,6.91206030150754,997,6.94182547642929
605,394,6.96528925619835,6.91116751269035,999,6.94394394394394
613,385,6.96411092985318,6.91428571428571,998,6.94488977955912
612,387,6.96732026143791,6.91989664082687,999,6.94894894894895
613,386,6.96574225122349,6.92487046632124,999,6.94994994994995
622,376,6.96623794212219,6.92553191489362,998,6.95090180360721
611,388,6.96563011456628,6.92525773195876,999,6.94994994994995
611,387,6.96399345335516,6.9250645994832,998,6.94889779559118
621,376,6.9597423510467,6.92553191489362,997,6.94684052156469
606,393,6.96369636963696,6.9236641221374,999,6.94794794794795
608,391,6.95723684210526,6.92838874680307,999,6.94594594594595
614,384,6.95928338762215,6.93229166666667,998,6.94889779559118
602,397,6.96013289036545,6.92947103274559,999,6.94794794794795
605,393,6.9603305785124,6.91857506361323,998,6.9438877755511
607,392,6.95881383855025,6.92602040816327,999,6.94594594594595
609,389,6.95894909688013,6.93316195372751,998,6.94889779559118
599,399,6.95826377295492,6.93984962406015,998,6.95090180360721
601,398,6.9567387687188,6.94472361809045,999,6.95195195195195
606,393,6.95874587458746,6.93893129770992,999,6.95095095095095
610,389,6.96393442622951,6.94087403598972,999,6.95495495495495
611,388,6.96399345335516,6.93556701030928,999,6.95295295295295
612,386,6.96732026143791,6.93523316062176,998,6.95490981963928
610,389,6.9655737704918,6.93316195372751,999,6.95295295295295
614,385,6.96579804560261,6.93506493506494,999,6.95395395395395
616,383,6.96266233766234,6.94516971279373,999,6.95595595595596
608,390,6.96217105263158,6.94102564102564,998,6.95390781563126
620,376,6.96290322580645,6.93882978723404,996,6.95381526104418
618,381,6.96116504854369,6.94225721784777,999,6.95395395395395
617,379,6.95948136142626,6.93931398416887,996,6.95180722891566
619,380,6.95961227786753,6.93947368421053,999,6.95195195195195
616,383,6.95292207792208,6.94516971279373,999,6.94994994994995
610,387,6.95737704918033,6.94573643410853,997,6.95285857572718
616,383,6.96103896103896,6.94255874673629,999,6.95395395395395
613,385,6.95595432300163,6.94025974025974,998,6.9498997995992
600,398,6.95166666666667,6.94221105527638,998,6.94789579158317
606,393,6.95709570957096,6.93638676844784,999,6.94894894894895
610,387,6.95737704918033,6.93798449612403,997,6.94984954864594
610,389,6.96065573770492,6.93830334190231,999,6.95195195195195
605,394,6.96198347107438,6.94416243654822,999,6.95495495495495
598,400,6.95986622073579,6.945,998,6.95390781563126
597,402,6.96147403685092,6.95024875621891,999,6.95695695695696
597,402,6.96147403685092,6.94776119402985,999,6.95595595595596
598,401,6.96153846153846,6.9426433915212,999,6.95395395395395
611,387,6.96235679214403,6.94573643410853,998,6.95591182364729
600,396,6.95666666666667,6.9469696969697,996,6.95281124497992
600,399,6.96,6.93734335839599,999,6.95095095095095
608,391,6.95888157894737,6.94373401534527,999,6.95295295295295
603,396,6.95356550580431,6.9469696969697,999,6.95095095095095
599,398,6.95158597662771,6.94472361809045,997,6.94884653961886
612,387,6.95424836601307,6.93798449612403,999,6.94794794794795
612,387,6.95261437908497,6.9328165374677,999,6.94494494494494
614,385,6.94788273615635,6.93506493506494,999,6.94294294294294
612,386,6.94934640522876,6.91968911917098,998,6.93787575150301
616,383,6.95292207792208,6.91906005221932,999,6.93993993993994
614,385,6.94951140065147,6.91428571428571,999,6.93593593593594
622,376,6.94855305466238,6.91223404255319,998,6.93486973947896
620,379,6.95,6.91820580474934,999,6.93793793793794
620,378,6.94838709677419,6.91534391534392,998,6.93587174348697
630,366,6.94920634920635,6.91803278688525,996,6.93775100401606
637,362,6.94819466248038,6.90883977900552,999,6.93393393393393
638,361,6.95297805642633,6.90858725761773,999,6.93693693693694
644,354,6.94875776397516,6.90960451977401,998,6.93486973947896
630,368,6.95079365079365,6.91304347826087,998,6.93687374749499
638,360,6.94984326018809,6.91111111111111,998,6.93587174348697
645,354,6.94573643410853,6.91242937853107,999,6.93393393393393
638,361,6.94670846394984,6.91689750692521,999,6.93593593593594
646,352,6.95046439628483,6.90909090909091,998,6.93587174348697
659,340,6.94992412746586,6.91764705882353,999,6.93893893893894
637,360,6.94348508634223,6.91944444444444,997,6.93480441323972
636,361,6.94339622641509,6.90858725761773,997,6.93079237713139
635,364,6.94330708661417,6.91483516483517,999,6.93293293293293
628,371,6.93949044585987,6.92452830188679,999,6.93393393393393
634,365,6.9384858044164,6.90958904109589,999,6.92792792792793
629,368,6.94276629570747,6.91576086956522,997,6.93279839518556
636,362,6.93867924528302,6.91988950276243,998,6.93186372745491
641,358,6.93915756630265,6.91620111731844,999,6.93093093093093
645,352,6.94108527131783,6.91761363636364,997,6.93279839518556
653,346,6.94027565084227,6.92196531791908,999,6.93393393393393
646,352,6.93343653250774,6.92897727272727,998,6.93186372745491
647,351,6.93663060278207,6.93447293447293,998,6.93587174348697
653,345,6.93721286370597,6.92463768115942,998,6.93286573146293
656,343,6.92987804878049,6.93877551020408,999,6.93293293293293
658,341,6.93617021276596,6.93548387096774,999,6.93593593593594
657,341,6.94216133942161,6.93255131964809,998,6.93887775551102
665,334,6.93684210526316,6.93712574850299,999,6.93693693693694
658,341,6.93920972644377,6.93548387096774,999,6.93793793793794
658,340,6.94376899696049,6.92941176470588,998,6.93887775551102
666,332,6.94294294294294,6.92168674698795,998,6.93587174348697
669,330,6.94170403587444,6.92121212121212,999,6.93493493493493
667,332,6.94452773613193,6.93373493975904,999,6.94094094094094
655,344,6.94503816793893,6.93313953488372,999,6.94094094094094
655,344,6.94198473282443,6.93313953488372,999,6.93893893893894
654,345,6.94495412844037,6.93333333333333,999,6.94094094094094
648,351,6.94444444444444,6.93162393162393,999,6.93993993993994
641,357,6.94539781591264,6.92997198879552,998,6.93987975951904
643,356,6.9393468118196,6.93258426966292,999,6.93693693693694
647,351,6.93663060278207,6.92877492877493,998,6.93386773547094
637,359,6.93249607535322,6.93593314763231,996,6.93373493975904
634,363,6.93690851735016,6.93939393939394,997,6.93781344032096
633,365,6.93996840442338,6.94520547945205,998,6.94188376753507
634,363,6.9384858044164,6.95592286501377,997,6.94483450351053
639,359,6.93896713615023,6.96100278551532,998,6.94689378757515
631,368,6.93502377179081,6.95923913043478,999,6.94394394394394
626,370,6.93929712460064,6.96756756756757,996,6.94979919678715
632,367,6.93829113924051,6.96730245231608,999,6.94894894894895
630,369,6.93809523809524,6.97018970189702,999,6.94994994994995
629,370,6.94276629570747,6.97027027027027,999,6.95295295295295
629,368,6.939586645469,6.96739130434783,997,6.94984954864594
628,370,6.93630573248408,6.97027027027027,998,6.94889779559118
631,367,6.93819334389857,6.96730245231608,998,6.94889779559118
634,364,6.9416403785489,6.96703296703297,998,6.95090180360721
631,367,6.94294770206022,6.9700272479564,998,6.95290581162325
636,363,6.94339622641509,6.96969696969697,999,6.95295295295295
636,362,6.94496855345912,6.97237569060773,998,6.95490981963928
633,366,6.95260663507109,6.97267759562842,999,6.95995995995996
635,363,6.94488188976378,6.97245179063361,998,6.95490981963928
629,369,6.94594594594595,6.97560975609756,998,6.95691382765531
630,369,6.94920634920635,6.97560975609756,999,6.95895895895896
630,368,6.94920634920635,6.97282608695652,998,6.95791583166333
623,376,6.95345104333868,6.97074468085106,999,6.95995995995996
625,373,6.9488,6.97319034852547,998,6.95791583166333
625,373,6.9552,6.97587131367292,998,6.96292585170341
621,377,6.95169082125604,6.97082228116711,998,6.95891783567134
626,373,6.94888178913738,6.96782841823056,999,6.95595595595596
624,375,6.95192307692308,6.97333333333333,999,6.95995995995996
625,373,6.9472,6.97319034852547,998,6.95691382765531
626,372,6.94888178913738,6.97311827956989,998,6.95791583166333
620,379,6.95645161290323,6.97889182058047,999,6.96496496496496
617,382,6.95948136142626,6.97643979057592,999,6.96596596596597
618,381,6.96116504854369,6.97637795275591,999,6.96696696696697
609,389,6.96223316912972,6.97686375321337,998,6.96793587174349
616,382,6.96266233766234,6.97905759162304,998,6.9689378757515
616,383,6.95616883116883,6.97389033942559,999,6.96296296296296
614,385,6.95765472312704,6.97142857142857,999,6.96296296296296
623,375,6.96147672552167,6.97066666666667,998,6.96492985971944
621,376,6.9597423510467,6.96808510638298,997,6.96288866599799
624,375,6.95833333333333,6.96266666666667,999,6.95995995995996
627,370,6.96012759170654,6.95945945945946,997,6.95987963891675
625,374,6.9584,6.9572192513369,999,6.95795795795796
619,379,6.96284329563813,6.95514511873351,998,6.95991983967936
616,382,6.96753246753247,6.96073298429319,998,6.96492985971944
618,378,6.96601941747573,6.95767195767196,996,6.96285140562249
623,376,6.96468699839486,6.95744680851064,999,6.96196196196196
628,371,6.96178343949045,6.9622641509434,999,6.96196196196196
634,365,6.96687697160883,6.95890410958904,999,6.96396396396396
626,370,6.96325878594249,6.95675675675676,996,6.96084337349398
636,363,6.96069182389937,6.96143250688705,999,6.96096096096096
647,352,6.9613601236476,6.96590909090909,999,6.96296296296296
639,359,6.96087636932707,6.96378830083565,998,6.96192384769539
635,364,6.96062992125984,6.96428571428571,999,6.96196196196196
633,365,6.95892575039495,6.96438356164384,998,6.96092184368737
629,370,6.96184419713831,6.96756756756757,999,6.96396396396396
622,376,6.96463022508039,6.96276595744681,998,6.96392785571142
630,368,6.96031746031746,6.96467391304348,998,6.96192384769539
632,367,6.95886075949367,6.96730245231608,999,6.96196196196196
623,376,6.95826645264848,6.96276595744681,999,6.95995995995996
622,376,6.95659163987138,6.96542553191489,998,6.95991983967936
630,369,6.95396825396825,6.97018970189702,999,6.95995995995996
619,380,6.95638126009693,6.96842105263158,999,6.96096096096096
619,380,6.95315024232633,6.96842105263158,999,6.95895895895896
619,379,6.95315024232633,6.96833773087071,998,6.95891783567134
612,386,6.95098039215686,6.97150259067358,998,6.95891783567134
615,383,6.9479674796748,6.96344647519582,998,6.95390781563126
628,370,6.94904458598726,6.96756756756757,998,6.95591182364729
620,379,6.94193548387097,6.96833773087071,999,6.95195195195195
624,374,6.94551282051282,6.96524064171123,998,6.95290581162325
624,375,6.94230769230769,6.96266666666667,999,6.94994994994995
618,379,6.94660194174757,6.96306068601583,997,6.95285857572718
625,374,6.9504,6.96524064171123,999,6.95595595595596
617,380,6.95299837925446,6.96315789473684,997,6.95687061183551
607,391,6.95387149917628,6.9616368286445,998,6.95691382765531
610,388,6.95573770491803,6.9639175257732,998,6.95891783567134
607,392,6.95551894563427,6.96173469387755,999,6.95795795795796
616,382,6.95292207792208,6.96596858638743,998,6.95791583166333
615,384,6.95447154471545,6.96354166666667,999,6.95795795795796
618,381,6.957928802589,6.96850393700787,999,6.96196196196196
628,371,6.95382165605096,6.96765498652291,999,6.95895895895896
625,374,6.952,6.96524064171123,999,6.95695695695696
622,376,6.95016077170418,6.96808510638298,998,6.95691382765531
629,369,6.94912559618442,6.96205962059621,998,6.95390781563126
633,365,6.94470774091627,6.96438356164384,998,6.95190380761523
637,361,6.94505494505495,6.96398891966759,998,6.95190380761523
639,360,6.9452269170579,6.96666666666667,999,6.95295295295295
642,355,6.94080996884735,6.96338028169014,997,6.94884653961886
637,362,6.94348508634223,6.96408839779006,999,6.95095095095095
643,356,6.9393468118196,6.96348314606742,999,6.94794794794795
641,358,6.94227769110764,6.9608938547486,999,6.94894894894895
636,363,6.94496855345912,6.96143250688705,999,6.95095095095095
634,365,6.94479495268139,6.96438356164384,999,6.95195195195195
632,367,6.94462025316456,6.9591280653951,999,6.94994994994995
627,372,6.94417862838915,6.95698924731183,999,6.94894894894895
636,363,6.94811320754717,6.95867768595041,999,6.95195195195195
636,363,6.95440251572327,6.96418732782369,999,6.95795795795796
635,362,6.95433070866142,6.96132596685083,997,6.95687061183551
641,356,6.95319812792512,6.96629213483146,997,6.95787362086259
647,350,6.95208655332303,6.96857142857143,997,6.95787362086259
651,348,6.95084485407066,6.95977011494253,999,6.95395395395395
647,351,6.95208655332303,6.96011396011396,998,6.95490981963928
653,346,6.95405819295559,6.96242774566474,999,6.95695695695696
660,338,6.95454545454545,6.9585798816568,998,6.95591182364729
662,336,6.95317220543807,6.95535714285714,998,6.95390781563126
669,328,6.95814648729447,6.96036585365854,997,6.95887662988967
684,314,6.95760233918129,6.96815286624204,998,6.96092184368737
687,311,6.95342066957787,6.96463022508039,998,6.95691382765531
683,316,6.95314787701318,6.96835443037975,999,6.95795795795796
683,313,6.95900439238653,6.97444089456869,996,6.96385542168675
686,312,6.95772594752187,6.97435897435897,998,6.96292585170341
682,316,6.95894428152493,6.9746835443038,998,6.96392785571142
688,309,6.96075581395349,6.98058252427184,997,6.96690070210632
686,313,6.96064139941691,6.98083067092652,999,6.96696696696697
684,312,6.96345029239766,6.9775641025641,996,6.96787148594377
694,305,6.96397694524496,6.97704918032787,999,6.96796796796797
689,309,6.96081277213353,6.97734627831715,998,6.96593186372746
687,312,6.96215429403202,6.97435897435897,999,6.96596596596597
694,304,6.96397694524496,6.97039473684211,998,6.96593186372746
686,313,6.96501457725947,6.96805111821086,999,6.96596596596597
686,312,6.96355685131195,6.96794871794872,998,6.96492985971944
678,321,6.96607669616519,6.95638629283489,999,6.96296296296296
684,313,6.96198830409357,6.95846645367412,997,6.96088264794383
680,319,6.96323529411765,6.96238244514107,999,6.96296296296296
679,320,6.96170839469809,6.9625,999,6.96196196196196
685,314,6.96350364963504,6.96178343949045,999,6.96296296296296
683,315,6.96046852122987,6.95873015873016,998,6.95991983967936
675,323,6.96444444444444,6.95975232198142,998,6.96292585170341
676,323,6.96449704142012,6.96284829721362,999,6.96396396396396
678,320,6.9646017699115,6.9625,998,6.96392785571142
675,324,6.96444444444444,6.96604938271605,999,6.96496496496496
667,331,6.96701649175412,6.96978851963746,998,6.96793587174349
675,324,6.96888888888889,6.97530864197531,999,6.97097097097097
669,330,6.96711509715994,6.97575757575758,999,6.96996996996997
667,332,6.97151424287856,6.97590361445783,999,6.97297297297297
662,334,6.96978851963746,6.97305389221557,996,6.97088353413655
668,331,6.96556886227545,6.97885196374622,999,6.96996996996997
669,330,6.96562032884903,6.97878787878788,999,6.96996996996997
670,328,6.96716417910448,6.98170731707317,998,6.97194388777555
668,331,6.96706586826347,6.98187311178248,999,6.97197197197197
678,320,6.96755162241888,6.98125,998,6.97194388777555
674,324,6.97032640949555,6.98456790123457,998,6.9749498997996
661,337,6.97276853252647,6.97922848664688,998,6.9749498997996
673,325,6.97176820208024,6.97846153846154,998,6.97394789579158
680,319,6.97205882352941,6.98119122257053,999,6.97497497497497
673,324,6.96879643387816,6.97839506172839,997,6.97191574724173
674,325,6.97032640949555,6.97230769230769,999,6.97097097097097
679,320,6.96759941089838,6.971875,999,6.96896896896897
676,322,6.96597633136095,6.96894409937888,998,6.96693386773547
681,318,6.96769456681351,6.95911949685535,999,6.96496496496496
679,319,6.96465390279823,6.96551724137931,998,6.96492985971944
675,324,6.96592592592593,6.96913580246914,999,6.96696696696697
684,315,6.96783625730994,6.96825396825397,999,6.96796796796797
674,324,6.96290801186944,6.96913580246914,998,6.96492985971944
677,321,6.96454948301329,6.97196261682243,998,6.96693386773547
676,322,6.96745562130178,6.97204968944099,998,6.9689378757515
668,331,6.96556886227545,6.96978851963746,999,6.96696696696697
661,337,6.9606656580938,6.97329376854599,998,6.96492985971944
669,329,6.96562032884903,6.97872340425532,998,6.96993987975952
676,322,6.96597633136095,6.98447204968944,998,6.97194388777555
674,325,6.96587537091988,6.98461538461538,999,6.97197197197197
666,333,6.97447447447447,6.98198198198198,999,6.97697697697698
669,330,6.98056801195815,6.97878787878788,999,6.97997997997998
678,320,6.98230088495575,6.975,998,6.97995991983968
682,316,6.98240469208211,6.9746835443038,998,6.97995991983968
678,320,6.98082595870206,6.971875,998,6.97795591182365
679,320,6.98085419734904,6.96875,999,6.97697697697698
686,311,6.98104956268222,6.97106109324759,997,6.97793380140421
688,311,6.9796511627907,6.97106109324759,999,6.97697697697698
696,303,6.97988505747126,6.96699669966997,999,6.97597597597598
704,294,6.98011363636364,6.96258503401361,998,6.9749498997996
703,295,6.97866287339972,6.96271186440678,998,6.97394789579158
711,286,6.9817158931083,6.96153846153846,997,6.97592778335005
712,287,6.9873595505618,6.95470383275261,999,6.97797797797798
694,304,6.98126801152738,6.96052631578947,998,6.9749498997996
684,312,6.98391812865497,6.96153846153846,996,6.97690763052209
689,309,6.98548621190131,6.957928802589,998,6.97695390781563
679,319,6.98232695139912,6.96238244514107,998,6.97595190380762
677,322,6.97932053175775,6.96273291925466,999,6.97397397397397
671,327,6.97913561847988,6.96636085626911,998,6.9749498997996
675,324,6.97925925925926,6.96913580246914,999,6.97597597597598
673,326,6.97622585438336,6.96932515337423,999,6.97397397397397
674,324,6.97626112759644,6.96913580246914,998,6.97394789579158
672,326,6.97916666666667,6.96932515337423,998,6.97595190380762
672,326,6.97470238095238,6.96932515337423,998,6.97294589178357
673,325,6.97622585438336,6.97230769230769,998,6.9749498997996
682,315,6.97947214076246,6.97142857142857,997,6.97693079237713
682,315,6.98387096774194,6.97777777777778,997,6.98194583751254
678,321,6.98230088495575,6.97819314641745,999,6.98098098098098
671,328,6.98509687034277,6.97865853658537,999,6.98298298298298
670,328,6.98507462686567,6.97560975609756,998,6.98196392785571
680,319,6.98235294117647,6.9717868338558,999,6.97897897897898
682,317,6.98240469208211,6.97160883280757,999,6.97897897897898
683,316,6.98243045387994,6.96518987341772,999,6.97697697697698
675,324,6.97925925925926,6.96296296296296,999,6.97397397397397
666,333,6.98348348348348,6.96096096096096,999,6.97597597597598
663,332,6.98491704374057,6.96084337349398,995,6.97688442211055
664,334,6.98644578313253,6.95808383233533,998,6.97695390781563
664,333,6.98644578313253,6.96396396396396,997,6.97893681043129
662,337,6.98489425981873,6.96439169139466,999,6.97797797797798
672,324,6.98511904761905,6.96604938271605,996,6.9789156626506
669,329,6.98654708520179,6.96960486322188,998,6.98096192384769
665,334,6.98796992481203,6.96706586826347,999,6.98098098098098
670,327,6.98805970149254,6.97247706422018,997,6.98294884653962
672,326,6.98660714285714,6.96932515337423,998,6.98096192384769
667,330,6.98500749625187,6.96969696969697,997,6.97993981945837
669,330,6.98804185351271,6.96666666666667,999,6.98098098098098
673,326,6.98959881129272,6.96932515337423,999,6.98298298298298
664,334,6.98644578313253,6.97305389221557,998,6.98196392785571
666,332,6.98948948948949,6.96987951807229,998,6.98296593186373
668,331,6.99101796407186,6.96676737160121,999,6.98298298298298
660,339,6.98939393939394,6.9646017699115,999,6.98098098098098
663,336,6.99095022624434,6.96428571428571,999,6.98198198198198
656,343,6.99085365853659,6.96501457725947,999,6.98198198198198
655,344,6.99083969465649,6.96220930232558,999,6.98098098098098
659,339,6.98937784522003,6.9646017699115,998,6.98096192384769
653,345,6.98928024502297,6.96521739130435,998,6.98096192384769
646,352,6.99071207430341,6.96590909090909,998,6.98196392785571
641,358,6.98907956318253,6.96368715083799,999,6.97997997997998
647,352,6.98763523956723,6.96590909090909,999,6.97997997997998
646,353,6.98916408668731,6.97450424929179,999,6.98398398398398
647,351,6.99072642967543,6.97150997150997,998,6.98396793587174
643,355,6.98600311041991,6.97746478873239,998,6.98296593186373
641,357,6.98595943837754,6.98039215686275,998,6.98396793587174
638,361,6.9858934169279,6.98060941828255,999,6.98398398398398
636,360,6.98270440251572,6.98055555555556,996,6.98192771084337
646,352,6.97987616099071,6.98011363636364,998,6.97995991983968
643,354,6.98289269051322,6.98305084745763,997,6.98294884653962
640,359,6.9859375,6.98328690807799,999,6.98498498498498
637,362,6.98273155416013,6.98342541436464,999,6.98298298298298
636,362,6.98584905660377,6.98066298342541,998,6.98396793587174
637,362,6.98587127158556,6.97790055248619,999,6.98298298298298
640,359,6.9859375,6.97771587743733,999,6.98298298298298
652,347,6.98773006134969,6.98270893371758,999,6.98598598598599
647,352,6.98763523956723,6.98579545454545,999,6.98698698698699
662,336,6.98791540785498,6.98809523809524,998,6.98797595190381
659,339,6.98786039453718,6.9882005899705,998,6.98797595190381
649,349,6.98613251155624,6.98567335243553,998,6.98597194388778
667,332,6.98950524737631,6.98795180722892,999,6.98898898898899
670,329,6.9910447761194,6.99088145896657,999,6.99099099099099
676,323,6.99112426035503,6.98761609907121,999,6.98998998998999
681,316,6.99412628487518,6.9873417721519,997,6.99197592778335
677,322,6.99261447562777,6.98757763975155,999,6.99099099099099
681,316,6.99412628487518,6.98417721518987,997,6.99097291875627
687,312,6.99417758369723,6.98717948717949,999,6.99199199199199
686,313,6.99416909620991,6.98402555910543,999,6.99099099099099
686,313,6.99416909620991,6.98722044728435,999,6.99199199199199
685,314,6.99270072992701,6.98726114649681,999,6.99099099099099
683,316,6.99267935578331,6.98417721518987,999,6.98998998998999
688,310,6.99127906976744,6.98709677419355,998,6.98997995991984
690,308,6.98985507246377,6.98376623376623,998,6.98797595190381
693,306,6.98989898989899,6.98366013071895,999,6.98798798798799
699,299,6.9928469241774,6.9866220735786,998,6.99098196392786
705,293,6.99432624113475,6.98634812286689,998,6.99198396793587
705,291,6.99432624113475,6.98625429553265,996,6.99196787148594
717,282,6.99302649930265,6.98581560283688,999,6.99099099099099
705,293,6.99290780141844,6.98634812286689,998,6.99098196392786
705,293,6.99290780141844,6.97952218430034,998,6.98897795591182
715,284,6.99440559440559,6.98591549295775,999,6.99199199199199
710,289,6.99295774647887,6.98615916955017,999,6.99099099099099
712,287,6.99297752808989,6.98257839721254,999,6.98998998998999
712,286,6.99297752808989,6.98251748251748,998,6.98997995991984
707,292,6.99434229137199,6.98972602739726,999,6.99299299299299
704,294,6.99573863636364,6.99319727891156,998,6.99498997995992
700,298,6.99571428571429,6.99328859060403,998,6.99498997995992
699,300,6.99427753934192,6.99333333333333,999,6.99399399399399
696,302,6.99425287356322,6.99337748344371,998,6.9939879759519
692,306,6.99566473988439,6.99673202614379,998,6.99599198396794
695,304,6.99568345323741,6.99671052631579,999,6.995995995996
694,305,6.99567723342939,7.0,999,6.996996996997
695,304,6.99568345323741,7.0,999,6.996996996997
693,304,6.995670995671,7.0,997,6.99699097291876
701,297,6.99572039942939,7.0,998,6.99699398797595
700,298,6.99428571428571,7.0,998,6.99599198396794
703,293,6.99431009957326,7.0,996,6.99598393574297
713,285,6.99579242636746,7.0,998,6.99699398797595
705,294,6.99432624113475,7.0,999,6.995995995996
709,290,6.99576868829337,7.0,999,6.996996996997
702,295,6.9957264957265,7.0,997,6.99699097291876
699,299,6.99570815450644,7.0,998,6.99699398797595
709,290,6.99435825105783,7.0,999,6.995995995996
698,300,6.99570200573066,7.0,998,6.99699398797595
695,304,6.99568345323741,7.0,999,6.996996996997
699,299,6.99570815450644,7.0,998,6.99699398797595
691,308,6.99421128798842,7.0,999,6.995995995996
695,304,6.99424460431655,7.0,999,6.995995995996
707,291,6.995756718529,7.0,998,6.99699398797595
696,302,6.99425287356322,7.0,998,6.99599198396794
688,308,6.99418604651163,7.0,996,6.99598393574297
693,305,6.99422799422799,7.0,998,6.99599198396794
687,312,6.99272197962154,7.0,999,6.99499499499499
701,298,6.99286733238231,7.0,999,6.99499499499499
702,297,6.99287749287749,7.0,999,6.99499499499499
694,304,6.99279538904899,7.0,998,6.99498997995992
696,303,6.99281609195402,7.0,999,6.99499499499499
687,312,6.99272197962154,7.0,999,6.99499499499499
694,305,6.99423631123919,7.0,999,6.995995995996
706,293,6.9915014164306,7.0,999,6.99399399399399
695,301,6.99136690647482,7.0,996,6.99397590361446
708,290,6.99293785310734,7.0,998,6.99498997995992
710,288,6.99154929577465,7.0,998,6.9939879759519
699,300,6.99141630901288,7.0,999,6.99399399399399
697,302,6.99282639885222,7.0,999,6.99499499499499
694,305,6.99279538904899,7.0,999,6.99499499499499
697,302,6.99139167862267,7.0,999,6.99399399399399
698,300,6.98997134670487,7.0,998,6.99298597194389
697,302,6.98995695839311,7.0,999,6.99299299299299
696,303,6.98994252873563,7.0,999,6.99299299299299
700,299,6.98857142857143,7.0,999,6.99199199199199
696,303,6.98706896551724,7.0,999,6.99099099099099
699,300,6.98855507868383,7.0,999,6.99199199199199
707,291,6.98585572842999,7.0,998,6.98997995991984
711,287,6.9845288326301,7.0,998,6.98897795591182
710,289,6.98591549295775,7.0,999,6.98998998998999
713,286,6.9859747545582,7.0,999,6.98998998998999
715,283,6.98321678321678,7.0,998,6.98797595190381
724,275,6.98618784530387,7.0,999,6.98998998998999
729,268,6.98628257887517,7.0,997,6.98996990972919
716,283,6.98603351955307,7.0,999,6.98998998998999
718,279,6.98467966573816,7.0,997,6.98896690070211
716,282,6.98603351955307,7.0,998,6.98997995991984
711,287,6.9873417721519,7.0,998,6.99098196392786
708,291,6.98446327683616,7.0,999,6.98898898898899
708,290,6.98446327683616,7.0,998,6.98897795591182
702,296,6.98575498575499,7.0,998,6.98997995991984
700,299,6.98571428571429,7.0,999,6.98998998998999
696,302,6.98419540229885,7.0,998,6.98897795591182
688,311,6.98255813953488,7.0,999,6.98798798798799
685,313,6.98102189781022,7.0,998,6.98697394789579
693,306,6.97979797979798,7.0,999,6.98598598598599
692,307,6.97832369942197,7.0,999,6.98498498498498
688,310,6.9796511627907,7.0,998,6.98597194388778
684,312,6.9780701754386,7.0,996,6.98493975903614
695,304,6.97985611510791,7.0,999,6.98598598598599
697,300,6.97991391678623,7.0,997,6.98595787362086
693,305,6.97979797979798,7.0,998,6.98597194388778
689,308,6.9811320754717,7.0,997,6.98696088264794
695,303,6.9841726618705,7.0,998,6.98897795591182
691,308,6.98697539797395,7.0,999,6.99099099099099
685,314,6.98978102189781,7.0,999,6.99299299299299
686,312,6.98979591836735,7.0,998,6.99298597194389
677,320,6.98966026587888,7.0,997,6.99297893681043
679,320,6.98821796759941,7.0,999,6.99199199199199
677,321,6.98818316100443,7.0,998,6.99198396793587
675,324,6.98814814814815,7.0,999,6.99199199199199
673,326,6.98662704309064,7.0,999,6.99099099099099
678,321,6.98672566371681,7.0,999,6.99099099099099
683,316,6.98682284040996,7.0,999,6.99099099099099
685,313,6.98540145985401,7.0,998,6.98997995991984
676,322,6.9896449704142,7.0,998,6.99298597194389
677,321,6.98966026587888,7.0,998,6.99298597194389
680,317,6.98970588235294,7.0,997,6.99297893681043
682,317,6.98680351906158,7.0,999,6.99099099099099
683,316,6.98682284040996,7.0,999,6.99099099099099
680,317,6.98529411764706,7.0,997,6.98996990972919
684,314,6.98245614035088,7.0,998,6.98797595190381
694,305,6.98414985590778,7.0,999,6.98898898898899
695,303,6.98561151079137,7.0,998,6.98997995991984
696,301,6.97988505747126,7.0,997,6.98595787362086
705,294,6.98439716312057,7.0,999,6.98898898898899
694,304,6.98414985590778,7.0,998,6.98897795591182
695,304,6.9841726618705,7.0,999,6.98898898898899
697,302,6.98134863701578,7.0,999,6.98698698698699
701,297,6.98288159771755,7.0,998,6.98797595190381
706,293,6.98441926345609,7.0,999,6.98898898898899
718,281,6.98328690807799,7.0,999,6.98798798798799
710,287,6.98450704225352,7.0,997,6.98896690070211
711,288,6.9845288326301,7.0,999,6.98898898898899
712,286,6.98314606741573,7.0,998,6.98797595190381
716,283,6.98324022346369,7.0,999,6.98798798798799
710,289,6.98028169014084,7.0,999,6.98598598598599
711,288,6.9789029535865,7.0,999,6.98498498498498
709,289,6.98166431593794,7.0,998,6.98697394789579
704,295,6.98153409090909,7.0,999,6.98698698698699
706,291,6.97875354107649,7.0,997,6.98495486459378
706,292,6.97875354107649,7.0,998,6.98496993987976
707,292,6.97878359264498,7.0,999,6.98498498498498
710,289,6.97605633802817,7.0,999,6.98298298298298
699,299,6.97424892703863,7.0,998,6.98196392785571
698,301,6.97134670487106,7.0,999,6.97997997997998
696,303,6.96695402298851,7.0,999,6.97697697697698
692,307,6.96965317919075,7.0,999,6.97897897897898
704,293,6.97443181818182,7.0,997,6.98194583751254
700,298,6.97428571428571,7.0,998,6.98196392785571
700,299,6.97428571428571,7.0,999,6.98198198198198
708,287,6.97457627118644,7.0,995,6.98190954773869
708,290,6.97457627118644,7.0,998,6.98196392785571
