forward_num,reverse_num,forward_rate,reverse_rate,organism_num,organism_rate
500,500,5.5,5.5,1000,5.5
498,496,5.50200803212851,5.50403225806452,994,5.50301810865191
496,494,5.49193548387097,5.51619433198381,990,5.5040404040404
545,454,5.81284403669725,5.55947136563877,999,5.6976976976977
584,414,5.95205479452055,5.58212560386473,998,5.79859719438878
615,384,6.0260162601626,5.61979166666667,999,5.86986986986987
644,355,6.04503105590062,5.57746478873239,999,5.87887887887888
667,330,6.047976011994,5.58181818181818,997,5.89368104312939
686,313,6.06705539358601,5.49840255591054,999,5.88888888888889
708,291,6.18502824858757,5.48109965635739,999,5.97997997997998
666,332,6.21021021021021,5.19879518072289,998,5.87374749498998
699,300,6.0071530758226,5.23333333333333,999,5.77477477477477
711,288,6.16315049226442,5.09722222222222,999,5.85585585585586
685,314,6.14014598540146,5.13694267515924,999,5.82482482482482
674,325,6.0919881305638,5.39384615384615,999,5.86486486486486
687,312,6.22998544395924,5.28846153846154,999,5.93593593593594
637,362,6.22448979591837,5.61049723756906,999,6.002002002002
645,354,6.30387596899225,5.53672316384181,999,6.03203203203203
644,354,6.39130434782609,5.68361581920904,998,6.14028056112224
651,347,6.42549923195084,5.78097982708934,998,6.20140280561122
631,364,6.40887480190174,5.89835164835165,995,6.22211055276382
662,335,6.13293051359517,5.89850746268657,997,6.05416248746239
635,362,6.16850393700787,5.80386740331492,997,6.03610832497492
655,344,6.1618320610687,5.7703488372093,999,6.02702702702703
673,325,6.19019316493314,5.76923076923077,998,6.05310621242485
661,338,6.2375189107413,5.86094674556213,999,6.11011011011011
664,334,6.26807228915663,5.75748502994012,998,6.09719438877756
655,343,6.2793893129771,5.87463556851312,998,6.14028056112224
682,317,6.31964809384164,5.88643533123028,999,6.18218218218218
683,315,6.35431918008785,5.97142857142857,998,6.23346693386774
672,327,6.34672619047619,6.03975535168196,999,6.24624624624625
675,323,6.32592592592593,5.99071207430341,998,6.21743486973948
674,325,6.37091988130564,6.05538461538462,999,6.26826826826827
673,325,6.41604754829123,6.07384615384615,998,6.30460921843687
670,327,6.37164179104478,6.04587155963303,997,6.26479438314945
671,327,6.36065573770492,6.07339449541284,998,6.26653306613226
672,327,6.28869047619048,6.12844036697248,999,6.23623623623624
660,339,6.30454545454545,6.08554572271386,999,6.23023023023023
664,335,6.35090361445783,5.98805970149254,999,6.22922922922923
654,344,6.35168195718654,6.05813953488372,998,6.25050100200401
664,335,6.36144578313253,6.03880597014925,999,6.25325325325325
649,350,6.29275808936826,6.07142857142857,999,6.21521521521522
657,340,6.32267884322679,6.05882352941176,997,6.23269809428285
651,346,6.33179723502304,5.94219653179191,997,6.19658976930792
662,335,6.30815709969789,5.95522388059702,997,6.18956870611836
669,330,6.33632286995516,5.9,999,6.19219219219219
674,325,6.34569732937685,6.00615384615385,999,6.23523523523524
680,319,6.41911764705882,6.07210031347962,999,6.30830830830831
678,321,6.45132743362832,6.17133956386293,999,6.36136136136136
687,312,6.41048034934498,6.24358974358974,999,6.35835835835836
687,311,6.40029112081514,6.22829581993569,998,6.34669338677355
691,307,6.3342981186686,6.24104234527687,998,6.30561122244489
685,314,6.35328467153285,6.25477707006369,999,6.32232232232232
686,313,6.34839650145773,6.29392971246006,999,6.33133133133133
687,311,6.34352256186317,6.33762057877814,998,6.34168336673347
685,314,6.32408759124088,6.4171974522293,999,6.35335335335335
678,319,6.40560471976401,6.4294670846395,997,6.41323971915747
675,322,6.40444444444444,6.44099378881988,997,6.41624874623872
673,326,6.37444279346211,6.37423312883436,999,6.37437437437437
680,318,6.38088235294118,6.33018867924528,998,6.36472945891784
681,318,6.39500734214391,6.43081761006289,999,6.40640640640641
683,316,6.3601756954612,6.4746835443038,999,6.3963963963964
683,316,6.39677891654466,6.41772151898734,999,6.4034034034034
679,319,6.35051546391753,6.43573667711599,998,6.37775551102204
661,337,6.33282904689864,6.5786350148368,998,6.41583166332665
675,324,6.31407407407407,6.60493827160494,999,6.40840840840841
683,316,6.29428989751098,6.62025316455696,999,6.3973973973974
679,318,6.31958762886598,6.62893081761006,997,6.41825476429288
677,320,6.36632200886263,6.64375,997,6.45536609829488
681,318,6.30102790014684,6.5377358490566,999,6.37637637637638
681,317,6.2863436123348,6.59305993690852,998,6.38376753507014
683,316,6.31332357247438,6.56962025316456,999,6.39439439439439
682,316,6.31378299120235,6.59177215189873,998,6.40180360721443
687,312,6.3056768558952,6.5224358974359,999,6.37337337337337
692,307,6.34826589595376,6.58631921824104,999,6.42142142142142
698,301,6.36962750716332,6.55481727574751,999,6.42542542542543
696,303,6.40948275862069,6.45214521452145,999,6.42242242242242
695,303,6.48776978417266,6.4983498349835,998,6.49098196392786
694,305,6.46829971181556,6.49508196721311,999,6.47647647647648
698,301,6.51719197707736,6.44518272425249,999,6.4954954954955
693,306,6.49062049062049,6.48692810457516,999,6.48948948948949
689,309,6.46153846153846,6.55663430420712,998,6.49098196392786
691,306,6.45875542691751,6.60130718954248,997,6.5025075225677
698,301,6.44126074498567,6.58471760797342,999,6.48448448448448
692,306,6.42196531791908,6.49019607843137,998,6.44288577154309
685,314,6.45547445255474,6.44585987261147,999,6.45245245245245
679,320,6.4300441826215,6.41875,999,6.42642642642643
679,316,6.4359351988218,6.41772151898734,995,6.43015075376884
686,312,6.49125364431487,6.36858974358974,998,6.45290581162325
681,318,6.48604992657856,6.40251572327044,999,6.45945945945946
679,318,6.5081001472754,6.40566037735849,997,6.47542627883651
683,316,6.45827232796486,6.43987341772152,999,6.45245245245245
690,309,6.42608695652174,6.45954692556634,999,6.43643643643644
680,319,6.43529411764706,6.42633228840125,999,6.43243243243243
682,316,6.43988269794721,6.43354430379747,998,6.43787575150301
688,310,6.42587209302326,6.42258064516129,998,6.4248496993988
693,306,6.3997113997114,6.40522875816993,999,6.4014014014014
692,306,6.4364161849711,6.39542483660131,998,6.42384769539078
695,304,6.48201438848921,6.33223684210526,999,6.43643643643644
694,304,6.48126801152738,6.43092105263158,998,6.46593186372746
694,304,6.49567723342939,6.48684210526316,998,6.49298597194389
705,294,6.54751773049645,6.46598639455782,999,6.52352352352352
704,292,6.52840909090909,6.45205479452055,996,6.50602409638554
708,290,6.43502824858757,6.48965517241379,998,6.45090180360721
713,286,6.41234221598878,6.5,999,6.43743743743744
716,282,6.43016759776536,6.5177304964539,998,6.45490981963928
717,282,6.34030683403068,6.48581560283688,999,6.38138138138138
728,269,6.40247252747253,6.49814126394052,997,6.42828485456369
728,270,6.36401098901099,6.57037037037037,998,6.41983967935872
731,268,6.39398084815322,6.58955223880597,999,6.44644644644645
726,273,6.38429752066116,6.57509157509157,999,6.43643643643644
726,273,6.37878787878788,6.57875457875458,999,6.43343343343343
723,276,6.43706777316736,6.57246376811594,999,6.47447447447447
721,277,6.44937586685159,6.61371841155235,998,6.49498997995992
721,277,6.4618585298197,6.63898916967509,998,6.51102204408818
729,269,6.45267489711934,6.53159851301115,998,6.47394789579158
735,264,6.44353741496599,6.51893939393939,999,6.46346346346346
726,273,6.42699724517906,6.46153846153846,999,6.43643643643644
723,276,6.42047026279391,6.45289855072464,999,6.42942942942943
729,270,6.39506172839506,6.45185185185185,999,6.41041041041041
723,274,6.40387275242047,6.42700729927007,997,6.41023069207623
721,276,6.3370319001387,6.35144927536232,997,6.34102306920762
720,277,6.34166666666667,6.36462093862816,997,6.34804413239719
724,274,6.35635359116022,6.45620437956204,998,6.38376753507014
721,278,6.29126213592233,6.38489208633094,999,6.31731731731732
719,279,6.39360222531293,6.40501792114695,998,6.39679358717435
722,276,6.35734072022161,6.32246376811594,998,6.34769539078156
724,275,6.37292817679558,6.28363636363636,999,6.34834834834835
722,275,6.33102493074792,6.31636363636364,997,6.32698094282849
728,269,6.35164835164835,6.37918215613383,997,6.35907723169509
737,262,6.40162822252374,6.37404580152672,999,6.39439439439439
741,257,6.33738191632929,6.33852140077821,998,6.3376753507014
736,259,6.32336956521739,6.28571428571429,995,6.31356783919598
733,266,6.35879945429741,6.30451127819549,999,6.34434434434434
729,269,6.39780521262003,6.32342007434944,998,6.37775551102204
731,267,6.41039671682627,6.37453183520599,998,6.40080160320641
739,259,6.40054127198917,6.32046332046332,998,6.37975951903808
734,264,6.35149863760218,6.40909090909091,998,6.36673346693387
734,264,6.32288828337875,6.39015151515152,998,6.34068136272545
733,266,6.33287858117326,6.33082706766917,999,6.33233233233233
729,270,6.32510288065844,6.34074074074074,999,6.32932932932933
730,268,6.28493150684931,6.34701492537313,998,6.30160320641283
729,270,6.26063100137174,6.3,999,6.27127127127127
725,273,6.28,6.31135531135531,998,6.28857715430862
732,267,6.28551912568306,6.24719101123596,999,6.27527527527528
732,265,6.29644808743169,6.25283018867925,997,6.28485456369107
730,269,6.31643835616438,6.19330855018587,999,6.28328328328328
739,260,6.3234100135318,6.18846153846154,999,6.28828828828829
743,254,6.33378196500673,6.27952755905512,997,6.31995987963892
745,254,6.37181208053691,6.23228346456693,999,6.33633633633634
750,248,6.376,6.22983870967742,998,6.33967935871743
747,251,6.36010709504685,6.25099601593625,998,6.33266533066132
758,240,6.35356200527704,6.29166666666667,998,6.33867735470942
753,246,6.32138114209827,6.26016260162602,999,6.30630630630631
763,236,6.36435124508519,6.24152542372881,999,6.33533533533534
754,241,6.36206896551724,6.2448132780083,995,6.33366834170854
753,245,6.38778220451527,6.26122448979592,998,6.35671342685371
745,254,6.42281879194631,6.26377952755906,999,6.38238238238238
741,258,6.39001349527665,6.21317829457364,999,6.34434434434434
745,253,6.3744966442953,6.25691699604743,998,6.34468937875751
733,266,6.48431105047749,6.14661654135338,999,6.39439439439439
744,255,6.47311827956989,6.09019607843137,999,6.37537537537538
740,258,6.41621621621622,6.14728682170543,998,6.34669338677355
746,253,6.48391420911528,6.23715415019763,999,6.42142142142142
745,252,6.49127516778523,6.24206349206349,997,6.42828485456369
753,244,6.46082337317397,6.24590163934426,997,6.40822467402207
760,238,6.45394736842105,6.2563025210084,998,6.40681362725451
768,231,6.45182291666667,6.26839826839827,999,6.40940940940941
767,231,6.46805736636245,6.21212121212121,998,6.40881763527054
781,218,6.47503201024328,6.24311926605505,999,6.42442442442442
780,219,6.45769230769231,6.31963470319635,999,6.42742742742743
777,221,6.46460746460746,6.2262443438914,998,6.41182364729459
777,222,6.46460746460746,6.21621621621622,999,6.40940940940941
775,224,6.48387096774194,6.29910714285714,999,6.44244244244244
773,226,6.49417852522639,6.2787610619469,999,6.44544544544545
776,223,6.45360824742268,6.37219730941704,999,6.43543543543544
785,214,6.43566878980892,6.39719626168224,999,6.42742742742743
771,227,6.4526588845655,6.38766519823789,998,6.43787575150301
774,224,6.47932816537468,6.47321428571429,998,6.47795591182365
775,224,6.50064516129032,6.45982142857143,999,6.49149149149149
770,228,6.55714285714286,6.63157894736842,998,6.57414829659319
780,218,6.54487179487179,6.71559633027523,998,6.58216432865731
787,212,6.53113087674714,6.74056603773585,999,6.57557557557558
773,226,6.53298835705045,6.70796460176991,999,6.57257257257257
778,221,6.48071979434447,6.61990950226244,999,6.51151151151151
775,223,6.44774193548387,6.56053811659193,998,6.47294589178357
772,227,6.46113989637306,6.56828193832599,999,6.48548548548549
772,227,6.43523316062176,6.52422907488987,999,6.45545545545546
780,218,6.40512820512821,6.59633027522936,998,6.44689378757515
775,224,6.42322580645161,6.58035714285714,999,6.45845845845846
780,218,6.42179487179487,6.61926605504587,998,6.46492985971944
788,211,6.43781725888325,6.54502369668246,999,6.46046046046046
779,220,6.45314505776637,6.55909090909091,999,6.47647647647648
782,217,6.46419437340153,6.52073732718894,999,6.47647647647648
773,225,6.48253557567917,6.53777777777778,998,6.49498997995992
782,217,6.48976982097187,6.49769585253456,999,6.49149149149149
775,222,6.55225806451613,6.57657657657658,997,6.55767301905717
768,230,6.59244791666667,6.58695652173913,998,6.59118236472946
772,227,6.54533678756477,6.47577092511013,999,6.52952952952953
770,228,6.55714285714286,6.56140350877193,998,6.55811623246493
769,228,6.52665799739922,6.49122807017544,997,6.518555667001
763,234,6.47706422018349,6.55982905982906,997,6.49648946840522
770,227,6.4974025974026,6.48017621145374,997,6.49348044132397
770,228,6.51428571428571,6.42543859649123,998,6.4939879759519
772,227,6.41321243523316,6.3920704845815,999,6.40840840840841
767,230,6.40938722294655,6.45217391304348,997,6.41925777331996
770,228,6.41038961038961,6.46491228070175,998,6.42284569138277
767,229,6.42372881355932,6.44978165938865,996,6.42971887550201
766,232,6.38120104438642,6.375,998,6.37975951903808
774,225,6.46124031007752,6.45333333333333,999,6.45945945945946
770,229,6.44675324675325,6.39737991266376,999,6.43543543543544
773,226,6.46701164294955,6.41592920353982,999,6.45545545545546
772,227,6.47279792746114,6.40088105726872,999,6.45645645645646
767,230,6.46414602346806,6.4695652173913,997,6.4653961885657
773,226,6.46054333764554,6.49115044247788,999,6.46746746746747
773,226,6.47736093143596,6.38938053097345,999,6.45745745745746
769,230,6.46553966189857,6.41739130434783,999,6.45445445445445
773,226,6.45407503234153,6.46017699115044,999,6.45545545545546
769,229,6.42132639791938,6.47598253275109,998,6.43386773547094
770,229,6.39350649350649,6.41921397379913,999,6.3993993993994
764,235,6.40183246073298,6.40851063829787,999,6.4034034034034
761,238,6.39290407358738,6.51680672268908,999,6.42242242242242
759,240,6.3768115942029,6.5375,999,6.41541541541542
746,252,6.35924932975871,6.57936507936508,998,6.41482965931864
755,243,6.34569536423841,6.64609053497942,998,6.4188376753507
750,246,6.336,6.68292682926829,996,6.42168674698795
749,249,6.31642189586115,6.65461847389558,998,6.40080160320641
744,254,6.30241935483871,6.60629921259843,998,6.37975951903808
752,246,6.22606382978723,6.65040650406504,998,6.33066132264529
749,250,6.22429906542056,6.636,999,6.32732732732733
751,248,6.23834886817577,6.63709677419355,999,6.33733733733734
751,247,6.22769640479361,6.61538461538461,998,6.32364729458918
741,257,6.23751686909582,6.52918287937743,998,6.312625250501
747,252,6.20883534136546,6.51984126984127,999,6.28728728728729
756,243,6.26322751322751,6.46090534979424,999,6.31131131131131
756,243,6.26984126984127,6.440329218107,999,6.31131131131131
758,239,6.28496042216359,6.40585774058577,997,6.31394182547643
761,237,6.30880420499343,6.35021097046414,998,6.3186372745491
763,235,6.30013106159895,6.40425531914894,998,6.32464929859719
773,226,6.28072445019405,6.41150442477876,999,6.31031031031031
771,226,6.28664072632944,6.39823008849558,997,6.31193580742227
763,235,6.25688073394495,6.36170212765957,998,6.2815631262525
766,232,6.24934725848564,6.35775862068965,998,6.27454909819639
772,227,6.22668393782383,6.35242290748899,999,6.25525525525526
775,224,6.24903225806452,6.42857142857143,999,6.28928928928929
767,229,6.27509778357236,6.38427947598253,996,6.30020080321285
769,229,6.30299089726918,6.48908296943231,998,6.34569138276553
773,226,6.3117723156533,6.5,999,6.35435435435435
771,227,6.36316472114137,6.55506607929515,998,6.40681362725451
780,219,6.3551282051282,6.51141552511416,999,6.38938938938939
779,220,6.35686777920411,6.45909090909091,999,6.37937937937938
778,220,6.37660668380463,6.46363636363636,998,6.39579158316633
776,223,6.33118556701031,6.42152466367713,999,6.35135135135135
773,225,6.33247089262613,6.34666666666667,998,6.33567134268537
768,229,6.33463541666667,6.37991266375546,997,6.34503510531595
770,227,6.30649350649351,6.51101321585903,997,6.3530591775326
760,237,6.30789473684211,6.42616033755274,997,6.33600802407222
755,244,6.27682119205298,6.51229508196721,999,6.33433433433433
758,238,6.33377308707124,6.57142857142857,996,6.39056224899598
762,237,6.36089238845144,6.72995780590717,999,6.44844844844845
756,242,6.36375661375661,6.73140495867769,998,6.45290581162325
753,244,6.35590969455511,6.72540983606557,997,6.44633901705115
748,249,6.34893048128342,6.75100401606426,997,6.4493480441324
749,248,6.36181575433912,6.65725806451613,997,6.43530591775326
752,247,6.43218085106383,6.60323886639676,999,6.47447447447447
754,245,6.46684350132626,6.56734693877551,999,6.49149149149149
752,243,6.43351063829787,6.60493827160494,995,6.47537688442211
764,235,6.45026178010471,6.6468085106383,999,6.4964964964965
768,231,6.41536458333333,6.70995670995671,999,6.48348348348348
765,234,6.43137254901961,6.76923076923077,999,6.51051051051051
760,239,6.38552631578947,6.73221757322176,999,6.46846846846847
762,236,6.31233595800525,6.75423728813559,998,6.41683366733467
761,238,6.31011826544021,6.77731092436975,999,6.42142142142142
764,234,6.32984293193717,6.74358974358974,998,6.42685370741483
757,242,6.28005284015852,6.73140495867769,999,6.38938938938939
759,240,6.28853754940711,6.7375,999,6.3963963963964
761,238,6.28120893561104,6.79831932773109,999,6.4044044044044
755,244,6.24900662251656,6.79098360655738,999,6.38138138138138
762,236,6.28346456692913,6.77542372881356,998,6.3997995991984
764,234,6.26570680628272,6.69230769230769,998,6.36573146292585
759,240,6.2437417654809,6.72083333333333,999,6.35835835835836
763,235,6.20576671035387,6.77446808510638,998,6.33967935871743
758,240,6.2467018469657,6.775,998,6.37374749498998
757,241,6.27080581241744,6.69709543568465,998,6.37374749498998
758,241,6.34036939313984,6.73858921161826,999,6.43643643643644
753,246,6.32934926958831,6.77235772357724,999,6.43843843843844
760,239,6.35,6.72803347280335,999,6.44044044044044
757,239,6.37252311756935,6.70292887029289,996,6.45180722891566
764,235,6.32460732984293,6.77446808510638,999,6.43043043043043
757,242,6.3778071334214,6.8099173553719,999,6.48248248248248
759,240,6.36627140974967,6.875,999,6.48848848848849
758,240,6.37862796833773,6.83333333333333,998,6.48797595190381
755,243,6.42781456953642,6.89711934156379,998,6.54208416833667
752,247,6.38829787234043,6.82186234817814,999,6.4954954954955
744,254,6.43413978494624,6.82283464566929,998,6.53306613226453
750,249,6.396,6.80722891566265,999,6.4984984984985
741,257,6.40620782726046,6.89105058365759,998,6.5310621242485
742,256,6.40161725067385,6.921875,998,6.53507014028056
750,249,6.38133333333333,6.90361445783132,999,6.51151151151151
751,248,6.40878828229028,6.90322580645161,999,6.53153153153153
743,256,6.38088829071332,6.87890625,999,6.50850850850851
744,254,6.36962365591398,6.82677165354331,998,6.48597194388778
740,257,6.33918918918919,6.81712062256809,997,6.46238716148445
743,255,6.27994616419919,6.75686274509804,998,6.40180360721443
741,256,6.29554655870445,6.7890625,997,6.4222668004012
748,248,6.29010695187166,6.78225806451613,996,6.41265060240964
756,242,6.36243386243386,6.79752066115702,998,6.46793587174349
760,239,6.37763157894737,6.78661087866109,999,6.47547547547548
750,248,6.32,6.81854838709677,998,6.4438877755511
753,245,6.32005312084993,6.82040816326531,998,6.44288577154309
746,253,6.3485254691689,6.8102766798419,999,6.46546546546547
759,239,6.34123847167325,6.75732217573222,998,6.44088176352705
757,242,6.31836195508586,6.67355371900826,999,6.4044044044044
754,244,6.3368700265252,6.67622950819672,998,6.41983967935872
754,245,6.3395225464191,6.68163265306122,999,6.42342342342342
751,248,6.35818908122503,6.67741935483871,999,6.43743743743744
755,244,6.37483443708609,6.66393442622951,999,6.44544544544545
753,245,6.36520584329349,6.68979591836735,998,6.44488977955912
748,250,6.34893048128342,6.708,998,6.43887775551102
746,252,6.37131367292225,6.70238095238095,998,6.45490981963928
759,238,6.34255599472991,6.71428571428571,997,6.43129388164493
753,245,6.35989375830013,6.60816326530612,998,6.42084168336673
751,245,6.36351531291611,6.60816326530612,996,6.42369477911647
750,248,6.332,6.6008064516129,998,6.39879759519038
753,246,6.31474103585657,6.63008130081301,999,6.39239239239239
740,259,6.30675675675676,6.66409266409266,999,6.3993993993994
743,255,6.26379542395693,6.71372549019608,998,6.37875751503006
735,263,6.27755102040816,6.66539923954373,998,6.37975951903808
731,267,6.29548563611491,6.66666666666667,998,6.39478957915832
734,262,6.26158038147139,6.72519083969466,996,6.38353413654619
748,251,6.25,6.73705179282869,999,6.37237237237237
745,254,6.2255033557047,6.8503937007874,999,6.38438438438438
746,253,6.23860589812332,6.88142292490119,999,6.4014014014014
746,253,6.29356568364611,6.88142292490119,999,6.44244244244244
742,256,6.27088948787062,6.75,998,6.3937875751503
742,256,6.24528301886792,6.7265625,998,6.3687374749499
755,243,6.21059602649007,6.74897119341564,998,6.34168336673347
749,248,6.23364485981308,6.68548387096774,997,6.34603811434303
744,253,6.24865591397849,6.71541501976285,997,6.36710130391173
748,250,6.2072192513369,6.78,998,6.35070140280561
751,247,6.20905459387483,6.78542510121457,998,6.35170340681363
749,247,6.19759679572764,6.76113360323887,996,6.33734939759036
741,257,6.14304993252362,6.7431906614786,998,6.29759519038076
745,254,6.16778523489933,6.62204724409449,999,6.28328328328328
736,260,6.17934782608696,6.62307692307692,996,6.29518072289157
737,262,6.17503392130258,6.59160305343511,999,6.28428428428428
739,259,6.19891745602165,6.53281853281853,998,6.28557114228457
739,259,6.19350473612991,6.53667953667954,998,6.28256513026052
733,264,6.17326057298772,6.57954545454545,997,6.28084252758275
732,267,6.28005464480874,6.56179775280899,999,6.35535535535536
728,271,6.30082417582418,6.56826568265683,999,6.37337337337337
718,277,6.30362116991643,6.5812274368231,995,6.38090452261306
726,273,6.30165289256198,6.53846153846154,999,6.36636636636637
717,282,6.30264993026499,6.58156028368794,999,6.38138138138138
723,276,6.28492392807745,6.54710144927536,999,6.35735735735736
731,267,6.25034199726402,6.55056179775281,998,6.33066132264529
729,270,6.27846364883402,6.56666666666667,999,6.35635635635636
727,271,6.27510316368638,6.50922509225092,998,6.33867735470942
733,265,6.25648021828104,6.51698113207547,998,6.32565130260521
734,265,6.25204359673025,6.51320754716981,999,6.32132132132132
734,265,6.21934604904632,6.55094339622642,999,6.30730730730731
737,262,6.19538670284939,6.54580152671756,999,6.28728728728729
742,256,6.17789757412399,6.46875,998,6.25250501002004
735,263,6.16598639455782,6.49049429657795,998,6.25150300601202
743,256,6.14131897711978,6.515625,999,6.23723723723724
739,259,6.1339648173207,6.53667953667954,998,6.23847695390782
744,255,6.11962365591398,6.48235294117647,999,6.21221221221221
748,250,6.13770053475936,6.524,998,6.23446893787575
749,250,6.10947930574099,6.568,999,6.22422422422422
746,253,6.14611260053619,6.66403162055336,999,6.27727727727728
740,258,6.18648648648649,6.6046511627907,998,6.29458917835671
744,255,6.19354838709677,6.58823529411765,999,6.29429429429429
738,261,6.17750677506775,6.64750957854406,999,6.3003003003003
741,258,6.14844804318489,6.66666666666667,999,6.28228228228228
736,263,6.10461956521739,6.63878326996198,999,6.24524524524525
739,259,6.12584573748309,6.67181467181467,998,6.26753507014028
743,256,6.16016150740242,6.68359375,999,6.29429429429429
740,257,6.12702702702703,6.69260700389105,997,6.2728184553661
737,261,6.16553595658073,6.7088122605364,998,6.30761523046092
742,257,6.18463611859838,6.67704280155642,999,6.31131131131131
738,261,6.20731707317073,6.66666666666667,999,6.32732732732733
751,248,6.14647137150466,6.64112903225806,999,6.26926926926927
758,241,6.18733509234828,6.65560165975104,999,6.3003003003003
755,243,6.15761589403974,6.62139917695473,998,6.27054108216433
747,252,6.18607764390897,6.59126984126984,999,6.28828828828829
749,250,6.18691588785047,6.6,999,6.29029029029029
744,255,6.18010752688172,6.5921568627451,999,6.28528528528529
734,265,6.13351498637602,6.55849056603774,999,6.24624624624625
732,267,6.10792349726776,6.47940074906367,999,6.20720720720721
732,266,6.08333333333333,6.38345864661654,998,6.16332665330661
738,261,6.10840108401084,6.39846743295019,999,6.18418418418418
727,271,6.12242090784044,6.50184501845018,998,6.22545090180361
727,272,6.17331499312242,6.47794117647059,999,6.25625625625626
728,271,6.19505494505495,6.51291512915129,999,6.28128128128128
725,274,6.13655172413793,6.52189781021898,999,6.24224224224224
726,273,6.15977961432507,6.52380952380952,999,6.25925925925926
715,283,6.19160839160839,6.4452296819788,998,6.26352705410822
713,286,6.21178120617111,6.40559440559441,999,6.26726726726727
708,291,6.22316384180791,6.44329896907217,999,6.28728728728729
706,291,6.25920679886686,6.52577319587629,997,6.3370110330993
711,288,6.28691983122363,6.42708333333333,999,6.32732732732733
700,294,6.29142857142857,6.39455782312925,994,6.32193158953722
704,295,6.24857954545455,6.45762711864407,999,6.31031031031031
698,299,6.189111747851,6.44147157190635,997,6.26479438314945
692,307,6.22543352601156,6.50162866449511,999,6.31031031031031
696,301,6.27155172413793,6.47840531561462,997,6.33400200601805
695,303,6.33237410071942,6.46534653465347,998,6.37274549098196
695,302,6.35539568345324,6.48675496688742,997,6.39518555667001
690,309,6.34927536231884,6.51456310679612,999,6.4004004004004
680,319,6.36029411764706,6.55799373040752,999,6.42342342342342
689,310,6.32656023222061,6.59354838709677,999,6.40940940940941
680,318,6.32058823529412,6.5062893081761,998,6.37975951903808
681,318,6.33773861967695,6.52830188679245,999,6.3983983983984
683,312,6.30893118594436,6.58974358974359,995,6.39698492462312
688,311,6.32848837209302,6.61414790996785,999,6.41741741741742
685,314,6.26715328467153,6.63694267515924,999,6.38338338338338
680,316,6.25147058823529,6.59810126582278,996,6.36144578313253
684,315,6.21198830409357,6.68888888888889,999,6.36236236236236
679,319,6.21649484536082,6.72100313479624,998,6.37775551102204
682,317,6.27712609970675,6.75709779179811,999,6.42942942942943
680,318,6.26470588235294,6.75786163522013,998,6.42184368737475
687,311,6.33624454148472,6.77813504823151,998,6.47394789579158
680,317,6.36911764705882,6.72239747634069,997,6.481444332999
669,330,6.38116591928251,6.7,999,6.48648648648649
666,333,6.40540540540541,6.71171171171171,999,6.50750750750751
660,339,6.41363636363636,6.68436578171091,999,6.50550550550551
663,336,6.35143288084465,6.66964285714286,999,6.45845845845846
660,339,6.37878787878788,6.67551622418879,999,6.47947947947948
666,332,6.33333333333333,6.65361445783132,998,6.43987975951904
664,335,6.31024096385542,6.61791044776119,999,6.41341341341341
661,335,6.31921331316188,6.65671641791045,996,6.43273092369478
667,332,6.32233883058471,6.60843373493976,999,6.41741741741742
667,332,6.36281859070465,6.50301204819277,999,6.40940940940941
659,339,6.30500758725341,6.50737463126844,998,6.37374749498998
664,333,6.32680722891566,6.54354354354354,997,6.39919759277833
663,336,6.30015082956259,6.59523809523809,999,6.3993993993994
651,348,6.27035330261137,6.57758620689655,999,6.37737737737738
650,349,6.26461538461538,6.59885386819484,999,6.38138138138138
657,342,6.29223744292237,6.61988304093567,999,6.4044044044044
639,360,6.36619718309859,6.64722222222222,999,6.46746746746747
641,357,6.44461778471139,6.62745098039216,998,6.51002004008016
639,360,6.42253521126761,6.64444444444444,999,6.5025025025025
635,363,6.37007874015748,6.64738292011019,998,6.47094188376754
645,353,6.35038759689922,6.61473087818697,998,6.4438877755511
647,352,6.36166924265842,6.66761363636364,999,6.46946946946947
644,354,6.33695652173913,6.6638418079096,998,6.45290581162325
652,347,6.33128834355828,6.65417867435159,999,6.44344344344344
651,347,6.28878648233487,6.60518731988473,998,6.39879759519038
646,352,6.26625386996904,6.67045454545455,998,6.40881763527054
650,349,6.32769230769231,6.66189111747851,999,6.44444444444444
651,348,6.31029185867896,6.6551724137931,999,6.43043043043043
654,345,6.34250764525994,6.59420289855072,999,6.42942942942943
642,356,6.37227414330218,6.59269662921348,998,6.45090180360721
633,364,6.39020537124803,6.63461538461539,997,6.47943831494483
639,359,6.320813771518,6.58774373259053,998,6.41683366733467
634,363,6.31072555205047,6.5068870523416,997,6.38214643931795
639,359,6.30672926447574,6.4150417827298,998,6.34569138276553
632,366,6.28955696202532,6.42896174863388,998,6.34068136272545
625,374,6.2352,6.43582887700535,999,6.31031031031031
633,365,6.2085308056872,6.43835616438356,998,6.29258517034068
633,366,6.15481832543444,6.46174863387978,999,6.26726726726727
627,369,6.14832535885167,6.48509485094851,996,6.27309236947791
624,373,6.16826923076923,6.57640750670241,997,6.320962888666
623,374,6.18459069020867,6.59625668449198,997,6.33901705115346
637,361,6.22605965463108,6.59002770083103,998,6.35771543086172
637,361,6.26373626373626,6.62603878116343,998,6.39478957915832
644,355,6.27484472049689,6.62253521126761,999,6.3983983983984
648,350,6.27469135802469,6.58285714285714,998,6.38276553106212
646,353,6.38235294117647,6.60056657223796,999,6.45945945945946
652,346,6.43098159509202,6.54046242774566,998,6.4689378757515
655,343,6.42900763358779,6.48396501457726,998,6.44789579158317
647,350,6.40494590417311,6.44857142857143,997,6.42026078234704
654,345,6.43425076452599,6.4463768115942,999,6.43843843843844
658,341,6.45136778115502,6.44574780058651,999,6.44944944944945
661,338,6.45990922844175,6.47041420118343,999,6.46346346346346
652,347,6.48926380368098,6.4985590778098,999,6.49249249249249
657,342,6.42465753424658,6.45906432748538,999,6.43643643643644
653,345,6.45482388973966,6.47246376811594,998,6.46092184368737
648,350,6.4537037037037,6.45714285714286,998,6.45490981963928
654,345,6.40061162079511,6.48115942028986,999,6.42842842842843
654,342,6.40061162079511,6.45029239766082,996,6.41767068273092
652,347,6.42177914110429,6.46397694524496,999,6.43643643643644
647,352,6.50386398763524,6.49715909090909,999,6.5015015015015
651,348,6.45007680491551,6.49712643678161,999,6.46646646646647
653,344,6.4104134762634,6.51453488372093,997,6.44633901705115
652,346,6.43865030674847,6.46531791907514,998,6.44789579158317
655,344,6.43358778625954,6.5203488372093,999,6.46346346346346
652,347,6.42024539877301,6.44668587896254,999,6.42942942942943
649,349,6.38828967642527,6.41833810888252,998,6.39879759519038
649,350,6.31124807395994,6.45142857142857,999,6.36036036036036
650,349,6.36307692307692,6.47851002865329,999,6.4034034034034
658,341,6.37386018237082,6.51612903225806,999,6.42242242242242
665,334,6.30977443609023,6.53293413173653,999,6.38438438438438
666,333,6.32132132132132,6.57057057057057,999,6.4044044044044
677,322,6.34711964549483,6.56521739130435,999,6.41741741741742
680,318,6.34411764705882,6.63522012578616,998,6.43687374749499
688,311,6.33720930232558,6.62379421221865,999,6.42642642642643
683,316,6.34699853587116,6.53481012658228,999,6.40640640640641
678,320,6.32890855457227,6.575,998,6.40781563126253
677,321,6.36927621861152,6.62305295950156,998,6.45090180360721
677,321,6.37223042836041,6.53894080996885,998,6.42585170340681
675,324,6.38222222222222,6.58641975308642,999,6.44844844844845
677,321,6.40177252584933,6.61370716510903,998,6.46993987975952
675,322,6.40740740740741,6.56832298136646,997,6.45937813440321
682,317,6.41788856304985,6.5205047318612,999,6.45045045045045
683,314,6.44655929721816,6.5828025477707,997,6.48946840521565
686,312,6.41690962099125,6.57051282051282,998,6.46492985971944
699,300,6.40343347639485,6.51666666666667,999,6.43743743743744
688,309,6.41279069767442,6.57605177993528,997,6.46339017051153
684,313,6.46491228070175,6.53993610223642,997,6.48846539618857
689,309,6.40493468795356,6.51132686084142,998,6.43787575150301
690,309,6.37536231884058,6.47572815533981,999,6.40640640640641
699,300,6.39771101573677,6.47666666666667,999,6.42142142142142
698,300,6.38252148997135,6.46,998,6.40581162324649
701,298,6.39514978601997,6.41275167785235,999,6.4004004004004
707,292,6.38189533239038,6.33219178082192,999,6.36736736736737
701,297,6.35805991440799,6.38383838383838,998,6.36573146292585
707,292,6.42857142857143,6.33561643835616,999,6.4014014014014
704,293,6.484375,6.37883959044369,997,6.45336008024072
706,290,6.47450424929179,6.39310344827586,996,6.45080321285141
707,290,6.46534653465347,6.33103448275862,997,6.42627883650953
712,287,6.43258426966292,6.36933797909408,999,6.41441441441441
721,278,6.42718446601942,6.43884892086331,999,6.43043043043043
730,269,6.47123287671233,6.49814126394052,999,6.47847847847848
724,271,6.49447513812155,6.48708487084871,995,6.49246231155779
729,269,6.5116598079561,6.4275092936803,998,6.48897795591182
733,264,6.51978171896317,6.43181818181818,997,6.49648946840522
726,273,6.48209366391185,6.46520146520147,999,6.47747747747748
736,262,6.45923913043478,6.42748091603053,998,6.45090180360721
735,263,6.48571428571429,6.46768060836502,998,6.48096192384769
731,267,6.50068399452804,6.47191011235955,998,6.49298597194389
732,265,6.4931693989071,6.40377358490566,997,6.46940822467402
724,275,6.4792817679558,6.44363636363636,999,6.46946946946947
723,275,6.44813278008299,6.47272727272727,998,6.45490981963928
725,272,6.47724137931035,6.48897058823529,997,6.48044132397192
719,279,6.4547983310153,6.45519713261649,998,6.45490981963928
720,278,6.45277777777778,6.53237410071942,998,6.4749498997996
716,281,6.49860335195531,6.48042704626334,997,6.49348044132397
712,285,6.56460674157303,6.48421052631579,997,6.54162487462387
725,272,6.52965517241379,6.50735294117647,997,6.52357071213641
737,262,6.5033921302578,6.5763358778626,999,6.52252252252252
732,266,6.43852459016393,6.57894736842105,998,6.47595190380762
737,262,6.45318860244233,6.62213740458015,999,6.4974974974975
736,263,6.46739130434783,6.5171102661597,999,6.48048048048048
736,263,6.44021739130435,6.47908745247148,999,6.45045045045045
739,259,6.44654939106901,6.47876447876448,998,6.45490981963928
745,252,6.43087248322148,6.46825396825397,997,6.44032096288867
745,253,6.44697986577181,6.49802371541502,998,6.45991983967936
749,250,6.41789052069426,6.448,999,6.42542542542543
748,251,6.43716577540107,6.52988047808765,999,6.46046046046046
742,256,6.41644204851752,6.58203125,998,6.45891783567134
742,256,6.4811320754717,6.53515625,998,6.49498997995992
739,259,6.45060893098782,6.57142857142857,998,6.48196392785571
731,268,6.42407660738714,6.59328358208955,999,6.46946946946947
734,265,6.41825613079019,6.59622641509434,999,6.46546546546547
733,266,6.45566166439291,6.6390977443609,999,6.5045045045045
730,269,6.46712328767123,6.59851301115242,999,6.5025025025025
729,269,6.46090534979424,6.62825278810409,998,6.5060120240481
735,261,6.40544217687075,6.5632183908046,996,6.44678714859438
728,271,6.40384615384615,6.56088560885609,999,6.44644644644645
732,266,6.41256830601093,6.56766917293233,998,6.45390781563126
735,263,6.45034013605442,6.60836501901141,998,6.49198396793587
733,266,6.49931787175989,6.57894736842105,999,6.52052052052052
732,266,6.45081967213115,6.59398496240602,998,6.48897795591182
728,270,6.45741758241758,6.48518518518518,998,6.46492985971944
732,267,6.43715846994535,6.37827715355805,999,6.42142142142142
724,274,6.46408839779006,6.40875912408759,998,6.44889779559118
717,281,6.39748953974895,6.42348754448399,998,6.40480961923848
716,283,6.39106145251397,6.5017667844523,999,6.42242242242242
715,284,6.42937062937063,6.42605633802817,999,6.42842842842843
711,287,6.41912798874824,6.36585365853659,998,6.40380761523046
721,278,6.43828016643551,6.40647482014388,999,6.42942942942943
721,274,6.43966712898752,6.36496350364964,995,6.41909547738693
731,268,6.48700410396717,6.40298507462687,999,6.46446446446446
736,263,6.54755434782609,6.39163498098859,999,6.50650650650651
743,256,6.58008075370121,6.48828125,999,6.55655655655656
739,260,6.57510148849797,6.52692307692308,999,6.56256256256256
738,259,6.63279132791328,6.47876447876448,997,6.59277833500501
740,259,6.63918918918919,6.4980694980695,999,6.6026026026026
751,248,6.69906790945406,6.46370967741935,999,6.64064064064064
754,243,6.68567639257294,6.44855967078189,997,6.62788365095286
760,238,6.67236842105263,6.51680672268908,998,6.63527054108216
759,240,6.61791831357049,6.475,999,6.58358358358358
763,236,6.64875491480996,6.4364406779661,999,6.5985985985986
766,232,6.68276762402089,6.48706896551724,998,6.6372745490982
758,239,6.69261213720317,6.4979079497908,997,6.64593781344032
769,230,6.71001300390117,6.46086956521739,999,6.65265265265265
771,228,6.69260700389105,6.41666666666667,999,6.62962962962963
766,232,6.67362924281984,6.39655172413793,998,6.60921843687375
768,231,6.69661458333333,6.33333333333333,999,6.61261261261261
765,234,6.66535947712418,6.37606837606838,999,6.5975975975976
766,232,6.64751958224543,6.42241379310345,998,6.59519038076152
765,234,6.6483660130719,6.42307692307692,999,6.5955955955956
774,225,6.67700258397933,6.30666666666667,999,6.59359359359359
780,219,6.6448717948718,6.28310502283105,999,6.56556556556557
786,211,6.61068702290076,6.30331753554502,997,6.5456369107322
786,213,6.62722646310433,6.29577464788732,999,6.55655655655656
784,215,6.62627551020408,6.31627906976744,999,6.55955955955956
788,211,6.63705583756345,6.32701421800948,999,6.57157157157157
788,209,6.61802030456853,6.35885167464115,997,6.56369107321966
788,209,6.62944162436548,6.29665071770335,997,6.55967903711133
786,213,6.66412213740458,6.34272300469484,999,6.5955955955956
789,210,6.65779467680608,6.27142857142857,999,6.57657657657658
793,205,6.65069356872636,6.39024390243902,998,6.59719438877756
791,208,6.65107458912769,6.41346153846154,999,6.6016016016016
788,208,6.58248730964467,6.48557692307692,996,6.56224899598394
791,207,6.58280657395702,6.47826086956522,998,6.56112224448898
790,209,6.59746835443038,6.42583732057416,999,6.56156156156156
790,209,6.58607594936709,6.49282296650718,999,6.56656656656657
790,207,6.63544303797468,6.48309178743961,997,6.60381143430291
794,205,6.62216624685139,6.34634146341463,999,6.56556556556557
798,201,6.65037593984962,6.36318407960199,999,6.59259259259259
793,205,6.65825977301387,6.37560975609756,998,6.6002004008016
794,205,6.62468513853904,6.41463414634146,999,6.58158158158158
788,211,6.6256345177665,6.40284360189573,999,6.57857857857858
786,211,6.58905852417303,6.4218009478673,997,6.55366098294885
796,203,6.62311557788945,6.40886699507389,999,6.57957957957958
797,201,6.57590966122961,6.2636815920398,998,6.51302605210421
796,203,6.51507537688442,6.21182266009852,999,6.45345345345345
795,203,6.52830188679245,6.2512315270936,998,6.47194388777555
790,207,6.46962025316456,6.2463768115942,997,6.42326980942828
790,208,6.4620253164557,6.23557692307692,998,6.41482965931864
788,210,6.46573604060914,6.09047619047619,998,6.38677354709419
790,208,6.45696202531646,6.04807692307692,998,6.37174348697395
789,209,6.43346007604563,5.98564593301435,998,6.33967935871743
792,206,6.4760101010101,6.00485436893204,998,6.37875751503006
795,203,6.53710691823899,6.03448275862069,998,6.43486973947896
793,205,6.55611601513241,6.05853658536585,998,6.45390781563126
790,208,6.59113924050633,6.12019230769231,998,6.49298597194389
789,208,6.59062103929024,6.14423076923077,997,6.4974924774323
790,208,6.56582278481013,6.11538461538461,998,6.47194388777555
786,212,6.52671755725191,6.14150943396226,998,6.44488977955912
788,209,6.54314720812183,6.24401913875598,997,6.48044132397192
788,210,6.50761421319797,6.17142857142857,998,6.43687374749499
788,211,6.5253807106599,6.1042654028436,999,6.43643643643644
789,208,6.54372623574144,6.16346153846154,997,6.46439317953862
788,210,6.55964467005076,6.18571428571429,998,6.48096192384769
788,211,6.57994923857868,6.14218009478673,999,6.48748748748749
789,208,6.58428390367554,6.17788461538461,997,6.49949849548646
779,220,6.602053915276,6.19090909090909,999,6.51151151151151
779,219,6.57381258023107,6.18264840182648,998,6.48797595190381
777,221,6.53796653796654,6.13122171945701,998,6.44789579158317
784,214,6.56760204081633,6.17757009345794,998,6.48396793587174
786,212,6.51908396946565,6.17452830188679,998,6.44589178356713
786,213,6.49618320610687,6.18779342723005,999,6.43043043043043
785,214,6.50191082802548,6.31775700934579,999,6.46246246246246
785,214,6.46496815286624,6.23364485981308,999,6.41541541541542
780,216,6.46025641025641,6.11111111111111,996,6.38453815261044
791,208,6.46396965865992,6.13942307692308,999,6.3963963963964
786,212,6.45674300254453,6.16981132075472,998,6.39579158316633
797,202,6.51568381430364,6.21782178217822,999,6.45545545545546
793,206,6.45901639344262,6.28155339805825,999,6.42242242242242
794,204,6.5088161209068,6.23039215686275,998,6.45190380761523
800,198,6.51375,6.21717171717172,998,6.45490981963928
804,195,6.57960199004975,6.25641025641026,999,6.51651651651652
801,196,6.61298377028714,6.30102040816327,997,6.55165496489468
798,200,6.62280701754386,6.305,998,6.55911823647295
799,198,6.62453066332916,6.32828282828283,997,6.56569709127382
798,199,6.56140350877193,6.27638190954774,997,6.50451354062187
798,200,6.57644110275689,6.325,998,6.52605210420842
796,202,6.56532663316583,6.38118811881188,998,6.52805611222445
784,215,6.50892857142857,6.45116279069767,999,6.4964964964965
777,222,6.54311454311454,6.50900900900901,999,6.53553553553554
782,216,6.57800511508951,6.51388888888889,998,6.56412825651303
775,224,6.60645161290323,6.58482142857143,999,6.6016016016016
773,225,6.63130659767141,6.58666666666667,998,6.62124248496994
764,234,6.62958115183246,6.57264957264957,998,6.61623246492986
764,234,6.64528795811518,6.55128205128205,998,6.62324649298597
761,236,6.65045992115637,6.5,997,6.6148445336008
760,238,6.65394736842105,6.46638655462185,998,6.60921843687375
773,226,6.63260025873221,6.47345132743363,999,6.5965965965966
764,233,6.60078534031414,6.47210300429185,997,6.57071213640923
766,232,6.60704960835509,6.39655172413793,998,6.55811623246493
768,230,6.62760416666667,6.33478260869565,998,6.56012024048096
771,226,6.60311284046693,6.42477876106195,997,6.56268806419258
776,223,6.66623711340206,6.45739910313901,999,6.61961961961962
776,223,6.6430412371134,6.41255605381166,999,6.59159159159159
777,221,6.62805662805663,6.5158371040724,998,6.60320641282565
781,218,6.59026888604353,6.44495412844037,999,6.55855855855856
776,221,6.56572164948454,6.48868778280543,997,6.54864593781344
779,220,6.57766367137356,6.46818181818182,999,6.55355355355355
781,218,6.58258642765685,6.34403669724771,999,6.53053053053053
778,220,6.59254498714653,6.34545454545455,998,6.53807615230461
775,224,6.58709677419355,6.31696428571429,999,6.52652652652653
777,222,6.60489060489061,6.2972972972973,999,6.53653653653654
773,225,6.61966364812419,6.31111111111111,998,6.5501002004008
774,223,6.58785529715762,6.25112107623318,997,6.51253761283852
770,229,6.6012987012987,6.31877729257642,999,6.53653653653654
771,227,6.56420233463035,6.24669603524229,998,6.49198396793587
762,236,6.58005249343832,6.25423728813559,998,6.50300601202405
769,228,6.57867360208062,6.30263157894737,997,6.51554663991976
774,225,6.53229974160207,6.25777777777778,999,6.47047047047047
771,228,6.46303501945525,6.27631578947368,999,6.42042042042042
777,221,6.5045045045045,6.29411764705882,998,6.45791583166333
774,224,6.4702842377261,6.27678571428571,998,6.42685370741483
778,220,6.46401028277635,6.15909090909091,998,6.39679358717435
774,223,6.5,6.16143497757847,997,6.42427281845537
780,219,6.47307692307692,6.12328767123288,999,6.3963963963964
777,221,6.46332046332046,6.10859728506787,998,6.38476953907816
774,225,6.45090439276486,6.15111111111111,999,6.38338338338338
781,217,6.45710627400768,6.07834101382489,998,6.374749498998
777,221,6.49163449163449,6.10859728506787,998,6.40681362725451
776,223,6.51159793814433,6.12556053811659,999,6.42542542542543
781,217,6.53137003841229,6.09216589861751,998,6.43587174348697
785,214,6.57707006369427,6.1214953271028,999,6.47947947947948
785,214,6.52484076433121,6.03271028037383,999,6.41941941941942
783,214,6.5338441890166,6.07943925233645,997,6.43630892678034
788,210,6.51776649746193,6.06666666666667,998,6.42284569138277
789,210,6.51330798479087,6.07619047619048,999,6.42142142142142
795,204,6.51698113207547,6.08823529411765,999,6.42942942942943
796,203,6.46105527638191,6.01970443349754,999,6.37137137137137
797,202,6.43789209535759,6.06435643564356,999,6.36236236236236
794,205,6.45717884130982,5.98536585365854,999,6.36036036036036
797,200,6.53701380175659,6.085,997,6.44633901705115
796,203,6.59045226130653,6.02955665024631,999,6.47647647647648
802,196,6.56982543640898,6.07142857142857,998,6.47194388777555
814,185,6.52457002457002,5.94594594594595,999,6.41741741741742
802,194,6.51995012468828,6.08247422680412,996,6.43473895582329
799,200,6.48811013767209,6.1,999,6.41041041041041
805,194,6.39751552795031,6.07216494845361,999,6.33433433433433
804,195,6.36442786069652,6.24615384615385,999,6.34134134134134
803,196,6.44582814445828,6.30102040816327,999,6.41741741741742
800,198,6.45625,6.34848484848485,998,6.43486973947896
798,201,6.51378446115288,6.28358208955224,999,6.46746746746747
794,204,6.51007556675063,6.29411764705882,998,6.46593186372746
793,205,6.50693568726356,6.35609756097561,998,6.47595190380762
797,202,6.51568381430364,6.27227722772277,999,6.46646646646647
802,195,6.55486284289277,6.31282051282051,997,6.50752256770311
807,192,6.52540272614622,6.27604166666667,999,6.47747747747748
809,189,6.50061804697157,6.12698412698413,998,6.42985971943888
804,194,6.51119402985075,6.09278350515464,998,6.42985971943888
808,188,6.5,6.10106382978723,996,6.42469879518072
814,184,6.45454545454545,6.20108695652174,998,6.40781563126253
815,184,6.51411042944785,6.2554347826087,999,6.46646646646647
818,180,6.44376528117359,6.23888888888889,998,6.40681362725451
817,181,6.39902080783354,6.14364640883978,998,6.35270541082164
825,172,6.39636363636364,6.26744186046512,997,6.3741223671013
819,177,6.48717948717949,6.16949152542373,996,6.43072289156626
816,182,6.48529411764706,6.25274725274725,998,6.44288577154309
815,183,6.51411042944785,6.11475409836066,998,6.44088176352705
823,175,6.51518833535844,6.06285714285714,998,6.43587174348697
814,185,6.52088452088452,6.17837837837838,999,6.45745745745746
816,183,6.58578431372549,6.10382513661202,999,6.4974974974975
818,181,6.55012224938875,6.14917127071823,999,6.47747747747748
817,181,6.57527539779682,6.13259668508287,998,6.49498997995992
813,185,6.56088560885609,6.21621621621622,998,6.49699398797595
811,187,6.62638717632552,6.22994652406417,998,6.55210420841683
811,188,6.6498150431566,6.28191489361702,999,6.58058058058058
813,183,6.6469864698647,6.30601092896175,996,6.58433734939759
810,186,6.62222222222222,6.39247311827957,996,6.5793172690763
815,184,6.59018404907975,6.36413043478261,999,6.54854854854855
821,178,6.60292326431181,6.48876404494382,999,6.58258258258258
823,176,6.56622114216282,6.58522727272727,999,6.56956956956957
823,175,6.57594167679222,6.52,998,6.56613226452906
824,175,6.60679611650485,6.52,999,6.59159159159159
822,177,6.59975669099757,6.54237288135593,999,6.58958958958959
822,177,6.67031630170316,6.5819209039548,999,6.65465465465465
826,173,6.63075060532688,6.60693641618497,999,6.62662662662663
823,176,6.69501822600243,6.71022727272727,999,6.6976976976977
827,172,6.62877871825877,6.72674418604651,999,6.64564564564565
825,174,6.65212121212121,6.6551724137931,999,6.65265265265265
829,170,6.62846803377563,6.56470588235294,999,6.61761761761762
822,176,6.64598540145985,6.58522727272727,998,6.63527054108216
827,169,6.62515114873035,6.65680473372781,996,6.63052208835341
831,167,6.647412755716,6.64670658682635,998,6.64729458917836
832,167,6.65384615384615,6.75449101796407,999,6.67067067067067
832,166,6.66947115384615,6.68674698795181,998,6.67234468937876
835,164,6.61317365269461,6.72560975609756,999,6.63163163163163
828,169,6.6304347826087,6.72189349112426,997,6.64593781344032
834,165,6.61630695443645,6.77575757575758,999,6.64264264264264
835,164,6.64790419161677,6.73170731707317,999,6.66166166166166
838,158,6.63603818615752,6.79113924050633,996,6.66064257028112
844,153,6.66943127962085,6.73856209150327,997,6.68004012036108
835,162,6.67664670658683,6.77160493827161,997,6.69207622868606
835,164,6.63473053892216,6.70731707317073,999,6.64664664664665
833,165,6.65546218487395,6.64848484848485,998,6.65430861723447
828,170,6.66787439613527,6.62941176470588,998,6.66132264529058
833,165,6.62545018007203,6.61212121212121,998,6.62324649298597
831,168,6.61492178098676,6.57142857142857,999,6.60760760760761
827,168,6.60217654171705,6.64285714285714,995,6.60904522613065
835,163,6.58323353293413,6.55828220858896,998,6.57915831663327
837,162,6.60573476702509,6.61111111111111,999,6.60660660660661
837,162,6.54838709677419,6.65432098765432,999,6.56556556556557
831,167,6.54512635379061,6.65269461077844,998,6.56312625250501
833,166,6.53421368547419,6.63855421686747,999,6.55155155155155
830,167,6.50963855421687,6.67664670658683,997,6.53761283851555
828,169,6.51570048309179,6.59171597633136,997,6.52858575727182
828,171,6.58816425120773,6.59649122807018,999,6.58958958958959
821,178,6.57734470158343,6.51685393258427,999,6.56656656656657
815,183,6.56441717791411,6.53005464480874,998,6.55811623246493
803,194,6.54171855541719,6.46907216494845,997,6.52758274824473
802,197,6.53740648379052,6.46700507614213,999,6.52352352352352
805,193,6.51428571428571,6.35751295336788,998,6.48396793587174
813,184,6.45264452644526,6.40760869565217,997,6.44433299899699
809,189,6.46477132262052,6.4021164021164,998,6.45290581162325
807,192,6.47583643122677,6.44791666666667,999,6.47047047047047
802,195,6.48254364089776,6.47692307692308,997,6.481444332999
803,196,6.49315068493151,6.48469387755102,999,6.49149149149149
813,185,6.43788437884379,6.42702702702703,998,6.43587174348697
812,186,6.46551724137931,6.41397849462366,998,6.45591182364729
810,188,6.43456790123457,6.48936170212766,998,6.44488977955912
812,187,6.44581280788177,6.51336898395722,999,6.45845845845846
814,184,6.45208845208845,6.54891304347826,998,6.46993987975952
822,177,6.42335766423358,6.61581920903955,999,6.45745745745746
819,180,6.47008547008547,6.56111111111111,999,6.48648648648649
816,183,6.51593137254902,6.54644808743169,999,6.52152152152152
818,180,6.45843520782396,6.58888888888889,998,6.48196392785571
820,177,6.48292682926829,6.55367231638418,997,6.49548645937813
820,177,6.52804878048781,6.66101694915254,997,6.55165496489468
829,170,6.48492159227986,6.54705882352941,999,6.4954954954955
831,168,6.47172081829122,6.50595238095238,999,6.47747747747748
825,173,6.48484848484848,6.41040462427746,998,6.47194388777555
838,161,6.47613365155131,6.37267080745342,999,6.45945945945946
835,164,6.46107784431138,6.30487804878049,999,6.43543543543544
832,167,6.43389423076923,6.26347305389222,999,6.40540540540541
828,171,6.42149758454106,6.28070175438596,999,6.3973973973974
824,174,6.41747572815534,6.2816091954023,998,6.3937875751503
827,172,6.46674727932285,6.30232558139535,999,6.43843843843844
823,176,6.51154313487242,6.21590909090909,999,6.45945945945946
824,173,6.52912621359223,6.20809248554913,997,6.47342026078235
833,166,6.5390156062425,6.18072289156626,999,6.47947947947948
833,166,6.57142857142857,6.28313253012048,999,6.52352352352352
832,166,6.59254807692308,6.1566265060241,998,6.52004008016032
832,167,6.53004807692308,6.18562874251497,999,6.47247247247247
828,170,6.57125603864734,6.07058823529412,998,6.48597194388778
825,174,6.57333333333333,6.11494252873563,999,6.49349349349349
831,168,6.55354993983153,6.09523809523809,999,6.47647647647648
841,156,6.56599286563615,6.10897435897436,997,6.49448345035105
843,156,6.47805456702254,6.12820512820513,999,6.42342342342342
832,165,6.47836538461539,6.16969696969697,997,6.42728184553661
842,157,6.44536817102138,6.37579617834395,999,6.43443443443443
845,153,6.48757396449704,6.37254901960784,998,6.46993987975952
852,147,6.46713615023474,6.42176870748299,999,6.46046046046046
847,152,6.45572609208973,6.42105263157895,999,6.45045045045045
842,157,6.44418052256532,6.46496815286624,999,6.44744744744745
843,156,6.47093712930012,6.58974358974359,999,6.48948948948949
838,161,6.46778042959427,6.59627329192547,999,6.48848848848849
843,154,6.47686832740214,6.51948051948052,997,6.48345035105316
843,156,6.4638196915777,6.49358974358974,999,6.46846846846847
839,160,6.41716328963051,6.48125,999,6.42742742742743
841,158,6.43638525564804,6.51898734177215,999,6.44944944944945
835,164,6.46946107784431,6.55487804878049,999,6.48348348348348
833,166,6.51500600240096,6.60843373493976,999,6.53053053053053
833,166,6.52460984393757,6.6566265060241,999,6.54654654654655
838,160,6.49880668257757,6.6125,998,6.51703406813627
831,168,6.4705174488568,6.61904761904762,999,6.4954954954955
830,168,6.49156626506024,6.67857142857143,998,6.52304609218437
827,171,6.51874244256348,6.6374269005848,998,6.53907815631263
823,176,6.52369380315917,6.67613636363636,999,6.55055055055055
832,166,6.50480769230769,6.66867469879518,998,6.53206412825651
823,175,6.47509113001215,6.66857142857143,998,6.50901803607214
824,175,6.41019417475728,6.71428571428571,999,6.46346346346346
824,173,6.35800970873786,6.60115606936416,997,6.40020060180542
822,176,6.35888077858881,6.59090909090909,998,6.3997995991984
821,178,6.43605359317905,6.55056179775281,999,6.45645645645646
824,174,6.42718446601942,6.54597701149425,998,6.44789579158317
824,175,6.4004854368932,6.53714285714286,999,6.42442442442442
825,173,6.36,6.56647398843931,998,6.39579158316633
825,173,6.36606060606061,6.60115606936416,998,6.40681362725451
826,172,6.40314769975787,6.61627906976744,998,6.43987975951904
826,173,6.38498789346247,6.57803468208092,999,6.41841841841842
820,177,6.42926829268293,6.51412429378531,997,6.44433299899699
824,175,6.43203883495146,6.65714285714286,999,6.47147147147147
820,179,6.44512195121951,6.62569832402235,999,6.47747747747748
820,179,6.46951219512195,6.70391061452514,999,6.51151151151151
823,176,6.46294046172539,6.63636363636364,999,6.49349349349349
829,169,6.49939686369119,6.7396449704142,998,6.54008016032064
829,169,6.45114595898673,6.79881656804734,998,6.51002004008016
825,173,6.43393939393939,6.76878612716763,998,6.49198396793587
825,174,6.41939393939394,6.66666666666667,999,6.46246246246246
820,177,6.39268292682927,6.71186440677966,997,6.4493480441324
827,171,6.39782345828295,6.64912280701754,998,6.44088176352705
825,172,6.38787878787879,6.58720930232558,997,6.4222668004012
827,172,6.37968561064087,6.49418604651163,999,6.3993993993994
830,169,6.38674698795181,6.45562130177515,999,6.3983983983984
834,164,6.36930455635492,6.49390243902439,998,6.38977955911824
833,165,6.3313325330132,6.46666666666667,998,6.35370741482966
834,165,6.39328537170264,6.41212121212121,999,6.3963963963964
831,167,6.42358604091456,6.48502994011976,998,6.43386773547094
828,169,6.39130434782609,6.44378698224852,997,6.40020060180542
840,159,6.35952380952381,6.52830188679245,999,6.38638638638639
841,157,6.39001189060642,6.56050955414013,998,6.41683366733467
844,153,6.40165876777251,6.66013071895425,997,6.44132397191575
848,151,6.40094339622642,6.62913907284768,999,6.43543543543544
844,154,6.45260663507109,6.66883116883117,998,6.48597194388778
843,156,6.48042704626334,6.66025641025641,999,6.50850850850851
844,155,6.53554502369668,6.71612903225806,999,6.56356356356356
852,147,6.57863849765258,6.59863945578231,999,6.58158158158158
846,152,6.55791962174941,6.66447368421053,998,6.57414829659319
851,148,6.57814336075206,6.5472972972973,999,6.57357357357357
863,135,6.55735805330243,6.58518518518519,998,6.56112224448898
860,139,6.53720930232558,6.62589928057554,999,6.54954954954955
859,140,6.49825378346915,6.69285714285714,999,6.52552552552553
855,143,6.44327485380117,6.61538461538461,998,6.46793587174349
853,145,6.41031652989449,6.61379310344828,998,6.43987975951904
853,144,6.45369284876905,6.61805555555556,997,6.47743229689067
854,145,6.43559718969555,6.6551724137931,999,6.46746746746747
854,144,6.43911007025761,6.77083333333333,998,6.48697394789579
851,148,6.39952996474736,6.72972972972973,999,6.44844844844845
851,147,6.40070505287897,6.66666666666667,998,6.43987975951904
849,149,6.40164899882214,6.68456375838926,998,6.4438877755511
844,154,6.43009478672986,6.72727272727273,998,6.47595190380762
853,146,6.45486518171161,6.73972602739726,999,6.4964964964965
846,153,6.43853427895981,6.69281045751634,999,6.47747747747748
851,148,6.40540540540541,6.62837837837838,999,6.43843843843844
853,145,6.39742086752638,6.68965517241379,998,6.43987975951904
844,154,6.39099526066351,6.66233766233766,998,6.43286573146293
842,156,6.35510688836105,6.57051282051282,998,6.38877755511022
839,157,6.39213349225268,6.46496815286624,996,6.40361445783132
847,152,6.40141676505313,6.45394736842105,999,6.40940940940941
845,154,6.36213017751479,6.41558441558442,999,6.37037037037037
845,154,6.38343195266272,6.38311688311688,999,6.38338338338338
840,158,6.38809523809524,6.31645569620253,998,6.37675350701403
841,157,6.37931034482759,6.28662420382166,998,6.36472945891784
838,161,6.30668257756563,6.38509316770186,999,6.31931931931932
840,159,6.34285714285714,6.39622641509434,999,6.35135135135135
840,157,6.33928571428571,6.4968152866242,997,6.36409227683049
840,158,6.3702380952381,6.5,998,6.39078156312625
844,155,6.35189573459716,6.60645161290323,999,6.39139139139139
843,156,6.35112692763938,6.6025641025641,999,6.39039039039039
847,151,6.34946871310508,6.58278145695364,998,6.38476953907816
850,149,6.38352941176471,6.63087248322148,999,6.42042042042042
849,150,6.39104829210836,6.66,999,6.43143143143143
847,152,6.35773317591499,6.67105263157895,999,6.40540540540541
847,152,6.39079102715466,6.76315789473684,999,6.44744744744745
851,147,6.4289071680376,6.76190476190476,998,6.47795591182365
850,149,6.41529411764706,6.78523489932886,999,6.47047047047047
851,148,6.43360752056404,6.72297297297297,999,6.47647647647648
849,150,6.43462897526502,6.68,999,6.47147147147147
846,153,6.38770685579196,6.77777777777778,999,6.44744744744745
841,156,6.41260404280618,6.74358974358974,997,6.46439317953862
852,146,6.38380281690141,6.79452054794521,998,6.4438877755511
848,148,6.37264150943396,6.65540540540541,996,6.41465863453815
851,148,6.33725029377203,6.55405405405405,999,6.36936936936937
851,147,6.36075205640423,6.53061224489796,998,6.38577154308617
847,151,6.38370720188902,6.60264900662252,998,6.41683366733467
846,152,6.39598108747045,6.46710526315789,998,6.40681362725451
853,146,6.43141852286049,6.43150684931507,999,6.43143143143143
842,154,6.47743467933492,6.55194805194805,996,6.48895582329317
852,146,6.43779342723005,6.54109589041096,998,6.45290581162325
853,146,6.43962485345838,6.5,999,6.44844844844845
844,155,6.45142180094787,6.39354838709677,999,6.44244244244244
841,158,6.40309155766944,6.40506329113924,999,6.4034034034034
840,156,6.41547619047619,6.31410256410256,996,6.3995983935743
846,153,6.36406619385343,6.18300653594771,999,6.33633633633634
842,156,6.40261282660333,6.21794871794872,998,6.37374749498998
853,144,6.40445486518171,6.19444444444444,997,6.3741223671013
854,144,6.42622950819672,6.1875,998,6.39178356713427
855,144,6.50175438596491,6.06944444444444,999,6.43943943943944
856,143,6.49532710280374,6.06293706293706,999,6.43343343343343
857,142,6.46557759626604,6.03521126760563,999,6.4044044044044
860,139,6.46162790697674,6.05755395683453,999,6.40540540540541
866,133,6.44226327944573,5.98496240601504,999,6.38138138138138
864,133,6.46527777777778,5.91729323308271,997,6.39217652958877
866,133,6.44226327944573,5.94736842105263,999,6.37637637637638
860,138,6.38604651162791,5.96376811594203,998,6.32765531062124
858,141,6.37762237762238,6.12765957446809,999,6.34234234234234
854,144,6.37002341920375,6.20138888888889,998,6.34569138276553
848,150,6.32665094339623,6.20666666666667,998,6.30861723446894
855,143,6.37543859649123,6.22377622377622,998,6.35370741482966
855,141,6.38011695906433,6.22695035460993,996,6.35843373493976
857,142,6.40373395565928,6.21830985915493,999,6.37737737737738
862,137,6.33874709976798,6.25547445255474,999,6.32732732732733
860,138,6.32674418604651,6.28985507246377,998,6.32164328657315
857,142,6.3558926487748,6.28169014084507,999,6.34534534534535
858,141,6.36480186480186,6.4468085106383,999,6.37637637637638
863,135,6.34183082271147,6.51111111111111,998,6.36472945891784
866,132,6.35219399538106,6.65151515151515,998,6.39178356713427
865,134,6.33179190751445,6.6865671641791,999,6.37937937937938
874,124,6.31235697940503,6.56451612903226,998,6.3436873747495
877,121,6.32953249714937,6.56198347107438,998,6.35771543086172
875,124,6.31428571428571,6.66129032258065,999,6.35735735735736
878,120,6.28587699316629,6.75,998,6.34168336673347
878,120,6.29271070615034,6.625,998,6.33266533066132
877,120,6.28278221208666,6.53333333333333,997,6.31293881644935
876,120,6.30936073059361,6.625,996,6.34738955823293
875,124,6.29828571428571,6.64516129032258,999,6.34134134134134
875,124,6.28457142857143,6.69354838709677,999,6.33533533533534
869,129,6.28653624856157,6.68992248062016,998,6.33867735470942
868,130,6.26267281105991,6.57692307692308,998,6.30360721442886
870,129,6.28965517241379,6.49612403100775,999,6.31631631631632
868,130,6.24193548387097,6.58461538461538,998,6.28657314629258
867,132,6.24682814302192,6.5530303030303,999,6.28728728728729
869,129,6.2313003452244,6.48837209302326,998,6.26452905811623
872,127,6.22477064220184,6.48031496062992,999,6.25725725725726
871,127,6.2617680826636,6.54330708661417,998,6.29759519038076
876,122,6.27739726027397,6.54918032786885,998,6.31062124248497
880,118,6.27954545454545,6.57627118644068,998,6.31462925851703
879,117,6.29124004550626,6.64957264957265,996,6.33333333333333
892,107,6.32735426008969,6.51401869158879,999,6.34734734734735
888,111,6.33333333333333,6.53153153153153,999,6.35535535535536
886,110,6.33634311512415,6.56363636363636,996,6.36144578313253
891,108,6.32884399551066,6.57407407407407,999,6.35535535535536
891,107,6.41301907968575,6.47663551401869,998,6.41983967935872
891,107,6.43434343434343,6.45794392523364,998,6.43687374749499
889,110,6.41732283464567,6.45454545454545,999,6.42142142142142
892,107,6.41928251121076,6.25233644859813,999,6.4014014014014
889,109,6.42744656917885,6.18348623853211,998,6.40080160320641
895,104,6.50167597765363,6.24038461538461,999,6.47447447447447
904,93,6.45132743362832,6.25806451612903,997,6.4332998996991
904,95,6.46128318584071,6.17894736842105,999,6.43443443443443
