forward_num,reverse_num,forward_rate,reverse_rate,organism_num,organism_rate
5,5,5.0,5.0,10,5.0
5,5,5.0,5.0,10,5.0
5,5,5.0,5.0,10,5.0
6,5,5.33333333333333,5.0,11,5.18181818181818
7,5,5.42857142857143,5.0,12,5.25
8,6,5.375,5.33333333333333,14,5.35714285714286
11,7,5.54545454545455,5.42857142857143,18,5.5
14,8,5.42857142857143,5.375,22,5.40909090909091
14,8,5.42857142857143,5.375,22,5.40909090909091
20,10,5.7,5.4,30,5.6
20,11,5.7,5.54545454545455,31,5.64516129032258
26,14,5.61538461538461,5.42857142857143,40,5.55
34,14,5.94117647058824,5.42857142857143,48,5.79166666666667
38,14,5.84210526315789,5.42857142857143,52,5.73076923076923
48,20,5.75,5.7,68,5.73529411764706
64,20,6.0625,5.7,84,5.97619047619048
68,21,5.94117647058824,5.71428571428571,89,5.8876404494382
76,26,5.84210526315789,5.61538461538461,102,5.7843137254902
124,34,6.16129032258065,5.94117647058824,158,6.11392405063291
123,34,6.16260162601626,5.94117647058824,157,6.11464968152866
123,37,6.16260162601626,5.86486486486486,160,6.09375
246,38,6.16260162601626,5.84210526315789,284,6.11971830985915
246,51,6.16260162601626,5.84313725490196,297,6.10774410774411
246,64,6.16260162601626,6.0625,310,6.14193548387097
374,64,6.44919786096257,6.0625,438,6.39269406392694
466,68,6.29613733905579,5.94117647058824,534,6.25093632958801
483,68,6.21946169772257,5.94117647058824,551,6.18511796733212
740,114,6.48648648648649,6.18421052631579,854,6.44613583138173
869,124,6.38319907940161,6.16129032258065,993,6.35548841893253
867,124,6.37946943483276,6.16129032258065,991,6.35216952573158
886,112,6.30925507900677,6.13392857142857,998,6.28957915831663
891,108,6.37934904601571,6.19444444444444,999,6.35935935935936
883,116,6.32955832389581,6.29310344827586,999,6.32532532532533
873,126,6.37227949599084,6.18253968253968,999,6.34834834834835
883,116,6.39071347678369,6.11206896551724,999,6.35835835835836
888,110,6.39301801801802,6.14545454545455,998,6.36573146292585
896,101,6.40513392857143,6.16831683168317,997,6.38114343029087
895,104,6.37206703910615,6.18269230769231,999,6.35235235235235
882,116,6.36054421768707,6.20689655172414,998,6.34268537074148
891,108,6.3658810325477,6.23148148148148,999,6.35135135135135
894,105,6.39149888143177,6.23809523809524,999,6.37537537537538
894,105,6.41834451901566,6.25714285714286,999,6.4014014014014
897,101,6.38238573021182,6.1980198019802,998,6.36372745490982
897,100,6.39464882943144,6.26,997,6.38114343029087
905,94,6.40773480662983,6.28723404255319,999,6.3963963963964
906,92,6.3841059602649,6.27173913043478,998,6.37374749498998
905,93,6.40220994475138,6.31182795698925,998,6.3937875751503
909,90,6.41254125412541,6.32222222222222,999,6.4044044044044
914,84,6.40153172866521,6.30952380952381,998,6.3937875751503
910,89,6.40769230769231,6.26966292134831,999,6.3953953953954
907,90,6.42778390297685,6.27777777777778,997,6.41424272818455
910,88,6.41978021978022,6.36363636363636,998,6.41482965931864
916,82,6.41921397379913,6.39024390243902,998,6.41683366733467
919,79,6.41784548422198,6.37974683544304,998,6.41482965931864
916,83,6.43777292576419,6.37349397590361,999,6.43243243243243
925,74,6.43459459459459,6.40540540540541,999,6.43243243243243
922,76,6.43600867678959,6.43421052631579,998,6.43587174348697
931,68,6.4640171858217,6.51470588235294,999,6.46746746746747
932,66,6.42167381974249,6.46969696969697,998,6.4248496993988
933,65,6.40407288317256,6.50769230769231,998,6.41082164328657
926,69,6.44492440604752,6.55072463768116,995,6.45226130653266
922,76,6.4587852494577,6.52631578947368,998,6.46392785571142
920,79,6.4554347826087,6.54430379746835,999,6.46246246246246
925,74,6.44540540540541,6.60810810810811,999,6.45745745745746
928,70,6.44396551724138,6.61428571428571,998,6.45591182364729
923,75,6.43336944745395,6.62666666666667,998,6.44789579158317
924,74,6.45238095238095,6.66216216216216,998,6.46793587174349
926,72,6.46868250539957,6.625,998,6.47995991983968
933,65,6.44051446945338,6.6,998,6.45090180360721
936,63,6.4508547008547,6.57142857142857,999,6.45845845845846
930,69,6.46344086021505,6.56521739130435,999,6.47047047047047
931,68,6.45435016111708,6.55882352941176,999,6.46146146146146
932,66,6.46351931330472,6.56060606060606,998,6.46993987975952
932,67,6.46781115879828,6.65671641791045,999,6.48048048048048
936,62,6.46047008547009,6.61290322580645,998,6.46993987975952
938,60,6.4456289978678,6.61666666666667,998,6.45591182364729
936,62,6.46153846153846,6.61290322580645,998,6.47094188376754
938,61,6.47974413646055,6.60655737704918,999,6.48748748748749
939,60,6.49307774227902,6.65,999,6.5025025025025
938,60,6.48507462686567,6.66666666666667,998,6.49599198396794
937,61,6.47812166488794,6.65573770491803,998,6.48897795591182
933,65,6.4876741693462,6.61538461538461,998,6.49599198396794
929,69,6.5048439181916,6.60869565217391,998,6.51202404809619
930,68,6.50752688172043,6.64705882352941,998,6.51703406813627
933,65,6.4983922829582,6.63076923076923,998,6.50701402805611
935,63,6.50160427807487,6.61904761904762,998,6.50901803607214
934,65,6.53640256959315,6.63076923076923,999,6.54254254254254
931,67,6.54135338345865,6.61194029850746,998,6.54609218436874
935,64,6.55614973262032,6.625,999,6.56056056056056
932,65,6.55579399141631,6.64615384615385,997,6.5616850551655
935,64,6.5475935828877,6.640625,999,6.55355355355355
932,64,6.55472103004292,6.6875,996,6.56325301204819
933,65,6.56698821007503,6.61538461538461,998,6.57014028056112
929,69,6.57588805166846,6.68115942028986,998,6.58316633266533
936,63,6.56837606837607,6.73015873015873,999,6.57857857857858
937,62,6.55709711846318,6.75806451612903,999,6.56956956956957
934,65,6.5610278372591,6.75384615384615,999,6.57357357357357
938,60,6.57995735607676,6.75,998,6.59018036072144
933,66,6.58413719185423,6.74242424242424,999,6.59459459459459
935,64,6.60534759358289,6.6875,999,6.61061061061061
942,57,6.59341825902335,6.75438596491228,999,6.6026026026026
942,57,6.58917197452229,6.80701754385965,999,6.6016016016016
944,55,6.58898305084746,6.81818181818182,999,6.6016016016016
944,53,6.59322033898305,6.77358490566038,997,6.60280842527583
945,54,6.59365079365079,6.7962962962963,999,6.6046046046046
944,54,6.59322033898305,6.7962962962963,998,6.60420841683367
945,54,6.6010582010582,6.7962962962963,999,6.61161161161161
948,51,6.60126582278481,6.7843137254902,999,6.61061061061061
946,51,6.60887949260042,6.76470588235294,997,6.61685055165496
947,51,6.61879619852165,6.74509803921569,998,6.625250501002
953,46,6.62539349422875,6.73913043478261,999,6.63063063063063
950,49,6.63473684210526,6.75510204081633,999,6.64064064064064
948,51,6.62763713080169,6.76470588235294,999,6.63463463463463
943,55,6.63944856839873,6.76363636363636,998,6.64629258517034
941,56,6.65462274176408,6.73214285714286,997,6.65897693079238
941,58,6.65037194473964,6.68965517241379,999,6.65265265265265
950,48,6.64315789473684,6.72916666666667,998,6.64729458917836
952,47,6.65126050420168,6.74468085106383,999,6.65565565565566
947,52,6.65364308342133,6.75,999,6.65865865865866
949,50,6.6522655426765,6.76,999,6.65765765765766
950,48,6.65157894736842,6.75,998,6.6563126252505
950,48,6.65052631578947,6.79166666666667,998,6.65731462925852
952,47,6.63760504201681,6.78723404255319,999,6.64464464464464
948,50,6.64662447257384,6.78,998,6.65330661322645
946,52,6.64164904862579,6.78846153846154,998,6.64929859719439
952,46,6.63970588235294,6.80434782608696,998,6.64729458917836
953,46,6.63064008394544,6.80434782608696,999,6.63863863863864
952,44,6.63655462184874,6.81818181818182,996,6.64457831325301
956,42,6.63702928870293,6.80952380952381,998,6.64428857715431
959,40,6.64129301355579,6.825,999,6.64864864864865
958,37,6.65657620041754,6.78378378378378,995,6.66130653266332
962,37,6.65488565488566,6.81081081081081,999,6.66066066066066
960,38,6.646875,6.76315789473684,998,6.65130260521042
957,41,6.64263322884013,6.80487804878049,998,6.64929859719439
957,38,6.63740856844305,6.76315789473684,995,6.64221105527638
959,39,6.63190823774765,6.76923076923077,998,6.6372745490982
959,37,6.63503649635036,6.72972972972973,996,6.63855421686747
963,35,6.62928348909657,6.71428571428571,998,6.63226452905812
964,34,6.61929460580913,6.76470588235294,998,6.62424849699399
964,34,6.61203319502075,6.73529411764706,998,6.61623246492986
957,37,6.63531870428422,6.75675675675676,994,6.63983903420523
959,40,6.63295099061522,6.75,999,6.63763763763764
958,40,6.62004175365345,6.775,998,6.62625250501002
963,35,6.62305295950156,6.82857142857143,998,6.63026052104208
962,36,6.62889812889813,6.86111111111111,998,6.6372745490982
961,38,6.62539021852237,6.86842105263158,999,6.63463463463463
958,40,6.61795407098121,6.85,998,6.62725450901804
958,40,6.62108559498956,6.825,998,6.62925851703407
961,38,6.62747138397503,6.81578947368421,999,6.63463463463463
961,38,6.62226847034339,6.86842105263158,999,6.63163163163163
956,40,6.63389121338912,6.875,996,6.64357429718875
964,34,6.63174273858921,6.91176470588235,998,6.64128256513026
964,34,6.63381742738589,6.88235294117647,998,6.64228456913828
962,36,6.63721413721414,6.86111111111111,998,6.64529058116232
963,36,6.63343717549325,6.86111111111111,999,6.64164164164164
958,38,6.62734864300626,6.86842105263158,996,6.63654618473896
963,35,6.63136033229491,6.85714285714286,998,6.63927855711423
961,37,6.64412070759625,6.83783783783784,998,6.65130260521042
960,39,6.64270833333333,6.82051282051282,999,6.64964964964965
960,39,6.64583333333333,6.84615384615385,999,6.65365365365365
958,39,6.65135699373695,6.84615384615385,997,6.65897693079238
957,42,6.64994775339603,6.85714285714286,999,6.65865865865866
956,42,6.66213389121339,6.85714285714286,998,6.67034068136273
962,37,6.67463617463617,6.83783783783784,999,6.68068068068068
963,35,6.68328141225337,6.85714285714286,998,6.68937875751503
965,34,6.68082901554404,6.85294117647059,999,6.68668668668669
967,32,6.68769389865564,6.875,999,6.69369369369369
968,31,6.68595041322314,6.83870967741935,999,6.69069069069069
965,33,6.6860103626943,6.81818181818182,998,6.69038076152305
968,29,6.68801652892562,6.79310344827586,997,6.69107321965898
969,30,6.68111455108359,6.8,999,6.68468468468468
969,28,6.6687306501548,6.82142857142857,997,6.67301905717151
972,26,6.67078189300411,6.80769230769231,998,6.67434869739479
973,25,6.67009249743063,6.8,998,6.67334669338677
969,27,6.67595459236326,6.81481481481481,996,6.67971887550201
971,27,6.67868177136972,6.81481481481481,998,6.68236472945892
976,23,6.67930327868852,6.78260869565217,999,6.68168168168168
976,22,6.67622950819672,6.81818181818182,998,6.67935871743487
974,25,6.68172484599589,6.84,999,6.68568568568569
976,23,6.68340163934426,6.82608695652174,999,6.68668668668669
975,24,6.69025641025641,6.83333333333333,999,6.69369369369369
973,22,6.68448098663926,6.81818181818182,995,6.68743718592965
974,22,6.68788501026694,6.81818181818182,996,6.69076305220884
973,26,6.6896197327852,6.80769230769231,999,6.69269269269269
972,27,6.69444444444444,6.85185185185185,999,6.6986986986987
976,23,6.68954918032787,6.82608695652174,999,6.69269269269269
976,23,6.69877049180328,6.82608695652174,999,6.7017017017017
975,24,6.70974358974359,6.875,999,6.71371371371371
976,23,6.71004098360656,6.8695652173913,999,6.71371371371371
977,22,6.70726714431934,6.86363636363636,999,6.71071071071071
978,19,6.69836400817996,6.84210526315789,997,6.70110330992979
980,17,6.70408163265306,6.82352941176471,997,6.7061183550652
980,19,6.70204081632653,6.78947368421053,999,6.7037037037037
980,18,6.70714285714286,6.83333333333333,998,6.70941883767535
981,16,6.70540265035678,6.8125,997,6.70712136409228
981,17,6.70846075433231,6.76470588235294,998,6.70941883767535
981,17,6.72069317023445,6.82352941176471,998,6.72244488977956
980,17,6.71632653061225,6.76470588235294,997,6.71715145436309
982,16,6.71283095723014,6.75,998,6.71342685370742
983,16,6.72431332655137,6.75,999,6.72472472472472
981,18,6.7420998980632,6.72222222222222,999,6.74174174174174
981,18,6.74006116207951,6.72222222222222,999,6.73973973973974
979,20,6.73544433094995,6.7,999,6.73473473473473
977,22,6.73899692937564,6.72727272727273,999,6.73873873873874
977,21,6.73592630501535,6.76190476190476,998,6.73647294589178
975,22,6.7425641025641,6.77272727272727,997,6.7432296890672
977,21,6.74309109518935,6.80952380952381,998,6.74448897795591
978,21,6.74335378323108,6.80952380952381,999,6.74474474474474
974,25,6.74948665297741,6.8,999,6.75075075075075
975,24,6.75589743589744,6.875,999,6.75875875875876
978,19,6.74539877300614,6.89473684210526,997,6.74824473420261
980,18,6.75408163265306,6.88888888888889,998,6.7565130260521
974,22,6.75256673511294,6.86363636363636,996,6.75502008032128
979,19,6.75485188968335,6.84210526315789,998,6.7565130260521
981,18,6.75840978593272,6.83333333333333,999,6.75975975975976
981,18,6.76758409785933,6.83333333333333,999,6.76876876876877
981,17,6.76350662589195,6.82352941176471,998,6.76452905811623
985,14,6.76243654822335,6.85714285714286,999,6.76376376376376
987,12,6.76190476190476,6.83333333333333,999,6.76276276276276
987,12,6.76393110435664,6.91666666666667,999,6.76576576576577
989,10,6.75834175935288,6.9,999,6.75975975975976
990,9,6.75858585858586,6.88888888888889,999,6.75975975975976
989,10,6.76643073811931,6.9,999,6.76776776776777
990,9,6.75757575757576,6.88888888888889,999,6.75875875875876
992,7,6.75604838709677,6.85714285714286,999,6.75675675675676
991,7,6.76589303733602,6.85714285714286,998,6.76653306613226
990,8,6.76767676767677,6.875,998,6.7685370741483
992,7,6.76612903225806,6.85714285714286,999,6.76676676676677
991,7,6.76589303733602,6.85714285714286,998,6.76653306613226
992,7,6.76814516129032,6.85714285714286,999,6.76876876876877
990,9,6.76464646464646,6.77777777777778,999,6.76476476476476
988,10,6.76518218623482,6.8,998,6.76553106212425
989,8,6.77451971688574,6.75,997,6.77432296890672
992,7,6.77520161290323,6.71428571428571,999,6.77477477477477
991,7,6.77901109989909,6.71428571428571,998,6.77855711422846
992,6,6.77217741935484,6.66666666666667,998,6.77154308617235
992,7,6.77620967741935,6.57142857142857,999,6.77477477477477
992,7,6.77923387096774,6.57142857142857,999,6.77777777777778
992,6,6.77822580645161,6.66666666666667,998,6.77755511022044
992,6,6.78528225806452,6.66666666666667,998,6.78456913827655
992,6,6.79737903225806,6.66666666666667,998,6.79659318637275
992,7,6.80040322580645,6.57142857142857,999,6.7987987987988
988,8,6.79655870445344,6.625,996,6.79518072289157
990,9,6.8020202020202,6.66666666666667,999,6.8008008008008
992,7,6.80846774193548,6.57142857142857,999,6.80680680680681
993,6,6.80563947633434,6.5,999,6.8038038038038
993,5,6.80463242698892,6.4,998,6.80260521042084
992,6,6.80241935483871,6.33333333333333,998,6.79959919839679
991,7,6.80423814328961,6.42857142857143,998,6.80160320641283
993,5,6.80161127895267,6.6,998,6.80060120240481
994,5,6.79376257545272,6.6,999,6.79279279279279
995,4,6.79095477386935,6.5,999,6.78978978978979
995,4,6.78793969849246,6.5,999,6.78678678678679
994,4,6.79175050301811,6.75,998,6.79158316633267
996,3,6.78212851405623,7.0,999,6.78278278278278
997,2,6.78234704112337,7.0,999,6.78278278278278
996,2,6.785140562249,7.0,998,6.78557114228457
994,2,6.78269617706237,7.0,996,6.78313253012048
997,2,6.78535606820461,7.0,999,6.78578578578579
995,2,6.78693467336683,7.0,997,6.78736208625878
997,2,6.79739217652959,7.0,999,6.7977977977978
997,2,6.79939819458375,7.0,999,6.7997997997998
995,3,6.79597989949749,7.0,998,6.79659318637275
996,2,6.78815261044177,7.0,998,6.78857715430862
997,2,6.78335005015045,7.0,999,6.78378378378378
998,1,6.78456913827655,7.0,999,6.78478478478478
998,1,6.78456913827655,7.0,999,6.78478478478478
997,1,6.78736208625878,7.0,998,6.7875751503006
997,1,6.78836509528586,7.0,998,6.78857715430862
996,1,6.79317269076305,7.0,997,6.79338014042126
997,1,6.79638916750251,7.0,998,6.79659318637275
998,1,6.79258517034068,7.0,999,6.79279279279279
997,1,6.79237713139418,7.0,998,6.79258517034068
998,1,6.79659318637275,7.0,999,6.7967967967968
996,1,6.79718875502008,7.0,997,6.79739217652959
997,1,6.79638916750251,7.0,998,6.79659318637275
998,1,6.78857715430862,7.0,999,6.78878878878879
998,0,6.78857715430862,NaN,998,6.78857715430862
999,0,6.79379379379379,NaN,999,6.79379379379379
999,0,6.78178178178178,NaN,999,6.78178178178178
997,0,6.78335005015045,NaN,997,6.78335005015045
998,0,6.77054108216433,NaN,998,6.77054108216433
998,0,6.76152304609218,NaN,998,6.76152304609218
999,0,6.76776776776777,NaN,999,6.76776776776777
998,0,6.7565130260521,NaN,998,6.7565130260521
998,0,6.75450901803607,NaN,998,6.75450901803607
998,0,6.75751503006012,NaN,998,6.75751503006012
998,0,6.75450901803607,NaN,998,6.75450901803607
998,0,6.74549098196393,NaN,998,6.74549098196393
998,0,6.75250501002004,NaN,998,6.75250501002004
997,0,6.75626880641926,NaN,997,6.75626880641926
998,0,6.76052104208417,NaN,998,6.76052104208417
998,0,6.7625250501002,NaN,998,6.7625250501002
999,0,6.77077077077077,NaN,999,6.77077077077077
999,0,6.76476476476476,NaN,999,6.76476476476476
997,0,6.76429287863591,NaN,997,6.76429287863591
999,0,6.75775775775776,NaN,999,6.75775775775776
997,0,6.76228686058174,NaN,997,6.76228686058174
999,0,6.75975975975976,NaN,999,6.75975975975976
998,0,6.76452905811623,NaN,998,6.76452905811623
999,0,6.77677677677678,NaN,999,6.77677677677678
997,0,6.77632898696088,NaN,997,6.77632898696088
999,0,6.77777777777778,NaN,999,6.77777777777778
999,0,6.78378378378378,NaN,999,6.78378378378378
999,0,6.78078078078078,NaN,999,6.78078078078078
999,0,6.76776776776777,NaN,999,6.76776776776777
995,0,6.76984924623116,NaN,995,6.76984924623116
999,0,6.77977977977978,NaN,999,6.77977977977978
998,0,6.77454909819639,NaN,998,6.77454909819639
999,0,6.77277277277277,NaN,999,6.77277277277277
999,0,6.78078078078078,NaN,999,6.78078078078078
998,0,6.77054108216433,NaN,998,6.77054108216433
999,0,6.76476476476476,NaN,999,6.76476476476476
999,0,6.76776776776777,NaN,999,6.76776776776777
999,0,6.76576576576577,NaN,999,6.76576576576577
998,0,6.76953907815631,NaN,998,6.76953907815631
998,0,6.76753507014028,NaN,998,6.76753507014028
998,0,6.77454909819639,NaN,998,6.77454909819639
999,0,6.77477477477477,NaN,999,6.77477477477477
999,0,6.78278278278278,NaN,999,6.78278278278278
999,0,6.77277277277277,NaN,999,6.77277277277277
999,0,6.78678678678679,NaN,999,6.78678678678679
998,0,6.78957915831663,NaN,998,6.78957915831663
999,0,6.77977977977978,NaN,999,6.77977977977978
998,0,6.78356713426854,NaN,998,6.78356713426854
999,0,6.77877877877878,NaN,999,6.77877877877878
998,0,6.78356713426854,NaN,998,6.78356713426854
998,0,6.78356713426854,NaN,998,6.78356713426854
998,0,6.78557114228457,NaN,998,6.78557114228457
998,0,6.78557114228457,NaN,998,6.78557114228457
999,0,6.78878878878879,NaN,999,6.78878878878879
999,0,6.79379379379379,NaN,999,6.79379379379379
999,0,6.8008008008008,NaN,999,6.8008008008008
999,0,6.7977977977978,NaN,999,6.7977977977978
997,0,6.79839518555667,NaN,997,6.79839518555667
999,0,6.79279279279279,NaN,999,6.79279279279279
999,0,6.7997997997998,NaN,999,6.7997997997998
999,0,6.7957957957958,NaN,999,6.7957957957958
998,0,6.80460921843687,NaN,998,6.80460921843687
999,0,6.80680680680681,NaN,999,6.80680680680681
999,0,6.8018018018018,NaN,999,6.8018018018018
998,0,6.80761523046092,NaN,998,6.80761523046092
999,0,6.80880880880881,NaN,999,6.80880880880881
997,0,6.8074222668004,NaN,997,6.8074222668004
998,0,6.81763527054108,NaN,998,6.81763527054108
999,0,6.81881881881882,NaN,999,6.81881881881882
999,0,6.81881881881882,NaN,999,6.81881881881882
999,0,6.82582582582583,NaN,999,6.82582582582583
999,0,6.83183183183183,NaN,999,6.83183183183183
998,0,6.83166332665331,NaN,998,6.83166332665331
998,0,6.83466933867735,NaN,998,6.83466933867735
999,0,6.83583583583584,NaN,999,6.83583583583584
998,0,6.83667334669339,NaN,998,6.83667334669339
997,0,6.83550651955868,NaN,997,6.83550651955868
999,0,6.84284284284284,NaN,999,6.84284284284284
996,0,6.84136546184739,NaN,996,6.84136546184739
998,0,6.83967935871743,NaN,998,6.83967935871743
998,0,6.83867735470942,NaN,998,6.83867735470942
999,0,6.84284284284284,NaN,999,6.84284284284284
998,0,6.83967935871743,NaN,998,6.83967935871743
997,0,6.83350050150451,NaN,997,6.83350050150451
998,0,6.83366733466934,NaN,998,6.83366733466934
999,0,6.83683683683684,NaN,999,6.83683683683684
999,0,6.83483483483483,NaN,999,6.83483483483483
999,0,6.83383383383383,NaN,999,6.83383383383383
999,0,6.83483483483483,NaN,999,6.83483483483483
999,0,6.83383383383383,NaN,999,6.83383383383383
997,0,6.83550651955868,NaN,997,6.83550651955868
999,0,6.83383383383383,NaN,999,6.83383383383383
999,0,6.82782782782783,NaN,999,6.82782782782783
999,0,6.83183183183183,NaN,999,6.83183183183183
999,0,6.83583583583584,NaN,999,6.83583583583584
999,0,6.83483483483483,NaN,999,6.83483483483483
998,0,6.83166332665331,NaN,998,6.83166332665331
998,0,6.83466933867735,NaN,998,6.83466933867735
999,0,6.84184184184184,NaN,999,6.84184184184184
999,0,6.84384384384384,NaN,999,6.84384384384384
998,0,6.84168336673347,NaN,998,6.84168336673347
998,0,6.8376753507014,NaN,998,6.8376753507014
998,0,6.83667334669339,NaN,998,6.83667334669339
999,0,6.83383383383383,NaN,999,6.83383383383383
999,0,6.83583583583584,NaN,999,6.83583583583584
999,0,6.83283283283283,NaN,999,6.83283283283283
998,0,6.83466933867735,NaN,998,6.83466933867735
996,0,6.84538152610442,NaN,996,6.84538152610442
998,0,6.85170340681363,NaN,998,6.85170340681363
999,0,6.84884884884885,NaN,999,6.84884884884885
998,0,6.84168336673347,NaN,998,6.84168336673347
998,0,6.84068136272545,NaN,998,6.84068136272545
999,0,6.84084084084084,NaN,999,6.84084084084084
998,0,6.84569138276553,NaN,998,6.84569138276553
999,0,6.84484484484484,NaN,999,6.84484484484484
998,0,6.8496993987976,NaN,998,6.8496993987976
997,0,6.84553660982949,NaN,997,6.84553660982949
999,0,6.85085085085085,NaN,999,6.85085085085085
998,0,6.85270541082164,NaN,998,6.85270541082164
999,0,6.84684684684685,NaN,999,6.84684684684685
997,0,6.84453360080241,NaN,997,6.84453360080241
998,0,6.84869739478958,NaN,998,6.84869739478958
997,0,6.8555667001003,NaN,997,6.8555667001003
999,0,6.85485485485485,NaN,999,6.85485485485485
999,0,6.85485485485485,NaN,999,6.85485485485485
999,0,6.85785785785786,NaN,999,6.85785785785786
999,0,6.85585585585586,NaN,999,6.85585585585586
998,0,6.8627254509018,NaN,998,6.8627254509018
997,0,6.86659979939819,NaN,997,6.86659979939819
998,0,6.86973947895792,NaN,998,6.86973947895792
998,0,6.87274549098196,NaN,998,6.87274549098196
998,0,6.87775551102204,NaN,998,6.87775551102204
999,0,6.87587587587588,NaN,999,6.87587587587588
998,0,6.87374749498998,NaN,998,6.87374749498998
999,0,6.87887887887888,NaN,999,6.87887887887888
999,0,6.87987987987988,NaN,999,6.87987987987988
999,0,6.88188188188188,NaN,999,6.88188188188188
997,0,6.88164493480441,NaN,997,6.88164493480441
998,0,6.88376753507014,NaN,998,6.88376753507014
999,0,6.88288288288288,NaN,999,6.88288288288288
999,0,6.88288288288288,NaN,999,6.88288288288288
999,0,6.88388388388388,NaN,999,6.88388388388388
998,0,6.88877755511022,NaN,998,6.88877755511022
998,0,6.89278557114228,NaN,998,6.89278557114228
997,0,6.89167502507523,NaN,997,6.89167502507523
999,0,6.88888888888889,NaN,999,6.88888888888889
996,0,6.89156626506024,NaN,996,6.89156626506024
998,0,6.89178356713427,NaN,998,6.89178356713427
999,0,6.89089089089089,NaN,999,6.89089089089089
998,0,6.89178356713427,NaN,998,6.89178356713427
999,0,6.88788788788789,NaN,999,6.88788788788789
998,0,6.89078156312625,NaN,998,6.89078156312625
999,0,6.88988988988989,NaN,999,6.88988988988989
998,0,6.88877755511022,NaN,998,6.88877755511022
999,0,6.89289289289289,NaN,999,6.89289289289289
999,0,6.89389389389389,NaN,999,6.89389389389389
999,0,6.89189189189189,NaN,999,6.89189189189189
999,0,6.89389389389389,NaN,999,6.89389389389389
999,0,6.8958958958959,NaN,999,6.8958958958959
999,0,6.89389389389389,NaN,999,6.89389389389389
999,0,6.8958958958959,NaN,999,6.8958958958959
998,0,6.8937875751503,NaN,998,6.8937875751503
999,0,6.89389389389389,NaN,999,6.89389389389389
998,0,6.89679358717435,NaN,998,6.89679358717435
999,0,6.8978978978979,NaN,999,6.8978978978979
999,0,6.8998998998999,NaN,999,6.8998998998999
999,0,6.90590590590591,NaN,999,6.90590590590591
998,0,6.8997995991984,NaN,998,6.8997995991984
997,0,6.90170511534604,NaN,997,6.90170511534604
999,0,6.9029029029029,NaN,999,6.9029029029029
999,0,6.9009009009009,NaN,999,6.9009009009009
999,0,6.9019019019019,NaN,999,6.9019019019019
998,0,6.90781563126253,NaN,998,6.90781563126253
998,0,6.90881763527054,NaN,998,6.90881763527054
997,0,6.9037111334002,NaN,997,6.9037111334002
998,0,6.90480961923848,NaN,998,6.90480961923848
998,0,6.90280561122244,NaN,998,6.90280561122244
999,0,6.90690690690691,NaN,999,6.90690690690691
999,0,6.91091091091091,NaN,999,6.91091091091091
999,0,6.91291291291291,NaN,999,6.91291291291291
999,0,6.91391391391391,NaN,999,6.91391391391391
997,0,6.91574724172518,NaN,997,6.91574724172518
999,0,6.92592592592593,NaN,999,6.92592592592593
999,0,6.92492492492492,NaN,999,6.92492492492492
998,0,6.92685370741483,NaN,998,6.92685370741483
996,0,6.92871485943775,NaN,996,6.92871485943775
999,0,6.93493493493493,NaN,999,6.93493493493493
998,0,6.92985971943888,NaN,998,6.92985971943888
999,0,6.92492492492492,NaN,999,6.92492492492492
998,0,6.92785571142285,NaN,998,6.92785571142285
998,0,6.92685370741483,NaN,998,6.92685370741483
997,0,6.92978936810431,NaN,997,6.92978936810431
999,0,6.93293293293293,NaN,999,6.93293293293293
999,0,6.93693693693694,NaN,999,6.93693693693694
998,0,6.93687374749499,NaN,998,6.93687374749499
998,0,6.94188376753507,NaN,998,6.94188376753507
996,0,6.94377510040161,NaN,996,6.94377510040161
996,0,6.94477911646586,NaN,996,6.94477911646586
998,0,6.94188376753507,NaN,998,6.94188376753507
997,0,6.94684052156469,NaN,997,6.94684052156469
999,0,6.94594594594595,NaN,999,6.94594594594595
998,0,6.9438877755511,NaN,998,6.9438877755511
997,0,6.94784353059178,NaN,997,6.94784353059178
997,0,6.94583751253761,NaN,997,6.94583751253761
999,0,6.94994994994995,NaN,999,6.94994994994995
999,0,6.95095095095095,NaN,999,6.95095095095095
999,0,6.95395395395395,NaN,999,6.95395395395395
997,0,6.95285857572718,NaN,997,6.95285857572718
999,0,6.95895895895896,NaN,999,6.95895895895896
999,0,6.96096096096096,NaN,999,6.96096096096096
997,0,6.96288866599799,NaN,997,6.96288866599799
999,0,6.96396396396396,NaN,999,6.96396396396396
999,0,6.96496496496496,NaN,999,6.96496496496496
998,0,6.96492985971944,NaN,998,6.96492985971944
998,0,6.96392785571142,NaN,998,6.96392785571142
999,0,6.96696696696697,NaN,999,6.96696696696697
997,0,6.96890672016048,NaN,997,6.96890672016048
998,0,6.97094188376754,NaN,998,6.97094188376754
999,0,6.96896896896897,NaN,999,6.96896896896897
999,0,6.97197197197197,NaN,999,6.97197197197197
998,0,6.97094188376754,NaN,998,6.97094188376754
999,0,6.96896896896897,NaN,999,6.96896896896897
999,0,6.96896896896897,NaN,999,6.96896896896897
999,0,6.97197197197197,NaN,999,6.97197197197197
998,0,6.96993987975952,NaN,998,6.96993987975952
999,0,6.97097097097097,NaN,999,6.97097097097097
998,0,6.97394789579158,NaN,998,6.97394789579158
999,0,6.97297297297297,NaN,999,6.97297297297297
999,0,6.96996996996997,NaN,999,6.96996996996997
995,0,6.97085427135678,NaN,995,6.97085427135678
999,0,6.97197197197197,NaN,999,6.97197197197197
998,0,6.96793587174349,NaN,998,6.96793587174349
998,0,6.9689378757515,NaN,998,6.9689378757515
998,0,6.97094188376754,NaN,998,6.97094188376754
999,0,6.96796796796797,NaN,999,6.96796796796797
999,0,6.96696696696697,NaN,999,6.96696696696697
999,0,6.96896896896897,NaN,999,6.96896896896897
998,0,6.96993987975952,NaN,998,6.96993987975952
998,0,6.96993987975952,NaN,998,6.96993987975952
998,0,6.9689378757515,NaN,998,6.9689378757515
999,0,6.97297297297297,NaN,999,6.97297297297297
998,0,6.97394789579158,NaN,998,6.97394789579158
997,0,6.97191574724173,NaN,997,6.97191574724173
998,0,6.97394789579158,NaN,998,6.97394789579158
997,0,6.97492477432297,NaN,997,6.97492477432297
998,0,6.97394789579158,NaN,998,6.97394789579158
999,0,6.97497497497497,NaN,999,6.97497497497497
998,0,6.97795591182365,NaN,998,6.97795591182365
999,0,6.97797797797798,NaN,999,6.97797797797798
999,0,6.97797797797798,NaN,999,6.97797797797798
998,0,6.97394789579158,NaN,998,6.97394789579158
998,0,6.9749498997996,NaN,998,6.9749498997996
999,0,6.97497497497497,NaN,999,6.97497497497497
998,0,6.97194388777555,NaN,998,6.97194388777555
999,0,6.96996996996997,NaN,999,6.96996996996997
999,0,6.97297297297297,NaN,999,6.97297297297297
999,0,6.97297297297297,NaN,999,6.97297297297297
998,0,6.97194388777555,NaN,998,6.97194388777555
999,0,6.97197197197197,NaN,999,6.97197197197197
999,0,6.97197197197197,NaN,999,6.97197197197197
997,0,6.97091273821464,NaN,997,6.97091273821464
999,0,6.97297297297297,NaN,999,6.97297297297297
999,0,6.97497497497497,NaN,999,6.97497497497497
999,0,6.97397397397397,NaN,999,6.97397397397397
999,0,6.97097097097097,NaN,999,6.97097097097097
996,0,6.9718875502008,NaN,996,6.9718875502008
995,0,6.97587939698492,NaN,995,6.97587939698492
998,0,6.97294589178357,NaN,998,6.97294589178357
999,0,6.97497497497497,NaN,999,6.97497497497497
999,0,6.97497497497497,NaN,999,6.97497497497497
997,0,6.97492477432297,NaN,997,6.97492477432297
998,0,6.97394789579158,NaN,998,6.97394789579158
997,0,6.97392176529589,NaN,997,6.97392176529589
998,0,6.97895791583166,NaN,998,6.97895791583166
998,0,6.97995991983968,NaN,998,6.97995991983968
998,0,6.98096192384769,NaN,998,6.98096192384769
997,0,6.98194583751254,NaN,997,6.98194583751254
998,0,6.98396793587174,NaN,998,6.98396793587174
998,0,6.98096192384769,NaN,998,6.98096192384769
998,0,6.98296593186373,NaN,998,6.98296593186373
999,0,6.98698698698699,NaN,999,6.98698698698699
998,0,6.98496993987976,NaN,998,6.98496993987976
999,0,6.98398398398398,NaN,999,6.98398398398398
999,0,6.98398398398398,NaN,999,6.98398398398398
999,0,6.98298298298298,NaN,999,6.98298298298298
998,0,6.98096192384769,NaN,998,6.98096192384769
999,0,6.98198198198198,NaN,999,6.98198198198198
998,0,6.98096192384769,NaN,998,6.98096192384769
998,0,6.98296593186373,NaN,998,6.98296593186373
999,0,6.98398398398398,NaN,999,6.98398398398398
999,0,6.98498498498498,NaN,999,6.98498498498498
999,0,6.98498498498498,NaN,999,6.98498498498498
999,0,6.98598598598599,NaN,999,6.98598598598599
999,0,6.98698698698699,NaN,999,6.98698698698699
998,0,6.98997995991984,NaN,998,6.98997995991984
999,0,6.98798798798799,NaN,999,6.98798798798799
997,0,6.98896690070211,NaN,997,6.98896690070211
997,0,6.98896690070211,NaN,997,6.98896690070211
999,0,6.98698698698699,NaN,999,6.98698698698699
997,0,6.98595787362086,NaN,997,6.98595787362086
998,0,6.98697394789579,NaN,998,6.98697394789579
999,0,6.98798798798799,NaN,999,6.98798798798799
997,0,6.9839518555667,NaN,997,6.9839518555667
998,0,6.98496993987976,NaN,998,6.98496993987976
999,0,6.98598598598599,NaN,999,6.98598598598599
998,0,6.98496993987976,NaN,998,6.98496993987976
998,0,6.98697394789579,NaN,998,6.98697394789579
999,0,6.98798798798799,NaN,999,6.98798798798799
999,0,6.98598598598599,NaN,999,6.98598598598599
998,0,6.98496993987976,NaN,998,6.98496993987976
998,0,6.98697394789579,NaN,998,6.98697394789579
998,0,6.98597194388778,NaN,998,6.98597194388778
999,0,6.98498498498498,NaN,999,6.98498498498498
999,0,6.98698698698699,NaN,999,6.98698698698699
999,0,6.98798798798799,NaN,999,6.98798798798799
999,0,6.98698698698699,NaN,999,6.98698698698699
999,0,6.98598598598599,NaN,999,6.98598598598599
998,0,6.98697394789579,NaN,998,6.98697394789579
997,0,6.98595787362086,NaN,997,6.98595787362086
998,0,6.98396793587174,NaN,998,6.98396793587174
999,0,6.98298298298298,NaN,999,6.98298298298298
999,0,6.98298298298298,NaN,999,6.98298298298298
999,0,6.97997997997998,NaN,999,6.97997997997998
999,0,6.98198198198198,NaN,999,6.98198198198198
999,0,6.98198198198198,NaN,999,6.98198198198198
999,0,6.98298298298298,NaN,999,6.98298298298298
999,0,6.98098098098098,NaN,999,6.98098098098098
999,0,6.97897897897898,NaN,999,6.97897897897898
999,0,6.97897897897898,NaN,999,6.97897897897898
999,0,6.97797797797798,NaN,999,6.97797797797798
999,0,6.97897897897898,NaN,999,6.97897897897898
998,0,6.97695390781563,NaN,998,6.97695390781563
999,0,6.97797797797798,NaN,999,6.97797797797798
999,0,6.97797797797798,NaN,999,6.97797797797798
999,0,6.97697697697698,NaN,999,6.97697697697698
999,0,6.97897897897898,NaN,999,6.97897897897898
999,0,6.97997997997998,NaN,999,6.97997997997998
999,0,6.97797797797798,NaN,999,6.97797797797798
999,0,6.97797797797798,NaN,999,6.97797797797798
999,0,6.97997997997998,NaN,999,6.97997997997998
998,0,6.98096192384769,NaN,998,6.98096192384769
998,0,6.97695390781563,NaN,998,6.97695390781563
999,0,6.97997997997998,NaN,999,6.97997997997998
999,0,6.97797797797798,NaN,999,6.97797797797798
998,0,6.97895791583166,NaN,998,6.97895791583166
998,0,6.97695390781563,NaN,998,6.97695390781563
998,0,6.97895791583166,NaN,998,6.97895791583166
999,0,6.98098098098098,NaN,999,6.98098098098098
998,0,6.98196392785571,NaN,998,6.98196392785571
999,0,6.98398398398398,NaN,999,6.98398398398398
998,0,6.98396793587174,NaN,998,6.98396793587174
998,0,6.98496993987976,NaN,998,6.98496993987976
999,0,6.98698698698699,NaN,999,6.98698698698699
998,0,6.98797595190381,NaN,998,6.98797595190381
998,0,6.98597194388778,NaN,998,6.98597194388778
998,0,6.98597194388778,NaN,998,6.98597194388778
999,0,6.98798798798799,NaN,999,6.98798798798799
999,0,6.98598598598599,NaN,999,6.98598598598599
998,0,6.98597194388778,NaN,998,6.98597194388778
999,0,6.98998998998999,NaN,999,6.98998998998999
999,0,6.98798798798799,NaN,999,6.98798798798799
998,0,6.98897795591182,NaN,998,6.98897795591182
996,0,6.98694779116466,NaN,996,6.98694779116466
999,0,6.98698698698699,NaN,999,6.98698698698699
998,0,6.98697394789579,NaN,998,6.98697394789579
998,0,6.98396793587174,NaN,998,6.98396793587174
998,0,6.98597194388778,NaN,998,6.98597194388778
997,0,6.98696088264794,NaN,997,6.98696088264794
999,0,6.98798798798799,NaN,999,6.98798798798799
998,0,6.98797595190381,NaN,998,6.98797595190381
999,0,6.98698698698699,NaN,999,6.98698698698699
999,0,6.98798798798799,NaN,999,6.98798798798799
997,0,6.98796389167503,NaN,997,6.98796389167503
997,0,6.98796389167503,NaN,997,6.98796389167503
999,0,6.98798798798799,NaN,999,6.98798798798799
999,0,6.98898898898899,NaN,999,6.98898898898899
998,0,6.98997995991984,NaN,998,6.98997995991984
999,0,6.98898898898899,NaN,999,6.98898898898899
999,0,6.98998998998999,NaN,999,6.98998998998999
998,0,6.98997995991984,NaN,998,6.98997995991984
999,0,6.99099099099099,NaN,999,6.99099099099099
998,0,6.99198396793587,NaN,998,6.99198396793587
998,0,6.99298597194389,NaN,998,6.99298597194389
998,0,6.99298597194389,NaN,998,6.99298597194389
999,0,6.995995995996,NaN,999,6.995995995996
997,0,6.99699097291876,NaN,997,6.99699097291876
997,0,6.99699097291876,NaN,997,6.99699097291876
999,0,6.997997997998,NaN,999,6.997997997998
999,0,6.997997997998,NaN,999,6.997997997998
998,0,6.99799599198397,NaN,998,6.99799599198397
999,0,6.997997997998,NaN,999,6.997997997998
999,0,6.998998998999,NaN,999,6.998998998999
998,0,6.99899799599198,NaN,998,6.99899799599198
998,0,6.99899799599198,NaN,998,6.99899799599198
999,0,6.998998998999,NaN,999,6.998998998999
998,0,6.99799599198397,NaN,998,6.99799599198397
999,0,6.997997997998,NaN,999,6.997997997998
997,0,6.99799398194584,NaN,997,6.99799398194584
998,0,6.99799599198397,NaN,998,6.99799599198397
998,0,6.99699398797595,NaN,998,6.99699398797595
999,0,6.996996996997,NaN,999,6.996996996997
998,0,6.99699398797595,NaN,998,6.99699398797595
998,0,6.99599198396794,NaN,998,6.99599198396794
998,0,6.99599198396794,NaN,998,6.99599198396794
998,0,6.99599198396794,NaN,998,6.99599198396794
998,0,6.99599198396794,NaN,998,6.99599198396794
999,0,6.99499499499499,NaN,999,6.99499499499499
999,0,6.99499499499499,NaN,999,6.99499499499499
997,0,6.99498495486459,NaN,997,6.99498495486459
996,0,6.99397590361446,NaN,996,6.99397590361446
999,0,6.99499499499499,NaN,999,6.99499499499499
999,0,6.99499499499499,NaN,999,6.99499499499499
999,0,6.995995995996,NaN,999,6.995995995996
997,0,6.99598796389168,NaN,997,6.99598796389168
998,0,6.99599198396794,NaN,998,6.99599198396794
999,0,6.99399399399399,NaN,999,6.99399399399399
999,0,6.99399399399399,NaN,999,6.99399399399399
999,0,6.99399399399399,NaN,999,6.99399399399399
999,0,6.99399399399399,NaN,999,6.99399399399399
997,0,6.99197592778335,NaN,997,6.99197592778335
998,0,6.99298597194389,NaN,998,6.99298597194389
998,0,6.9939879759519,NaN,998,6.9939879759519
997,0,6.99498495486459,NaN,997,6.99498495486459
999,0,6.996996996997,NaN,999,6.996996996997
998,0,6.99699398797595,NaN,998,6.99699398797595
998,0,6.99699398797595,NaN,998,6.99699398797595
999,0,6.996996996997,NaN,999,6.996996996997
997,0,6.99799398194584,NaN,997,6.99799398194584
999,0,6.997997997998,NaN,999,6.997997997998
998,0,6.99699398797595,NaN,998,6.99699398797595
997,0,6.99699097291876,NaN,997,6.99699097291876
998,0,6.99799599198397,NaN,998,6.99799599198397
999,0,6.995995995996,NaN,999,6.995995995996
999,0,6.996996996997,NaN,999,6.996996996997
999,0,6.996996996997,NaN,999,6.996996996997
998,0,6.99699398797595,NaN,998,6.99699398797595
997,0,6.99498495486459,NaN,997,6.99498495486459
997,0,6.99598796389168,NaN,997,6.99598796389168
999,0,6.995995995996,NaN,999,6.995995995996
999,0,6.995995995996,NaN,999,6.995995995996
997,0,6.99598796389168,NaN,997,6.99598796389168
999,0,6.996996996997,NaN,999,6.996996996997
999,0,6.996996996997,NaN,999,6.996996996997
999,0,6.995995995996,NaN,999,6.995995995996
999,0,6.995995995996,NaN,999,6.995995995996
997,0,6.99699097291876,NaN,997,6.99699097291876
997,0,6.99699097291876,NaN,997,6.99699097291876
998,0,6.99699398797595,NaN,998,6.99699398797595
998,0,6.99699398797595,NaN,998,6.99699398797595
999,0,6.997997997998,NaN,999,6.997997997998
999,0,6.996996996997,NaN,999,6.996996996997
999,0,6.996996996997,NaN,999,6.996996996997
997,0,6.99699097291876,NaN,997,6.99699097291876
998,0,6.99699398797595,NaN,998,6.99699398797595
999,0,6.996996996997,NaN,999,6.996996996997
998,0,6.99699398797595,NaN,998,6.99699398797595
998,0,6.99799599198397,NaN,998,6.99799599198397
997,0,6.99699097291876,NaN,997,6.99699097291876
999,0,6.996996996997,NaN,999,6.996996996997
999,0,6.996996996997,NaN,999,6.996996996997
998,0,6.99599198396794,NaN,998,6.99599198396794
999,0,6.995995995996,NaN,999,6.995995995996
999,0,6.995995995996,NaN,999,6.995995995996
999,0,6.99499499499499,NaN,999,6.99499499499499
998,0,6.99599198396794,NaN,998,6.99599198396794
999,0,6.996996996997,NaN,999,6.996996996997
998,0,6.99599198396794,NaN,998,6.99599198396794
998,0,6.99699398797595,NaN,998,6.99699398797595
999,0,6.997997997998,NaN,999,6.997997997998
999,0,6.997997997998,NaN,999,6.997997997998
997,0,6.99699097291876,NaN,997,6.99699097291876
998,0,6.99799599198397,NaN,998,6.99799599198397
999,0,6.997997997998,NaN,999,6.997997997998
997,0,6.99799398194584,NaN,997,6.99799398194584
997,0,6.99799398194584,NaN,997,6.99799398194584
999,0,6.997997997998,NaN,999,6.997997997998
999,0,6.998998998999,NaN,999,6.998998998999
999,0,6.998998998999,NaN,999,6.998998998999
999,0,7.0,NaN,999,7.0
999,0,7.0,NaN,999,7.0
999,0,7.0,NaN,999,7.0
999,0,7.0,NaN,999,7.0
999,0,7.0,NaN,999,7.0
999,0,7.0,NaN,999,7.0
999,0,7.0,NaN,999,7.0
999,0,7.0,NaN,999,7.0
999,0,7.0,NaN,999,7.0
997,0,7.0,NaN,997,7.0
999,0,7.0,NaN,999,7.0
998,0,7.0,NaN,998,7.0
999,0,7.0,NaN,999,7.0
999,0,7.0,NaN,999,7.0
997,0,7.0,NaN,997,7.0
999,0,7.0,NaN,999,7.0
999,0,7.0,NaN,999,7.0
996,0,7.0,NaN,996,7.0
997,0,7.0,NaN,997,7.0
997,0,7.0,NaN,997,7.0
998,0,7.0,NaN,998,7.0
999,0,7.0,NaN,999,7.0
998,0,7.0,NaN,998,7.0
998,0,7.0,NaN,998,7.0
999,0,7.0,NaN,999,7.0
999,0,7.0,NaN,999,7.0
998,0,7.0,NaN,998,7.0
999,0,7.0,NaN,999,7.0
997,0,7.0,NaN,997,7.0
998,0,7.0,NaN,998,7.0
997,0,7.0,NaN,997,7.0
998,0,7.0,NaN,998,7.0
996,0,7.0,NaN,996,7.0
999,0,7.0,NaN,999,7.0
999,0,7.0,NaN,999,7.0
998,0,7.0,NaN,998,7.0
998,0,7.0,NaN,998,7.0
999,0,7.0,NaN,999,7.0
999,0,7.0,NaN,999,7.0
998,0,7.0,NaN,998,7.0
998,0,7.0,NaN,998,7.0
998,0,7.0,NaN,998,7.0
999,0,7.0,NaN,999,7.0
998,0,7.0,NaN,998,7.0
997,0,7.0,NaN,997,7.0
997,0,7.0,NaN,997,7.0
999,0,7.0,NaN,999,7.0
998,0,7.0,NaN,998,7.0
999,0,7.0,NaN,999,7.0
997,0,7.0,NaN,997,7.0
998,0,7.0,NaN,998,7.0
998,0,7.0,NaN,998,7.0
999,0,7.0,NaN,999,7.0
999,0,7.0,NaN,999,7.0
997,0,7.0,NaN,997,7.0
999,0,7.0,NaN,999,7.0
998,0,7.0,NaN,998,7.0
999,0,7.0,NaN,999,7.0
999,0,7.0,NaN,999,7.0
999,0,7.0,NaN,999,7.0
998,0,7.0,NaN,998,7.0
996,0,7.0,NaN,996,7.0
999,0,7.0,NaN,999,7.0
999,0,7.0,NaN,999,7.0
999,0,7.0,NaN,999,7.0
999,0,7.0,NaN,999,7.0
999,0,7.0,NaN,999,7.0
996,0,7.0,NaN,996,7.0
999,0,7.0,NaN,999,7.0
997,0,7.0,NaN,997,7.0
999,0,7.0,NaN,999,7.0
998,0,7.0,NaN,998,7.0
999,0,7.0,NaN,999,7.0
998,0,7.0,NaN,998,7.0
999,0,7.0,NaN,999,7.0
998,0,7.0,NaN,998,7.0
999,0,7.0,NaN,999,7.0
998,0,7.0,NaN,998,7.0
997,0,7.0,NaN,997,7.0
999,0,7.0,NaN,999,7.0
998,0,7.0,NaN,998,7.0
998,0,7.0,NaN,998,7.0
998,0,7.0,NaN,998,7.0
999,0,7.0,NaN,999,7.0
998,0,7.0,NaN,998,7.0
998,0,7.0,NaN,998,7.0
999,0,7.0,NaN,999,7.0
999,0,7.0,NaN,999,7.0
999,0,7.0,NaN,999,7.0
998,0,7.0,NaN,998,7.0
998,0,7.0,NaN,998,7.0
999,0,7.0,NaN,999,7.0
999,0,7.0,NaN,999,7.0
998,0,7.0,NaN,998,7.0
997,0,7.0,NaN,997,7.0
999,0,7.0,NaN,999,7.0
999,0,7.0,NaN,999,7.0
998,0,7.0,NaN,998,7.0
999,0,7.0,NaN,999,7.0
999,0,7.0,NaN,999,7.0
999,0,7.0,NaN,999,7.0
999,0,7.0,NaN,999,7.0
998,0,7.0,NaN,998,7.0
999,0,7.0,NaN,999,7.0
994,0,7.0,NaN,994,7.0
999,0,7.0,NaN,999,7.0
999,0,7.0,NaN,999,7.0
997,0,7.0,NaN,997,7.0
999,0,7.0,NaN,999,7.0
999,0,7.0,NaN,999,7.0
999,0,7.0,NaN,999,7.0
999,0,7.0,NaN,999,7.0
999,0,7.0,NaN,999,7.0
999,0,7.0,NaN,999,7.0
999,0,7.0,NaN,999,7.0
998,0,7.0,NaN,998,7.0
999,0,7.0,NaN,999,7.0
998,0,7.0,NaN,998,7.0
999,0,7.0,NaN,999,7.0
998,0,7.0,NaN,998,7.0
998,0,7.0,NaN,998,7.0
999,0,7.0,NaN,999,7.0
999,0,7.0,NaN,999,7.0
999,0,7.0,NaN,999,7.0
999,0,7.0,NaN,999,7.0
999,0,7.0,NaN,999,7.0
998,0,7.0,NaN,998,7.0
999,0,7.0,NaN,999,7.0
998,0,7.0,NaN,998,7.0
998,0,7.0,NaN,998,7.0
999,0,7.0,NaN,999,7.0
998,0,7.0,NaN,998,7.0
999,0,7.0,NaN,999,7.0
998,0,7.0,NaN,998,7.0
998,0,7.0,NaN,998,7.0
999,0,7.0,NaN,999,7.0
998,0,7.0,NaN,998,7.0
997,0,7.0,NaN,997,7.0
999,0,7.0,NaN,999,7.0
999,0,7.0,NaN,999,7.0
998,0,7.0,NaN,998,7.0
998,0,7.0,NaN,998,7.0
996,0,7.0,NaN,996,7.0
999,0,7.0,NaN,999,7.0
999,0,7.0,NaN,999,7.0
999,0,7.0,NaN,999,7.0
999,0,7.0,NaN,999,7.0
998,0,7.0,NaN,998,7.0
998,0,7.0,NaN,998,7.0
999,0,7.0,NaN,999,7.0
999,0,7.0,NaN,999,7.0
998,0,7.0,NaN,998,7.0
999,0,7.0,NaN,999,7.0
999,0,7.0,NaN,999,7.0
999,0,7.0,NaN,999,7.0
999,0,7.0,NaN,999,7.0
999,0,7.0,NaN,999,7.0
999,0,7.0,NaN,999,7.0
996,0,7.0,NaN,996,7.0
998,0,7.0,NaN,998,7.0
999,0,7.0,NaN,999,7.0
999,0,7.0,NaN,999,7.0
997,0,7.0,NaN,997,7.0
998,0,7.0,NaN,998,7.0
999,0,7.0,NaN,999,7.0
999,0,7.0,NaN,999,7.0
995,0,7.0,NaN,995,7.0
997,0,7.0,NaN,997,7.0
998,0,7.0,NaN,998,7.0
998,0,7.0,NaN,998,7.0
999,0,7.0,NaN,999,7.0
998,0,7.0,NaN,998,7.0
997,0,7.0,NaN,997,7.0
999,0,7.0,NaN,999,7.0
998,0,7.0,NaN,998,7.0
999,0,7.0,NaN,999,7.0
998,0,7.0,NaN,998,7.0
998,0,7.0,NaN,998,7.0
999,0,7.0,NaN,999,7.0
999,0,7.0,NaN,999,7.0
999,0,7.0,NaN,999,7.0
999,0,7.0,NaN,999,7.0
999,0,7.0,NaN,999,7.0
999,0,7.0,NaN,999,7.0
999,0,7.0,NaN,999,7.0
999,0,7.0,NaN,999,7.0
999,0,7.0,NaN,999,7.0
999,0,7.0,NaN,999,7.0
998,0,7.0,NaN,998,7.0
997,0,7.0,NaN,997,7.0
999,0,7.0,NaN,999,7.0
999,0,7.0,NaN,999,7.0
999,0,7.0,NaN,999,7.0
999,0,7.0,NaN,999,7.0
999,0,7.0,NaN,999,7.0
998,0,7.0,NaN,998,7.0
998,0,7.0,NaN,998,7.0
999,0,7.0,NaN,999,7.0
998,0,7.0,NaN,998,7.0
997,0,7.0,NaN,997,7.0
997,0,7.0,NaN,997,7.0
999,0,7.0,NaN,999,7.0
998,0,7.0,NaN,998,7.0
998,0,7.0,NaN,998,7.0
999,0,7.0,NaN,999,7.0
999,0,7.0,NaN,999,7.0
999,0,7.0,NaN,999,7.0
999,0,7.0,NaN,999,7.0
999,0,7.0,NaN,999,7.0
997,0,7.0,NaN,997,7.0
999,0,7.0,NaN,999,7.0
999,0,7.0,NaN,999,7.0
998,0,7.0,NaN,998,7.0
997,0,7.0,NaN,997,7.0
999,0,7.0,NaN,999,7.0
999,0,7.0,NaN,999,7.0
998,0,7.0,NaN,998,7.0
997,0,7.0,NaN,997,7.0
999,0,7.0,NaN,999,7.0
999,0,7.0,NaN,999,7.0
998,0,7.0,NaN,998,7.0
998,0,7.0,NaN,998,7.0
999,0,7.0,NaN,999,7.0
999,0,7.0,NaN,999,7.0
997,0,7.0,NaN,997,7.0
999,0,7.0,NaN,999,7.0
999,0,7.0,NaN,999,7.0
999,0,7.0,NaN,999,7.0
999,0,7.0,NaN,999,7.0
999,0,7.0,NaN,999,7.0
998,0,7.0,NaN,998,7.0
999,0,7.0,NaN,999,7.0
999,0,7.0,NaN,999,7.0
997,0,7.0,NaN,997,7.0
996,0,7.0,NaN,996,7.0
999,0,7.0,NaN,999,7.0
998,0,7.0,NaN,998,7.0
998,0,7.0,NaN,998,7.0
998,0,7.0,NaN,998,7.0
999,0,7.0,NaN,999,7.0
999,0,7.0,NaN,999,7.0
999,0,7.0,NaN,999,7.0
999,0,7.0,NaN,999,7.0
997,0,7.0,NaN,997,7.0
997,0,7.0,NaN,997,7.0
998,0,7.0,NaN,998,7.0
